"","hnum","dt.chat","dnum.chat","totchib","winchib","xbxchib","xabchib","xtkchib","dt.call","dnum.call","wincall","xtkcall","xabcall","xbxcall","totcall","dt","dnum","actsess","actuser"
"1",12409,2016-06-01 01:00:00,517,188,188,0,0,0,2016-06-01 01:00:00,517,551,1054,431,1485,2036,2016-06-01 01:00:00,517,36637,36480
"2",12410,2016-06-01 02:00:00,517,177,177,0,0,0,2016-06-01 02:00:00,517,397,827,333,1160,1557,2016-06-01 02:00:00,517,37404,37222
"3",12411,2016-06-01 03:00:00,517,135,135,0,0,0,2016-06-01 03:00:00,517,307,592,268,860,1167,2016-06-01 03:00:00,517,35178,34975
"4",12412,2016-06-01 04:00:00,517,149,149,0,0,0,2016-06-01 04:00:00,517,187,343,146,489,676,2016-06-01 04:00:00,517,33183,33027
"5",12413,2016-06-01 05:00:00,517,92,92,0,0,0,2016-06-01 05:00:00,517,136,207,86,293,429,2016-06-01 05:00:00,517,34500,34318
"6",12414,2016-06-01 06:00:00,517,83,83,0,0,0,2016-06-01 06:00:00,517,86,91,42,133,219,2016-06-01 06:00:00,517,41220,40991
"7",12415,2016-06-01 07:00:00,517,78,78,0,0,0,2016-06-01 07:00:00,517,65,54,22,76,141,2016-06-01 07:00:00,517,45698,45443
"8",12416,2016-06-01 08:00:00,517,95,95,0,0,0,2016-06-01 08:00:00,517,48,50,22,72,120,2016-06-01 08:00:00,517,48758,48469
"9",12417,2016-06-01 09:00:00,517,82,82,0,0,0,2016-06-01 09:00:00,517,53,39,22,61,114,2016-06-01 09:00:00,517,48966,48632
"10",12418,2016-06-01 10:00:00,517,86,86,0,0,0,2016-06-01 10:00:00,517,94,95,53,148,242,2016-06-01 10:00:00,517,45806,45535
"11",12419,2016-06-01 11:00:00,517,106,106,0,0,0,2016-06-01 11:00:00,517,144,148,87,235,379,2016-06-01 11:00:00,517,48616,48329
"12",12420,2016-06-01 12:00:00,517,130,130,0,0,0,2016-06-01 12:00:00,517,284,336,193,529,813,2016-06-01 12:00:00,517,58419,58100
"13",12421,2016-06-01 13:00:00,517,164,164,0,0,0,2016-06-01 13:00:00,517,598,550,313,863,1461,2016-06-01 13:00:00,517,69876,69446
"14",12422,2016-06-01 14:00:00,517,257,257,0,0,0,2016-06-01 14:00:00,517,691,691,391,1082,1773,2016-06-01 14:00:00,517,74868,74473
"15",12423,2016-06-01 15:00:00,517,263,263,0,0,0,2016-06-01 15:00:00,517,827,858,483,1341,2168,2016-06-01 15:00:00,517,73145,72712
"16",12424,2016-06-01 16:00:00,517,220,220,0,0,0,2016-06-01 16:00:00,517,853,922,486,1408,2261,2016-06-01 16:00:00,517,65047,64667
"17",12425,2016-06-01 17:00:00,517,258,258,0,0,0,2016-06-01 17:00:00,517,939,951,470,1421,2360,2016-06-01 17:00:00,517,63514,63106
"18",12426,2016-06-01 18:00:00,517,245,245,0,0,0,2016-06-01 18:00:00,517,862,1116,530,1646,2508,2016-06-01 18:00:00,517,64228,63853
"19",12427,2016-06-01 19:00:00,517,197,197,0,0,0,2016-06-01 19:00:00,517,922,1273,608,1881,2803,2016-06-01 19:00:00,517,62451,62038
"20",12428,2016-06-01 20:00:00,517,188,188,0,0,0,2016-06-01 20:00:00,517,852,1460,686,2146,2998,2016-06-01 20:00:00,517,58321,57972
"21",12429,2016-06-01 21:00:00,517,205,205,0,0,0,2016-06-01 21:00:00,517,892,1398,635,2033,2925,2016-06-01 21:00:00,517,48429,48154
"22",12430,2016-06-01 22:00:00,517,180,180,0,0,0,2016-06-01 22:00:00,517,717,1376,607,1983,2700,2016-06-01 22:00:00,517,38858,38629
"23",12431,2016-06-01 23:00:00,517,157,157,0,0,0,2016-06-01 23:00:00,517,705,1416,616,2032,2737,2016-06-01 23:00:00,517,35669,35464
"24",12432,2016-06-02 00:00:00,518,143,143,0,0,0,2016-06-02 00:00:00,518,611,1223,500,1723,2334,2016-06-02 00:00:00,518,34430,34270
"25",12433,2016-06-02 01:00:00,518,132,132,0,0,0,2016-06-02 01:00:00,518,513,1109,449,1558,2071,2016-06-02 01:00:00,518,36244,36042
"26",12434,2016-06-02 02:00:00,518,164,164,0,0,0,2016-06-02 02:00:00,518,471,938,390,1328,1799,2016-06-02 02:00:00,518,36644,36464
"27",12435,2016-06-02 03:00:00,518,135,135,0,0,0,2016-06-02 03:00:00,518,306,631,276,907,1213,2016-06-02 03:00:00,518,34189,34000
"28",12436,2016-06-02 04:00:00,518,116,116,0,0,0,2016-06-02 04:00:00,518,182,404,167,571,753,2016-06-02 04:00:00,518,32696,32551
"29",12437,2016-06-02 05:00:00,518,97,97,0,0,0,2016-06-02 05:00:00,518,125,199,99,298,423,2016-06-02 05:00:00,518,34175,33970
"30",12438,2016-06-02 06:00:00,518,65,65,0,0,0,2016-06-02 06:00:00,518,80,123,58,181,261,2016-06-02 06:00:00,518,39915,39678
"31",12439,2016-06-02 07:00:00,518,72,72,0,0,0,2016-06-02 07:00:00,518,70,68,32,100,170,2016-06-02 07:00:00,518,45231,44949
"32",12440,2016-06-02 08:00:00,518,54,54,0,0,0,2016-06-02 08:00:00,518,44,40,17,57,101,2016-06-02 08:00:00,518,47943,47683
"33",12441,2016-06-02 09:00:00,518,62,62,0,0,0,2016-06-02 09:00:00,518,66,34,18,52,118,2016-06-02 09:00:00,518,48012,47741
"34",12442,2016-06-02 10:00:00,518,63,63,0,0,0,2016-06-02 10:00:00,518,91,59,37,96,187,2016-06-02 10:00:00,518,44657,44420
"35",12443,2016-06-02 11:00:00,518,97,97,0,0,0,2016-06-02 11:00:00,518,164,166,110,276,440,2016-06-02 11:00:00,518,47954,47691
"36",12444,2016-06-02 12:00:00,518,112,112,0,0,0,2016-06-02 12:00:00,518,280,355,209,564,844,2016-06-02 12:00:00,518,58331,57995
"37",12445,2016-06-02 13:00:00,518,148,148,0,0,0,2016-06-02 13:00:00,518,715,715,431,1146,1861,2016-06-02 13:00:00,518,68372,67964
"38",12446,2016-06-02 14:00:00,518,218,218,0,0,0,2016-06-02 14:00:00,518,812,727,415,1142,1954,2016-06-02 14:00:00,518,75075,74655
"39",12447,2016-06-02 15:00:00,518,212,212,0,0,0,2016-06-02 15:00:00,518,821,905,511,1416,2237,2016-06-02 15:00:00,518,71251,70807
"40",12448,2016-06-02 16:00:00,518,193,193,0,0,0,2016-06-02 16:00:00,518,809,971,507,1478,2287,2016-06-02 16:00:00,518,62342,62010
"41",12449,2016-06-02 17:00:00,518,192,192,0,0,0,2016-06-02 17:00:00,518,877,939,454,1393,2270,2016-06-02 17:00:00,518,61552,61214
"42",12450,2016-06-02 18:00:00,518,212,212,0,0,0,2016-06-02 18:00:00,518,866,1251,609,1860,2726,2016-06-02 18:00:00,518,62865,62533
"43",12451,2016-06-02 19:00:00,518,235,235,0,0,0,2016-06-02 19:00:00,518,807,1326,676,2002,2809,2016-06-02 19:00:00,518,60384,60026
"44",12452,2016-06-02 20:00:00,518,233,233,0,0,0,2016-06-02 20:00:00,518,851,1393,679,2072,2923,2016-06-02 20:00:00,518,56404,56104
"45",12453,2016-06-02 21:00:00,518,213,213,0,0,0,2016-06-02 21:00:00,518,854,1431,699,2130,2984,2016-06-02 21:00:00,518,47137,46882
"46",12454,2016-06-02 22:00:00,518,132,132,0,0,0,2016-06-02 22:00:00,518,704,1382,642,2024,2728,2016-06-02 22:00:00,518,37076,36902
"47",12462,2016-06-03 06:00:00,519,39,39,0,0,0,2016-06-03 06:00:00,519,87,110,47,157,244,2016-06-03 06:00:00,519,37454,37289
"48",12463,2016-06-03 07:00:00,519,54,54,0,0,0,2016-06-03 07:00:00,519,58,78,36,114,172,2016-06-03 07:00:00,519,40898,40683
"49",12464,2016-06-03 08:00:00,519,58,58,0,0,0,2016-06-03 08:00:00,519,35,45,21,66,101,2016-06-03 08:00:00,519,43129,42876
"50",12465,2016-06-03 09:00:00,519,50,50,0,0,0,2016-06-03 09:00:00,519,37,34,13,47,84,2016-06-03 09:00:00,519,42599,42363
"51",12466,2016-06-03 10:00:00,519,69,69,0,0,0,2016-06-03 10:00:00,519,73,79,42,121,194,2016-06-03 10:00:00,519,39820,39612
"52",12467,2016-06-03 11:00:00,519,77,77,0,0,0,2016-06-03 11:00:00,519,147,133,85,218,365,2016-06-03 11:00:00,519,42880,42652
"53",12468,2016-06-03 12:00:00,519,90,90,0,0,0,2016-06-03 12:00:00,519,295,373,239,612,907,2016-06-03 12:00:00,519,51063,50793
"54",12469,2016-06-03 13:00:00,519,116,116,0,0,0,2016-06-03 13:00:00,519,521,638,380,1018,1539,2016-06-03 13:00:00,519,60872,60553
"55",12470,2016-06-03 14:00:00,519,188,188,0,0,0,2016-06-03 14:00:00,519,674,716,401,1117,1791,2016-06-03 14:00:00,519,65267,64910
"56",12471,2016-06-03 15:00:00,519,180,180,0,0,0,2016-06-03 15:00:00,519,724,910,533,1443,2167,2016-06-03 15:00:00,519,63809,63453
"57",12472,2016-06-03 16:00:00,519,235,235,0,0,0,2016-06-03 16:00:00,519,815,974,503,1477,2292,2016-06-03 16:00:00,519,57387,57055
"58",12473,2016-06-03 17:00:00,519,217,217,0,0,0,2016-06-03 17:00:00,519,817,969,471,1440,2257,2016-06-03 17:00:00,519,55297,55005
"59",12474,2016-06-03 18:00:00,519,209,209,0,0,0,2016-06-03 18:00:00,519,906,1171,598,1769,2675,2016-06-03 18:00:00,519,55234,54925
"60",12475,2016-06-03 19:00:00,519,181,181,0,0,0,2016-06-03 19:00:00,519,854,1216,601,1817,2671,2016-06-03 19:00:00,519,52846,52553
"61",12476,2016-06-03 20:00:00,519,161,161,0,0,0,2016-06-03 20:00:00,519,853,1313,631,1944,2797,2016-06-03 20:00:00,519,47996,47723
"62",12477,2016-06-03 21:00:00,519,177,177,0,0,0,2016-06-03 21:00:00,519,679,1285,608,1893,2572,2016-06-03 21:00:00,519,40421,40228
"63",12478,2016-06-03 22:00:00,519,141,141,0,0,0,2016-06-03 22:00:00,519,689,1345,592,1937,2626,2016-06-03 22:00:00,519,33187,33032
"64",12479,2016-06-03 23:00:00,519,130,130,0,0,0,2016-06-03 23:00:00,519,562,1293,592,1885,2447,2016-06-03 23:00:00,519,28607,28483
"65",12480,2016-06-04 00:00:00,520,133,133,0,0,0,2016-06-04 00:00:00,520,457,1224,546,1770,2227,2016-06-04 00:00:00,520,26278,26154
"66",12481,2016-06-04 01:00:00,520,130,130,0,0,0,2016-06-04 01:00:00,520,408,1143,439,1582,1990,2016-06-04 01:00:00,520,25589,25480
"67",12482,2016-06-04 02:00:00,520,124,124,0,0,0,2016-06-04 02:00:00,520,315,844,370,1214,1529,2016-06-04 02:00:00,520,25915,25783
"68",12483,2016-06-04 03:00:00,520,112,112,0,0,0,2016-06-04 03:00:00,520,231,701,289,990,1221,2016-06-04 03:00:00,520,24631,24508
"69",12484,2016-06-04 04:00:00,520,94,94,0,0,0,2016-06-04 04:00:00,520,186,473,215,688,874,2016-06-04 04:00:00,520,23260,23163
"70",12485,2016-06-04 05:00:00,520,89,89,0,0,0,2016-06-04 05:00:00,520,92,307,142,449,541,2016-06-04 05:00:00,520,22382,22288
"71",12486,2016-06-04 06:00:00,520,72,72,0,0,0,2016-06-04 06:00:00,520,75,135,55,190,265,2016-06-04 06:00:00,520,22933,22802
"72",12487,2016-06-04 07:00:00,520,63,63,0,0,0,2016-06-04 07:00:00,520,52,93,35,128,180,2016-06-04 07:00:00,520,23042,22947
"73",12488,2016-06-04 08:00:00,520,81,81,0,0,0,2016-06-04 08:00:00,520,43,46,16,62,105,2016-06-04 08:00:00,520,22981,22887
"74",12489,2016-06-04 09:00:00,520,98,98,0,0,0,2016-06-04 09:00:00,520,39,20,12,32,71,2016-06-04 09:00:00,520,23791,23696
"75",12490,2016-06-04 10:00:00,520,65,65,0,0,0,2016-06-04 10:00:00,520,63,39,27,66,129,2016-06-04 10:00:00,520,23248,23145
"76",12491,2016-06-04 11:00:00,520,64,64,0,0,0,2016-06-04 11:00:00,520,109,142,91,233,342,2016-06-04 11:00:00,520,24426,24303
"77",12492,2016-06-04 12:00:00,520,82,82,0,0,0,2016-06-04 12:00:00,520,203,264,150,414,617,2016-06-04 12:00:00,520,26026,25930
"78",12493,2016-06-04 13:00:00,520,101,101,0,0,0,2016-06-04 13:00:00,520,290,543,272,815,1105,2016-06-04 13:00:00,520,28355,28230
"79",12494,2016-06-04 14:00:00,520,124,124,0,0,0,2016-06-04 14:00:00,520,491,656,334,990,1481,2016-06-04 14:00:00,520,30455,30306
"80",12495,2016-06-04 15:00:00,520,119,119,0,0,0,2016-06-04 15:00:00,520,519,1803,503,2306,2825,2016-06-04 15:00:00,520,33248,33106
"81",12496,2016-06-04 16:00:00,520,153,153,0,0,0,2016-06-04 16:00:00,520,558,1112,484,1596,2154,2016-06-04 16:00:00,520,30395,30286
"82",12497,2016-06-04 17:00:00,520,161,161,0,0,0,2016-06-04 17:00:00,520,517,1209,533,1742,2259,2016-06-04 17:00:00,520,30650,30517
"83",12498,2016-06-04 18:00:00,520,144,144,0,0,0,2016-06-04 18:00:00,520,611,1214,490,1704,2315,2016-06-04 18:00:00,520,29942,29826
"84",12499,2016-06-04 19:00:00,520,152,152,0,0,0,2016-06-04 19:00:00,520,574,1309,559,1868,2442,2016-06-04 19:00:00,520,28901,28761
"85",12500,2016-06-04 20:00:00,520,157,157,0,0,0,2016-06-04 20:00:00,520,563,1477,595,2072,2635,2016-06-04 20:00:00,520,26885,26745
"86",12501,2016-06-04 21:00:00,520,124,124,0,0,0,2016-06-04 21:00:00,520,523,1453,561,2014,2537,2016-06-04 21:00:00,520,25899,25766
"87",12502,2016-06-04 22:00:00,520,117,117,0,0,0,2016-06-04 22:00:00,520,494,1381,511,1892,2386,2016-06-04 22:00:00,520,24260,24163
"88",12503,2016-06-04 23:00:00,520,126,126,0,0,0,2016-06-04 23:00:00,520,412,1454,530,1984,2396,2016-06-04 23:00:00,520,23110,23022
"89",12504,2016-06-05 00:00:00,521,108,108,0,0,0,2016-06-05 00:00:00,521,402,1288,446,1734,2136,2016-06-05 00:00:00,521,23036,22932
"90",12505,2016-06-05 01:00:00,521,94,94,0,0,0,2016-06-05 01:00:00,521,361,1188,432,1620,1981,2016-06-05 01:00:00,521,23622,23519
"91",12506,2016-06-05 02:00:00,521,71,71,0,0,0,2016-06-05 02:00:00,521,276,1058,389,1447,1723,2016-06-05 02:00:00,521,23775,23680
"92",12507,2016-06-05 03:00:00,521,92,92,0,0,0,2016-06-05 03:00:00,521,186,776,272,1048,1234,2016-06-05 03:00:00,521,23465,23367
"93",12508,2016-06-05 04:00:00,521,79,79,0,0,0,2016-06-05 04:00:00,521,144,487,165,652,796,2016-06-05 04:00:00,521,22911,22807
"94",12509,2016-06-05 05:00:00,521,43,43,0,0,0,2016-06-05 05:00:00,521,97,309,118,427,524,2016-06-05 05:00:00,521,22213,22126
"95",12510,2016-06-05 06:00:00,521,46,46,0,0,0,2016-06-05 06:00:00,521,75,168,57,225,300,2016-06-05 06:00:00,521,22612,22508
"96",12511,2016-06-05 07:00:00,521,63,63,0,0,0,2016-06-05 07:00:00,521,56,104,37,141,197,2016-06-05 07:00:00,521,22230,22120
"97",12512,2016-06-05 08:00:00,521,70,70,0,0,0,2016-06-05 08:00:00,521,32,70,30,100,132,2016-06-05 08:00:00,521,22988,22867
"98",12513,2016-06-05 09:00:00,521,58,58,0,0,0,2016-06-05 09:00:00,521,48,63,26,89,137,2016-06-05 09:00:00,521,22427,22320
"99",12514,2016-06-05 10:00:00,521,57,57,0,0,0,2016-06-05 10:00:00,521,39,78,33,111,150,2016-06-05 10:00:00,521,22086,21945
"100",12515,2016-06-05 11:00:00,521,67,67,0,0,0,2016-06-05 11:00:00,521,76,134,54,188,264,2016-06-05 11:00:00,521,24590,24478
"101",12516,2016-06-05 12:00:00,521,89,89,0,0,0,2016-06-05 12:00:00,521,130,252,94,346,476,2016-06-05 12:00:00,521,25375,25273
"102",12517,2016-06-05 13:00:00,521,136,136,0,0,0,2016-06-05 13:00:00,521,258,558,215,773,1031,2016-06-05 13:00:00,521,27129,27009
"103",12518,2016-06-05 14:00:00,521,131,131,0,0,0,2016-06-05 14:00:00,521,358,648,259,907,1265,2016-06-05 14:00:00,521,28982,28865
"104",12519,2016-06-05 15:00:00,521,132,132,0,0,0,2016-06-05 15:00:00,521,436,970,382,1352,1788,2016-06-05 15:00:00,521,30778,30632
"105",12520,2016-06-05 16:00:00,521,122,122,0,0,0,2016-06-05 16:00:00,521,467,1019,420,1439,1906,2016-06-05 16:00:00,521,31145,31008
"106",12521,2016-06-05 17:00:00,521,145,145,0,0,0,2016-06-05 17:00:00,521,582,1020,427,1447,2029,2016-06-05 17:00:00,521,31065,30924
"107",12522,2016-06-05 18:00:00,521,176,176,0,0,0,2016-06-05 18:00:00,521,506,1252,517,1769,2275,2016-06-05 18:00:00,521,30840,30689
"108",12523,2016-06-05 19:00:00,521,138,138,0,0,0,2016-06-05 19:00:00,521,557,1222,502,1724,2281,2016-06-05 19:00:00,521,30300,30170
"109",12524,2016-06-05 20:00:00,521,152,152,0,0,0,2016-06-05 20:00:00,521,550,1218,504,1722,2272,2016-06-05 20:00:00,521,29212,29056
"110",12525,2016-06-05 21:00:00,521,166,166,0,0,0,2016-06-05 21:00:00,521,497,1251,553,1804,2301,2016-06-05 21:00:00,521,27437,27316
"111",12526,2016-06-05 22:00:00,521,141,141,0,0,0,2016-06-05 22:00:00,521,497,1275,585,1860,2357,2016-06-05 22:00:00,521,26630,26518
"112",12527,2016-06-05 23:00:00,521,137,137,0,0,0,2016-06-05 23:00:00,521,467,1232,536,1768,2235,2016-06-05 23:00:00,521,26843,26736
"113",12528,2016-06-06 00:00:00,522,151,151,0,0,0,2016-06-06 00:00:00,522,370,1150,483,1633,2003,2016-06-06 00:00:00,522,28110,27997
"114",12529,2016-06-06 01:00:00,522,104,104,0,0,0,2016-06-06 01:00:00,522,383,1026,437,1463,1846,2016-06-06 01:00:00,522,30633,30485
"115",12530,2016-06-06 02:00:00,522,117,117,0,0,0,2016-06-06 02:00:00,522,249,763,349,1112,1361,2016-06-06 02:00:00,522,31658,31520
"116",12531,2016-06-06 03:00:00,522,82,82,0,0,0,2016-06-06 03:00:00,522,181,544,242,786,967,2016-06-06 03:00:00,522,30519,30388
"117",12532,2016-06-06 04:00:00,522,106,106,0,0,0,2016-06-06 04:00:00,522,136,90,11,101,237,2016-06-06 04:00:00,522,29642,29524
"118",12533,2016-06-06 05:00:00,522,95,95,0,0,0,2016-06-06 05:00:00,522,78,148,58,206,284,2016-06-06 05:00:00,522,31336,31169
"119",12534,2016-06-06 06:00:00,522,71,71,0,0,0,2016-06-06 06:00:00,522,57,90,38,128,185,2016-06-06 06:00:00,522,37912,37717
"120",12535,2016-06-06 07:00:00,522,56,56,0,0,0,2016-06-06 07:00:00,522,42,58,27,85,127,2016-06-06 07:00:00,522,42860,42601
"121",12536,2016-06-06 08:00:00,522,64,64,0,0,0,2016-06-06 08:00:00,522,47,34,13,47,94,2016-06-06 08:00:00,522,44354,44089
"122",12537,2016-06-06 09:00:00,522,75,75,0,0,0,2016-06-06 09:00:00,522,48,37,22,59,107,2016-06-06 09:00:00,522,44965,44692
"123",12538,2016-06-06 10:00:00,522,77,77,0,0,0,2016-06-06 10:00:00,522,58,57,34,91,149,2016-06-06 10:00:00,522,42552,42323
"124",12539,2016-06-06 11:00:00,522,102,102,0,0,0,2016-06-06 11:00:00,522,115,129,70,199,314,2016-06-06 11:00:00,522,45225,45001
"125",12540,2016-06-06 12:00:00,522,117,117,0,0,0,2016-06-06 12:00:00,522,285,346,184,530,815,2016-06-06 12:00:00,522,54054,53774
"126",12541,2016-06-06 13:00:00,522,163,163,0,0,0,2016-06-06 13:00:00,522,491,637,371,1008,1499,2016-06-06 13:00:00,522,64525,64228
"127",12542,2016-06-06 14:00:00,522,215,215,0,0,0,2016-06-06 14:00:00,522,660,690,371,1061,1721,2016-06-06 14:00:00,522,69206,68805
"128",12543,2016-06-06 15:00:00,522,245,245,0,0,0,2016-06-06 15:00:00,522,832,965,541,1506,2338,2016-06-06 15:00:00,522,68366,68000
"129",12544,2016-06-06 16:00:00,522,243,243,0,0,0,2016-06-06 16:00:00,522,811,1032,536,1568,2379,2016-06-06 16:00:00,522,61091,60733
"130",12545,2016-06-06 17:00:00,522,230,230,0,0,0,2016-06-06 17:00:00,522,951,1111,591,1702,2653,2016-06-06 17:00:00,522,59604,59267
"131",12546,2016-06-06 18:00:00,522,240,240,0,0,0,2016-06-06 18:00:00,522,934,1201,617,1818,2752,2016-06-06 18:00:00,522,60957,60617
"132",12547,2016-06-06 19:00:00,522,225,225,0,0,0,2016-06-06 19:00:00,522,914,1282,682,1964,2878,2016-06-06 19:00:00,522,58372,58015
"133",12548,2016-06-06 20:00:00,522,211,211,0,0,0,2016-06-06 20:00:00,522,925,1547,782,2329,3254,2016-06-06 20:00:00,522,54322,54018
"134",12549,2016-06-06 21:00:00,522,236,236,0,0,0,2016-06-06 21:00:00,522,862,1635,820,2455,3317,2016-06-06 21:00:00,522,45666,45447
"135",12550,2016-06-06 22:00:00,522,171,171,0,0,0,2016-06-06 22:00:00,522,784,1763,794,2557,3341,2016-06-06 22:00:00,522,36298,36138
"136",12551,2016-06-06 23:00:00,522,165,165,0,0,0,2016-06-06 23:00:00,522,735,1625,740,2365,3100,2016-06-06 23:00:00,522,34203,34028
"137",12552,2016-06-07 00:00:00,523,161,161,0,0,0,2016-06-07 00:00:00,523,596,1507,700,2207,2803,2016-06-07 00:00:00,523,33319,33173
"138",12553,2016-06-07 01:00:00,523,145,145,0,0,0,2016-06-07 01:00:00,523,526,1175,538,1713,2239,2016-06-07 01:00:00,523,34657,34482
"139",12554,2016-06-07 02:00:00,523,126,126,0,0,0,2016-06-07 02:00:00,523,395,936,402,1338,1733,2016-06-07 02:00:00,523,34856,34696
"140",12555,2016-06-07 03:00:00,523,116,116,0,0,0,2016-06-07 03:00:00,523,306,625,284,909,1215,2016-06-07 03:00:00,523,33101,32912
"141",12556,2016-06-07 04:00:00,523,95,95,0,0,0,2016-06-07 04:00:00,523,197,452,191,643,840,2016-06-07 04:00:00,523,31605,31453
"142",12557,2016-06-07 05:00:00,523,87,87,0,0,0,2016-06-07 05:00:00,523,117,284,105,389,506,2016-06-07 05:00:00,523,32674,32516
"143",12558,2016-06-07 06:00:00,523,67,67,0,0,0,2016-06-07 06:00:00,523,86,137,49,186,272,2016-06-07 06:00:00,523,39169,38949
"144",12559,2016-06-07 07:00:00,523,92,92,0,0,0,2016-06-07 07:00:00,523,61,78,40,118,179,2016-06-07 07:00:00,523,44128,43870
"145",12560,2016-06-07 08:00:00,523,110,110,0,0,0,2016-06-07 08:00:00,523,44,43,22,65,109,2016-06-07 08:00:00,523,46361,46066
"146",12561,2016-06-07 09:00:00,523,100,100,0,0,0,2016-06-07 09:00:00,523,37,23,7,30,67,2016-06-07 09:00:00,523,45302,45047
"147",12562,2016-06-07 10:00:00,523,65,65,0,0,0,2016-06-07 10:00:00,523,76,67,35,102,178,2016-06-07 10:00:00,523,42610,42352
"148",12563,2016-06-07 11:00:00,523,95,95,0,0,0,2016-06-07 11:00:00,523,154,183,98,281,435,2016-06-07 11:00:00,523,46269,45995
"149",12564,2016-06-07 12:00:00,523,98,98,0,0,0,2016-06-07 12:00:00,523,261,294,155,449,710,2016-06-07 12:00:00,523,56054,55771
"150",12565,2016-06-07 13:00:00,523,127,127,0,0,0,2016-06-07 13:00:00,523,584,562,318,880,1464,2016-06-07 13:00:00,523,67270,66892
"151",12566,2016-06-07 14:00:00,523,205,205,0,0,0,2016-06-07 14:00:00,523,712,655,356,1011,1723,2016-06-07 14:00:00,523,71397,70988
"152",12567,2016-06-07 15:00:00,523,227,227,0,0,0,2016-06-07 15:00:00,523,747,831,429,1260,2007,2016-06-07 15:00:00,523,69117,68718
"153",12568,2016-06-07 16:00:00,523,190,190,0,0,0,2016-06-07 16:00:00,523,766,895,448,1343,2109,2016-06-07 16:00:00,523,61637,61264
"154",12569,2016-06-07 17:00:00,523,210,210,0,0,0,2016-06-07 17:00:00,523,796,1259,636,1895,2691,2016-06-07 17:00:00,523,60008,59668
"155",12570,2016-06-07 18:00:00,523,224,224,0,0,0,2016-06-07 18:00:00,523,901,1257,648,1905,2806,2016-06-07 18:00:00,523,61074,60737
"156",12571,2016-06-07 19:00:00,523,191,191,0,0,0,2016-06-07 19:00:00,523,935,1439,691,2130,3065,2016-06-07 19:00:00,523,60077,59689
"157",12572,2016-06-07 20:00:00,523,248,248,0,0,0,2016-06-07 20:00:00,523,884,1532,708,2240,3124,2016-06-07 20:00:00,523,56230,55917
"158",12573,2016-06-07 21:00:00,523,188,188,0,0,0,2016-06-07 21:00:00,523,755,1668,700,2368,3123,2016-06-07 21:00:00,523,46536,46325
"159",12574,2016-06-07 22:00:00,523,205,205,0,0,0,2016-06-07 22:00:00,523,655,1605,735,2340,2995,2016-06-07 22:00:00,523,37768,37582
"160",12575,2016-06-07 23:00:00,523,200,200,0,0,0,2016-06-07 23:00:00,523,609,1548,690,2238,2847,2016-06-07 23:00:00,523,33661,33491
"161",12576,2016-06-08 00:00:00,524,180,180,0,0,0,2016-06-08 00:00:00,524,545,1375,599,1974,2519,2016-06-08 00:00:00,524,32014,31849
"162",12577,2016-06-08 01:00:00,524,150,150,0,0,0,2016-06-08 01:00:00,524,451,1157,514,1671,2122,2016-06-08 01:00:00,524,33824,33656
"163",12578,2016-06-08 02:00:00,524,167,167,0,0,0,2016-06-08 02:00:00,524,357,918,414,1332,1689,2016-06-08 02:00:00,524,34191,34025
"164",12579,2016-06-08 03:00:00,524,154,154,0,0,0,2016-06-08 03:00:00,524,234,625,262,887,1121,2016-06-08 03:00:00,524,31917,31744
"165",12580,2016-06-08 04:00:00,524,135,135,0,0,0,2016-06-08 04:00:00,524,180,373,148,521,701,2016-06-08 04:00:00,524,30997,30828
"166",12581,2016-06-08 05:00:00,524,97,97,0,0,0,2016-06-08 05:00:00,524,109,251,117,368,477,2016-06-08 05:00:00,524,32754,32600
"167",12582,2016-06-08 06:00:00,524,89,89,0,0,0,2016-06-08 06:00:00,524,66,151,69,220,286,2016-06-08 06:00:00,524,39571,39351
"168",12583,2016-06-08 07:00:00,524,72,72,0,0,0,2016-06-08 07:00:00,524,72,79,34,113,185,2016-06-08 07:00:00,524,44217,43966
"169",12584,2016-06-08 08:00:00,524,82,82,0,0,0,2016-06-08 08:00:00,524,45,35,16,51,96,2016-06-08 08:00:00,524,46616,46328
"170",12585,2016-06-08 09:00:00,524,97,97,0,0,0,2016-06-08 09:00:00,524,48,19,11,30,78,2016-06-08 09:00:00,524,46317,46054
"171",12586,2016-06-08 10:00:00,524,87,87,0,0,0,2016-06-08 10:00:00,524,61,63,40,103,164,2016-06-08 10:00:00,524,43008,42761
"172",12587,2016-06-08 11:00:00,524,95,95,0,0,0,2016-06-08 11:00:00,524,165,157,105,262,427,2016-06-08 11:00:00,524,45444,45206
"173",12588,2016-06-08 12:00:00,524,140,140,0,0,0,2016-06-08 12:00:00,524,290,338,219,557,847,2016-06-08 12:00:00,524,54941,54607
"174",12589,2016-06-08 13:00:00,524,142,142,0,0,0,2016-06-08 13:00:00,524,478,565,364,929,1407,2016-06-08 13:00:00,524,66503,66142
"175",12590,2016-06-08 14:00:00,524,220,220,0,0,0,2016-06-08 14:00:00,524,581,640,333,973,1554,2016-06-08 14:00:00,524,71374,70958
"176",12591,2016-06-08 15:00:00,524,226,226,0,0,0,2016-06-08 15:00:00,524,686,728,378,1106,1792,2016-06-08 15:00:00,524,68547,68197
"177",12592,2016-06-08 16:00:00,524,206,206,0,0,0,2016-06-08 16:00:00,524,743,851,430,1281,2024,2016-06-08 16:00:00,524,61541,61230
"178",12593,2016-06-08 17:00:00,524,242,242,0,0,0,2016-06-08 17:00:00,524,820,983,490,1473,2293,2016-06-08 17:00:00,524,60328,59998
"179",12594,2016-06-08 18:00:00,524,232,232,0,0,0,2016-06-08 18:00:00,524,817,1043,530,1573,2390,2016-06-08 18:00:00,524,61815,61457
"180",12595,2016-06-08 19:00:00,524,265,265,0,0,0,2016-06-08 19:00:00,524,880,1085,543,1628,2508,2016-06-08 19:00:00,524,62251,61887
"181",12596,2016-06-08 20:00:00,524,242,242,0,0,0,2016-06-08 20:00:00,524,787,1427,673,2100,2887,2016-06-08 20:00:00,524,59376,59051
"182",12597,2016-06-08 21:00:00,524,211,211,0,0,0,2016-06-08 21:00:00,524,706,1396,679,2075,2781,2016-06-08 21:00:00,524,47752,47478
"183",12598,2016-06-08 22:00:00,524,175,175,0,0,0,2016-06-08 22:00:00,524,696,1361,603,1964,2660,2016-06-08 22:00:00,524,38475,38284
"184",12599,2016-06-08 23:00:00,524,185,185,0,0,0,2016-06-08 23:00:00,524,596,1394,616,2010,2606,2016-06-08 23:00:00,524,34133,33970
"185",12600,2016-06-09 00:00:00,525,152,152,0,0,0,2016-06-09 00:00:00,525,522,1291,525,1816,2338,2016-06-09 00:00:00,525,31551,31416
"186",12601,2016-06-09 01:00:00,525,125,125,0,0,0,2016-06-09 01:00:00,525,441,1022,387,1409,1850,2016-06-09 01:00:00,525,32437,32279
"187",12602,2016-06-09 02:00:00,525,153,153,0,0,0,2016-06-09 02:00:00,525,373,844,374,1218,1591,2016-06-09 02:00:00,525,32054,31898
"188",12603,2016-06-09 03:00:00,525,143,143,0,0,0,2016-06-09 03:00:00,525,272,670,270,940,1212,2016-06-09 03:00:00,525,30067,29940
"189",12604,2016-06-09 04:00:00,525,108,108,0,0,0,2016-06-09 04:00:00,525,168,480,217,697,865,2016-06-09 04:00:00,525,29861,29736
"190",12605,2016-06-09 05:00:00,525,94,94,0,0,0,2016-06-09 05:00:00,525,110,258,94,352,462,2016-06-09 05:00:00,525,31439,31281
"191",12606,2016-06-09 06:00:00,525,77,77,0,0,0,2016-06-09 06:00:00,525,73,110,56,166,239,2016-06-09 06:00:00,525,37165,36984
"192",12607,2016-06-09 07:00:00,525,84,84,0,0,0,2016-06-09 07:00:00,525,54,62,27,89,143,2016-06-09 07:00:00,525,42384,42131
"193",12608,2016-06-09 08:00:00,525,83,83,0,0,0,2016-06-09 08:00:00,525,54,35,19,54,108,2016-06-09 08:00:00,525,44349,44089
"194",12609,2016-06-09 09:00:00,525,84,84,0,0,0,2016-06-09 09:00:00,525,65,31,13,44,109,2016-06-09 09:00:00,525,44616,44355
"195",12610,2016-06-09 10:00:00,525,82,82,0,0,0,2016-06-09 10:00:00,525,89,60,32,92,181,2016-06-09 10:00:00,525,42680,42432
"196",12611,2016-06-09 11:00:00,525,77,77,0,0,0,2016-06-09 11:00:00,525,97,110,67,177,274,2016-06-09 11:00:00,525,45153,44900
"197",12612,2016-06-09 12:00:00,525,103,103,0,0,0,2016-06-09 12:00:00,525,302,281,146,427,729,2016-06-09 12:00:00,525,54556,54258
"198",12613,2016-06-09 13:00:00,525,144,144,0,0,0,2016-06-09 13:00:00,525,476,576,344,920,1396,2016-06-09 13:00:00,525,65481,65136
"199",12614,2016-06-09 14:00:00,525,204,204,0,0,0,2016-06-09 14:00:00,525,605,654,318,972,1577,2016-06-09 14:00:00,525,69691,69295
"200",12615,2016-06-09 15:00:00,525,217,217,0,0,0,2016-06-09 15:00:00,525,683,794,424,1218,1901,2016-06-09 15:00:00,525,67796,67383
"201",12616,2016-06-09 16:00:00,525,229,229,0,0,0,2016-06-09 16:00:00,525,714,857,427,1284,1998,2016-06-09 16:00:00,525,60295,59950
"202",12617,2016-06-09 17:00:00,525,237,237,0,0,0,2016-06-09 17:00:00,525,728,994,507,1501,2229,2016-06-09 17:00:00,525,58105,57796
"203",12618,2016-06-09 18:00:00,525,245,245,0,0,0,2016-06-09 18:00:00,525,748,1129,555,1684,2432,2016-06-09 18:00:00,525,58903,58580
"204",12619,2016-06-09 19:00:00,525,202,202,0,0,0,2016-06-09 19:00:00,525,836,1249,577,1826,2662,2016-06-09 19:00:00,525,57854,57533
"205",12620,2016-06-09 20:00:00,525,276,276,0,0,0,2016-06-09 20:00:00,525,802,1539,764,2303,3105,2016-06-09 20:00:00,525,53901,53606
"206",12621,2016-06-09 21:00:00,525,222,222,0,0,0,2016-06-09 21:00:00,525,679,1359,613,1972,2651,2016-06-09 21:00:00,525,45036,44793
"207",12622,2016-06-09 22:00:00,525,186,186,0,0,0,2016-06-09 22:00:00,525,610,1412,654,2066,2676,2016-06-09 22:00:00,525,35830,35665
"208",12623,2016-06-09 23:00:00,525,189,189,0,0,0,2016-06-09 23:00:00,525,523,1365,601,1966,2489,2016-06-09 23:00:00,525,32472,32289
"209",12624,2016-06-10 00:00:00,526,174,174,0,0,0,2016-06-10 00:00:00,526,486,1328,554,1882,2368,2016-06-10 00:00:00,526,30728,30600
"210",12625,2016-06-10 01:00:00,526,171,171,0,0,0,2016-06-10 01:00:00,526,502,1155,489,1644,2146,2016-06-10 01:00:00,526,31569,31394
"211",12626,2016-06-10 02:00:00,526,171,171,0,0,0,2016-06-10 02:00:00,526,310,904,352,1256,1566,2016-06-10 02:00:00,526,31546,31393
"212",12627,2016-06-10 03:00:00,526,132,132,0,0,0,2016-06-10 03:00:00,526,279,602,263,865,1144,2016-06-10 03:00:00,526,29483,29368
"213",12628,2016-06-10 04:00:00,526,107,107,0,0,0,2016-06-10 04:00:00,526,171,431,188,619,790,2016-06-10 04:00:00,526,28259,28115
"214",12629,2016-06-10 05:00:00,526,89,89,0,0,0,2016-06-10 05:00:00,526,138,228,106,334,472,2016-06-10 05:00:00,526,28944,28810
"215",12630,2016-06-10 06:00:00,526,76,76,0,0,0,2016-06-10 06:00:00,526,87,103,39,142,229,2016-06-10 06:00:00,526,34579,34378
"216",12631,2016-06-10 07:00:00,526,108,108,0,0,0,2016-06-10 07:00:00,526,57,63,23,86,143,2016-06-10 07:00:00,526,38723,38490
"217",12632,2016-06-10 08:00:00,526,89,89,0,0,0,2016-06-10 08:00:00,526,61,41,15,56,117,2016-06-10 08:00:00,526,40139,39902
"218",12633,2016-06-10 09:00:00,526,92,92,0,0,0,2016-06-10 09:00:00,526,52,28,10,38,90,2016-06-10 09:00:00,526,39754,39535
"219",12634,2016-06-10 10:00:00,526,78,78,0,0,0,2016-06-10 10:00:00,526,63,53,29,82,145,2016-06-10 10:00:00,526,37074,36867
"220",12635,2016-06-10 11:00:00,526,112,112,0,0,0,2016-06-10 11:00:00,526,120,141,83,224,344,2016-06-10 11:00:00,526,39667,39446
"221",12636,2016-06-10 12:00:00,526,159,159,0,0,0,2016-06-10 12:00:00,526,233,278,157,435,668,2016-06-10 12:00:00,526,48275,48052
"222",12637,2016-06-10 13:00:00,526,201,201,0,0,0,2016-06-10 13:00:00,526,430,602,335,937,1367,2016-06-10 13:00:00,526,58000,57684
"223",12638,2016-06-10 14:00:00,526,266,266,0,0,0,2016-06-10 14:00:00,526,564,728,385,1113,1677,2016-06-10 14:00:00,526,61158,60801
"224",12639,2016-06-10 15:00:00,526,211,211,0,0,0,2016-06-10 15:00:00,526,636,833,445,1278,1914,2016-06-10 15:00:00,526,60068,59764
"225",12640,2016-06-10 16:00:00,526,234,234,0,0,0,2016-06-10 16:00:00,526,710,1016,495,1511,2221,2016-06-10 16:00:00,526,53439,53155
"226",12641,2016-06-10 17:00:00,526,245,245,0,0,0,2016-06-10 17:00:00,526,716,1051,477,1528,2244,2016-06-10 17:00:00,526,51796,51544
"227",12642,2016-06-10 18:00:00,526,250,250,0,0,0,2016-06-10 18:00:00,526,778,1209,566,1775,2553,2016-06-10 18:00:00,526,53018,52747
"228",12643,2016-06-10 19:00:00,526,242,242,0,0,0,2016-06-10 19:00:00,526,691,1318,576,1894,2585,2016-06-10 19:00:00,526,49516,49224
"229",12644,2016-06-10 20:00:00,526,226,226,0,0,0,2016-06-10 20:00:00,526,751,1371,631,2002,2753,2016-06-10 20:00:00,526,44970,44740
"230",12645,2016-06-10 21:00:00,526,218,218,0,0,0,2016-06-10 21:00:00,526,643,1317,595,1912,2555,2016-06-10 21:00:00,526,37761,37569
"231",12646,2016-06-10 22:00:00,526,161,161,0,0,0,2016-06-10 22:00:00,526,571,1289,587,1876,2447,2016-06-10 22:00:00,526,30824,30668
"232",12647,2016-06-10 23:00:00,526,158,158,0,0,0,2016-06-10 23:00:00,526,489,1227,500,1727,2216,2016-06-10 23:00:00,526,26368,26262
"233",12648,2016-06-11 00:00:00,527,126,126,0,0,0,2016-06-11 00:00:00,527,414,1222,515,1737,2151,2016-06-11 00:00:00,527,23881,23773
"234",12649,2016-06-11 01:00:00,527,150,150,0,0,0,2016-06-11 01:00:00,527,382,952,391,1343,1725,2016-06-11 01:00:00,527,23351,23271
"235",12650,2016-06-11 02:00:00,527,130,130,0,0,0,2016-06-11 02:00:00,527,326,818,331,1149,1475,2016-06-11 02:00:00,527,23334,23235
"236",12651,2016-06-11 03:00:00,527,111,111,0,0,0,2016-06-11 03:00:00,527,226,617,272,889,1115,2016-06-11 03:00:00,527,22608,22506
"237",12652,2016-06-11 04:00:00,527,124,124,0,0,0,2016-06-11 04:00:00,527,155,521,212,733,888,2016-06-11 04:00:00,527,22618,22519
"238",12653,2016-06-11 05:00:00,527,87,87,0,0,0,2016-06-11 05:00:00,527,94,279,101,380,474,2016-06-11 05:00:00,527,21497,21413
"239",12654,2016-06-11 06:00:00,527,87,87,0,0,0,2016-06-11 06:00:00,527,85,131,43,174,259,2016-06-11 06:00:00,527,21620,21523
"240",12655,2016-06-11 07:00:00,527,71,71,0,0,0,2016-06-11 07:00:00,527,48,81,35,116,164,2016-06-11 07:00:00,527,22206,22111
"241",12656,2016-06-11 08:00:00,527,69,69,0,0,0,2016-06-11 08:00:00,527,43,41,19,60,103,2016-06-11 08:00:00,527,21851,21741
"242",12657,2016-06-11 09:00:00,527,78,78,0,0,0,2016-06-11 09:00:00,527,47,35,19,54,101,2016-06-11 09:00:00,527,21541,21452
"243",12658,2016-06-11 10:00:00,527,83,83,0,0,0,2016-06-11 10:00:00,527,71,43,24,67,138,2016-06-11 10:00:00,527,21877,21763
"244",12659,2016-06-11 11:00:00,527,113,113,0,0,0,2016-06-11 11:00:00,527,100,100,60,160,260,2016-06-11 11:00:00,527,22701,22607
"245",12660,2016-06-11 12:00:00,527,106,106,0,0,0,2016-06-11 12:00:00,527,175,209,107,316,491,2016-06-11 12:00:00,527,24234,24129
"246",12661,2016-06-11 13:00:00,527,117,117,0,0,0,2016-06-11 13:00:00,527,279,524,264,788,1067,2016-06-11 13:00:00,527,26466,26354
"247",12662,2016-06-11 14:00:00,527,184,184,0,0,0,2016-06-11 14:00:00,527,364,642,316,958,1322,2016-06-11 14:00:00,527,28172,28045
"248",12663,2016-06-11 15:00:00,527,158,158,0,0,0,2016-06-11 15:00:00,527,519,792,372,1164,1683,2016-06-11 15:00:00,527,29675,29542
"249",12664,2016-06-11 16:00:00,527,188,188,0,0,0,2016-06-11 16:00:00,527,531,822,358,1180,1711,2016-06-11 16:00:00,527,29556,29423
"250",12665,2016-06-11 17:00:00,527,168,168,0,0,0,2016-06-11 17:00:00,527,473,932,394,1326,1799,2016-06-11 17:00:00,527,28614,28476
"251",12666,2016-06-11 18:00:00,527,179,179,0,0,0,2016-06-11 18:00:00,527,551,1058,443,1501,2052,2016-06-11 18:00:00,527,28571,28447
"252",12667,2016-06-11 19:00:00,527,225,225,0,0,0,2016-06-11 19:00:00,527,520,991,446,1437,1957,2016-06-11 19:00:00,527,27011,26875
"253",12668,2016-06-11 20:00:00,527,176,176,0,0,0,2016-06-11 20:00:00,527,480,1100,450,1550,2030,2016-06-11 20:00:00,527,25723,25616
"254",12669,2016-06-11 21:00:00,527,188,188,0,0,0,2016-06-11 21:00:00,527,478,1183,483,1666,2144,2016-06-11 21:00:00,527,24433,24320
"255",12670,2016-06-11 22:00:00,527,164,164,0,0,0,2016-06-11 22:00:00,527,410,1083,460,1543,1953,2016-06-11 22:00:00,527,22532,22438
"256",12671,2016-06-11 23:00:00,527,142,142,0,0,0,2016-06-11 23:00:00,527,355,1144,472,1616,1971,2016-06-11 23:00:00,527,21639,21545
"257",12672,2016-06-12 00:00:00,528,131,131,0,0,0,2016-06-12 00:00:00,528,388,1070,437,1507,1895,2016-06-12 00:00:00,528,21018,20906
"258",12673,2016-06-12 01:00:00,528,155,155,0,0,0,2016-06-12 01:00:00,528,306,842,331,1173,1479,2016-06-12 01:00:00,528,21159,21071
"259",12674,2016-06-12 02:00:00,528,124,124,0,0,0,2016-06-12 02:00:00,528,244,892,335,1227,1471,2016-06-12 02:00:00,528,22760,22665
"260",12675,2016-06-12 03:00:00,528,117,117,0,0,0,2016-06-12 03:00:00,528,169,584,225,809,978,2016-06-12 03:00:00,528,21466,21385
"261",12676,2016-06-12 04:00:00,528,111,111,0,0,0,2016-06-12 04:00:00,528,136,475,203,678,814,2016-06-12 04:00:00,528,20338,20239
"262",12677,2016-06-12 05:00:00,528,61,61,0,0,0,2016-06-12 05:00:00,528,103,225,100,325,428,2016-06-12 05:00:00,528,20018,19951
"263",12678,2016-06-12 06:00:00,528,84,84,0,0,0,2016-06-12 06:00:00,528,80,105,38,143,223,2016-06-12 06:00:00,528,20705,20621
"264",12679,2016-06-12 07:00:00,528,87,87,0,0,0,2016-06-12 07:00:00,528,67,94,33,127,194,2016-06-12 07:00:00,528,21005,20903
"265",12680,2016-06-12 08:00:00,528,84,84,0,0,0,2016-06-12 08:00:00,528,59,48,19,67,126,2016-06-12 08:00:00,528,21838,21738
"266",12681,2016-06-12 09:00:00,528,65,65,0,0,0,2016-06-12 09:00:00,528,50,39,15,54,104,2016-06-12 09:00:00,528,21718,21619
"267",12682,2016-06-12 10:00:00,528,61,61,0,0,0,2016-06-12 10:00:00,528,40,50,26,76,116,2016-06-12 10:00:00,528,21604,21509
"268",12683,2016-06-12 11:00:00,528,80,80,0,0,0,2016-06-12 11:00:00,528,67,61,28,89,156,2016-06-12 11:00:00,528,22659,22555
"269",12684,2016-06-12 12:00:00,528,91,91,0,0,0,2016-06-12 12:00:00,528,143,167,83,250,393,2016-06-12 12:00:00,528,23724,23612
"270",12685,2016-06-12 13:00:00,528,122,122,0,0,0,2016-06-12 13:00:00,528,227,350,164,514,741,2016-06-12 13:00:00,528,24942,24849
"271",12686,2016-06-12 14:00:00,528,142,142,0,0,0,2016-06-12 14:00:00,528,296,542,244,786,1082,2016-06-12 14:00:00,528,27210,27098
"272",12687,2016-06-12 15:00:00,528,153,153,0,0,0,2016-06-12 15:00:00,528,363,800,329,1129,1492,2016-06-12 15:00:00,528,28362,28236
"273",12688,2016-06-12 16:00:00,528,154,154,0,0,0,2016-06-12 16:00:00,528,397,820,367,1187,1584,2016-06-12 16:00:00,528,28543,28397
"274",12689,2016-06-12 17:00:00,528,162,162,0,0,0,2016-06-12 17:00:00,528,410,925,414,1339,1749,2016-06-12 17:00:00,528,28865,28735
"275",12690,2016-06-12 18:00:00,528,182,182,0,0,0,2016-06-12 18:00:00,528,426,1007,407,1414,1840,2016-06-12 18:00:00,528,28529,28382
"276",12691,2016-06-12 19:00:00,528,191,191,0,0,0,2016-06-12 19:00:00,528,402,1016,420,1436,1838,2016-06-12 19:00:00,528,27833,27699
"277",12692,2016-06-12 20:00:00,528,185,185,0,0,0,2016-06-12 20:00:00,528,470,1078,430,1508,1978,2016-06-12 20:00:00,528,26607,26485
"278",12693,2016-06-12 21:00:00,528,156,156,0,0,0,2016-06-12 21:00:00,528,437,1125,404,1529,1966,2016-06-12 21:00:00,528,25684,25570
"279",12694,2016-06-12 22:00:00,528,160,160,0,0,0,2016-06-12 22:00:00,528,392,1224,481,1705,2097,2016-06-12 22:00:00,528,24135,24022
"280",12695,2016-06-12 23:00:00,528,158,158,0,0,0,2016-06-12 23:00:00,528,364,1170,485,1655,2019,2016-06-12 23:00:00,528,24023,23917
"281",12696,2016-06-13 00:00:00,529,150,150,0,0,0,2016-06-13 00:00:00,529,319,1121,461,1582,1901,2016-06-13 00:00:00,529,25499,25386
"282",12697,2016-06-13 01:00:00,529,160,160,0,0,0,2016-06-13 01:00:00,529,299,953,381,1334,1633,2016-06-13 01:00:00,529,28151,28001
"283",12698,2016-06-13 02:00:00,529,131,131,0,0,0,2016-06-13 02:00:00,529,260,812,297,1109,1369,2016-06-13 02:00:00,529,29732,29593
"284",12699,2016-06-13 03:00:00,529,127,127,0,0,0,2016-06-13 03:00:00,529,206,512,209,721,927,2016-06-13 03:00:00,529,29267,29131
"285",12700,2016-06-13 04:00:00,529,93,93,0,0,0,2016-06-13 04:00:00,529,133,416,162,578,711,2016-06-13 04:00:00,529,28031,27887
"286",12701,2016-06-13 05:00:00,529,90,90,0,0,0,2016-06-13 05:00:00,529,110,190,71,261,371,2016-06-13 05:00:00,529,29400,29252
"287",12702,2016-06-13 06:00:00,529,71,71,0,0,0,2016-06-13 06:00:00,529,88,96,41,137,225,2016-06-13 06:00:00,529,36376,36197
"288",12703,2016-06-13 07:00:00,529,93,93,0,0,0,2016-06-13 07:00:00,529,56,57,32,89,145,2016-06-13 07:00:00,529,41317,41076
"289",12704,2016-06-13 08:00:00,529,88,88,0,0,0,2016-06-13 08:00:00,529,47,51,30,81,128,2016-06-13 08:00:00,529,44144,43894
"290",12705,2016-06-13 09:00:00,529,108,108,0,0,0,2016-06-13 09:00:00,529,72,48,19,67,139,2016-06-13 09:00:00,529,44183,43908
"291",12706,2016-06-13 10:00:00,529,87,87,0,0,0,2016-06-13 10:00:00,529,65,59,27,86,151,2016-06-13 10:00:00,529,41391,41157
"292",12707,2016-06-13 11:00:00,529,101,101,0,0,0,2016-06-13 11:00:00,529,113,97,57,154,267,2016-06-13 11:00:00,529,44350,44107
"293",12708,2016-06-13 12:00:00,529,114,114,0,0,0,2016-06-13 12:00:00,529,278,253,130,383,661,2016-06-13 12:00:00,529,52372,52118
"294",12709,2016-06-13 13:00:00,529,153,153,0,0,0,2016-06-13 13:00:00,529,482,598,342,940,1422,2016-06-13 13:00:00,529,62751,62401
"295",12710,2016-06-13 14:00:00,529,211,211,0,0,0,2016-06-13 14:00:00,529,639,761,382,1143,1782,2016-06-13 14:00:00,529,67889,67514
"296",12711,2016-06-13 15:00:00,529,255,255,0,0,0,2016-06-13 15:00:00,529,777,972,527,1499,2276,2016-06-13 15:00:00,529,66592,66213
"297",12712,2016-06-13 16:00:00,529,293,293,0,0,0,2016-06-13 16:00:00,529,738,1119,587,1706,2444,2016-06-13 16:00:00,529,60488,60153
"298",12713,2016-06-13 17:00:00,529,280,280,0,0,0,2016-06-13 17:00:00,529,766,1195,597,1792,2558,2016-06-13 17:00:00,529,58423,58093
"299",12714,2016-06-13 18:00:00,529,272,272,0,0,0,2016-06-13 18:00:00,529,803,1552,838,2390,3193,2016-06-13 18:00:00,529,60107,59772
"300",12715,2016-06-13 19:00:00,529,236,236,0,0,0,2016-06-13 19:00:00,529,830,1580,790,2370,3200,2016-06-13 19:00:00,529,58607,58281
"301",12716,2016-06-13 20:00:00,529,275,275,0,0,0,2016-06-13 20:00:00,529,783,1612,766,2378,3161,2016-06-13 20:00:00,529,54641,54342
"302",12717,2016-06-13 21:00:00,529,241,241,0,0,0,2016-06-13 21:00:00,529,721,1712,787,2499,3220,2016-06-13 21:00:00,529,45803,45566
"303",12718,2016-06-13 22:00:00,529,222,222,0,0,0,2016-06-13 22:00:00,529,730,1848,857,2705,3435,2016-06-13 22:00:00,529,37467,37282
"304",12719,2016-06-13 23:00:00,529,198,198,0,0,0,2016-06-13 23:00:00,529,610,1797,835,2632,3242,2016-06-13 23:00:00,529,33510,33353
"305",12720,2016-06-14 00:00:00,530,200,200,0,0,0,2016-06-14 00:00:00,530,567,1628,718,2346,2913,2016-06-14 00:00:00,530,32588,32432
"306",12721,2016-06-14 01:00:00,530,171,171,0,0,0,2016-06-14 01:00:00,530,448,1316,563,1879,2327,2016-06-14 01:00:00,530,33680,33512
"307",12722,2016-06-14 02:00:00,530,155,155,0,0,0,2016-06-14 02:00:00,530,377,1017,454,1471,1848,2016-06-14 02:00:00,530,33814,33659
"308",12723,2016-06-14 03:00:00,530,147,147,0,0,0,2016-06-14 03:00:00,530,298,715,326,1041,1339,2016-06-14 03:00:00,530,32049,31873
"309",12724,2016-06-14 04:00:00,530,136,136,0,0,0,2016-06-14 04:00:00,530,201,558,246,804,1005,2016-06-14 04:00:00,530,31196,31048
"310",12725,2016-06-14 05:00:00,530,103,103,0,0,0,2016-06-14 05:00:00,530,94,275,111,386,480,2016-06-14 05:00:00,530,32398,32235
"311",12726,2016-06-14 06:00:00,530,94,94,0,0,0,2016-06-14 06:00:00,530,77,132,62,194,271,2016-06-14 06:00:00,530,39225,39004
"312",12727,2016-06-14 07:00:00,530,79,79,0,0,0,2016-06-14 07:00:00,530,68,85,36,121,189,2016-06-14 07:00:00,530,43666,43416
"313",12728,2016-06-14 08:00:00,530,76,76,0,0,0,2016-06-14 08:00:00,530,72,46,26,72,144,2016-06-14 08:00:00,530,46198,45909
"314",12729,2016-06-14 09:00:00,530,111,111,0,0,0,2016-06-14 09:00:00,530,64,30,16,46,110,2016-06-14 09:00:00,530,46268,46003
"315",12730,2016-06-14 10:00:00,530,94,94,0,0,0,2016-06-14 10:00:00,530,89,82,39,121,210,2016-06-14 10:00:00,530,43623,43377
"316",12731,2016-06-14 11:00:00,530,125,125,0,0,0,2016-06-14 11:00:00,530,114,187,95,282,396,2016-06-14 11:00:00,530,45454,45202
"317",12732,2016-06-14 12:00:00,530,114,114,0,0,0,2016-06-14 12:00:00,530,254,303,178,481,735,2016-06-14 12:00:00,530,55932,55654
"318",12733,2016-06-14 13:00:00,530,177,177,0,0,0,2016-06-14 13:00:00,530,444,662,351,1013,1457,2016-06-14 13:00:00,530,66788,66431
"319",12734,2016-06-14 14:00:00,530,217,217,0,0,0,2016-06-14 14:00:00,530,622,807,435,1242,1864,2016-06-14 14:00:00,530,70767,70385
"320",12735,2016-06-14 15:00:00,530,246,246,0,0,0,2016-06-14 15:00:00,530,676,970,528,1498,2174,2016-06-14 15:00:00,530,68861,68463
"321",12736,2016-06-14 16:00:00,530,299,299,0,0,0,2016-06-14 16:00:00,530,647,1204,637,1841,2488,2016-06-14 16:00:00,530,61463,61132
"322",12737,2016-06-14 17:00:00,530,263,263,0,0,0,2016-06-14 17:00:00,530,738,1306,625,1931,2669,2016-06-14 17:00:00,530,60401,60058
"323",12738,2016-06-14 18:00:00,530,292,292,0,0,0,2016-06-14 18:00:00,530,741,1434,686,2120,2861,2016-06-14 18:00:00,530,63351,63019
"324",12739,2016-06-14 19:00:00,530,240,240,0,0,0,2016-06-14 19:00:00,530,755,1454,711,2165,2920,2016-06-14 19:00:00,530,62202,61813
"325",12740,2016-06-14 20:00:00,530,256,256,0,0,0,2016-06-14 20:00:00,530,765,1469,655,2124,2889,2016-06-14 20:00:00,530,58623,58306
"326",12741,2016-06-14 21:00:00,530,219,219,0,0,0,2016-06-14 21:00:00,530,723,1681,803,2484,3207,2016-06-14 21:00:00,530,49634,49367
"327",12742,2016-06-14 22:00:00,530,216,216,0,0,0,2016-06-14 22:00:00,530,615,1569,687,2256,2871,2016-06-14 22:00:00,530,40316,40090
"328",12743,2016-06-14 23:00:00,530,189,189,0,0,0,2016-06-14 23:00:00,530,581,1570,729,2299,2880,2016-06-14 23:00:00,530,36208,36028
"329",12744,2016-06-15 00:00:00,531,186,186,0,0,0,2016-06-15 00:00:00,531,488,1508,655,2163,2651,2016-06-15 00:00:00,531,34882,34725
"330",12745,2016-06-15 01:00:00,531,171,171,0,0,0,2016-06-15 01:00:00,531,409,1366,614,1980,2389,2016-06-15 01:00:00,531,35635,35468
"331",12746,2016-06-15 02:00:00,531,147,147,0,0,0,2016-06-15 02:00:00,531,345,1022,426,1448,1793,2016-06-15 02:00:00,531,36763,36574
"332",12747,2016-06-15 03:00:00,531,150,150,0,0,0,2016-06-15 03:00:00,531,266,757,338,1095,1361,2016-06-15 03:00:00,531,34389,34221
"333",12748,2016-06-15 04:00:00,531,174,174,0,0,0,2016-06-15 04:00:00,531,171,556,270,826,997,2016-06-15 04:00:00,531,33087,32939
"334",12749,2016-06-15 05:00:00,531,105,105,0,0,0,2016-06-15 05:00:00,531,113,262,97,359,472,2016-06-15 05:00:00,531,34460,34316
"335",12750,2016-06-15 06:00:00,531,88,88,0,0,0,2016-06-15 06:00:00,531,69,136,49,185,254,2016-06-15 06:00:00,531,41209,40973
"336",12751,2016-06-15 07:00:00,531,109,109,0,0,0,2016-06-15 07:00:00,531,55,77,35,112,167,2016-06-15 07:00:00,531,46096,45835
"337",12752,2016-06-15 08:00:00,531,86,86,0,0,0,2016-06-15 08:00:00,531,43,49,17,66,109,2016-06-15 08:00:00,531,48453,48171
"338",12753,2016-06-15 09:00:00,531,108,108,0,0,0,2016-06-15 09:00:00,531,39,39,17,56,95,2016-06-15 09:00:00,531,48309,48043
"339",12754,2016-06-15 10:00:00,531,96,96,0,0,0,2016-06-15 10:00:00,531,60,57,30,87,147,2016-06-15 10:00:00,531,45544,45281
"340",12755,2016-06-15 11:00:00,531,118,118,0,0,0,2016-06-15 11:00:00,531,103,119,70,189,292,2016-06-15 11:00:00,531,48990,48726
"341",12756,2016-06-15 12:00:00,531,131,131,0,0,0,2016-06-15 12:00:00,531,256,276,169,445,701,2016-06-15 12:00:00,531,58758,58477
"342",12757,2016-06-15 13:00:00,531,172,172,0,0,0,2016-06-15 13:00:00,531,521,570,322,892,1413,2016-06-15 13:00:00,531,71257,70860
"343",12758,2016-06-15 14:00:00,531,235,235,0,0,0,2016-06-15 14:00:00,531,609,754,392,1146,1755,2016-06-15 14:00:00,531,75958,75534
"344",12759,2016-06-15 15:00:00,531,249,249,0,0,0,2016-06-15 15:00:00,531,677,851,448,1299,1976,2016-06-15 15:00:00,531,74767,74332
"345",12760,2016-06-15 16:00:00,531,242,242,0,0,0,2016-06-15 16:00:00,531,701,1059,546,1605,2306,2016-06-15 16:00:00,531,66395,66025
"346",12761,2016-06-15 17:00:00,531,230,230,0,0,0,2016-06-15 17:00:00,531,765,1123,545,1668,2433,2016-06-15 17:00:00,531,65222,64864
"347",12762,2016-06-15 18:00:00,531,274,274,0,0,0,2016-06-15 18:00:00,531,888,1290,589,1879,2767,2016-06-15 18:00:00,531,66286,65905
"348",12763,2016-06-15 19:00:00,531,262,262,0,0,0,2016-06-15 19:00:00,531,801,1390,679,2069,2870,2016-06-15 19:00:00,531,64056,63660
"349",12764,2016-06-15 20:00:00,531,254,254,0,0,0,2016-06-15 20:00:00,531,781,1559,718,2277,3058,2016-06-15 20:00:00,531,58653,58306
"350",12765,2016-06-15 21:00:00,531,278,278,0,0,0,2016-06-15 21:00:00,531,794,1468,650,2118,2912,2016-06-15 21:00:00,531,50941,50683
"351",12766,2016-06-15 22:00:00,531,251,251,0,0,0,2016-06-15 22:00:00,531,626,1539,743,2282,2908,2016-06-15 22:00:00,531,40953,40750
"352",12767,2016-06-15 23:00:00,531,222,222,0,0,0,2016-06-15 23:00:00,531,573,1599,735,2334,2907,2016-06-15 23:00:00,531,36970,36792
"353",12768,2016-06-16 00:00:00,532,237,237,0,0,0,2016-06-16 00:00:00,532,531,1508,672,2180,2711,2016-06-16 00:00:00,532,35032,34859
"354",12769,2016-06-16 01:00:00,532,202,202,0,0,0,2016-06-16 01:00:00,532,469,1272,493,1765,2234,2016-06-16 01:00:00,532,36840,36663
"355",12770,2016-06-16 02:00:00,532,195,195,0,0,0,2016-06-16 02:00:00,532,377,998,449,1447,1824,2016-06-16 02:00:00,532,36488,36303
"356",12771,2016-06-16 03:00:00,532,168,168,0,0,0,2016-06-16 03:00:00,532,262,737,309,1046,1308,2016-06-16 03:00:00,532,34338,34175
"357",12772,2016-06-16 04:00:00,532,114,114,0,0,0,2016-06-16 04:00:00,532,168,508,233,741,909,2016-06-16 04:00:00,532,32294,32140
"358",12773,2016-06-16 05:00:00,532,117,117,0,0,0,2016-06-16 05:00:00,532,115,278,112,390,505,2016-06-16 05:00:00,532,33960,33792
"359",12774,2016-06-16 06:00:00,532,103,103,0,0,0,2016-06-16 06:00:00,532,86,156,73,229,315,2016-06-16 06:00:00,532,40506,40284
"360",12775,2016-06-16 07:00:00,532,90,90,0,0,0,2016-06-16 07:00:00,532,71,79,39,118,189,2016-06-16 07:00:00,532,45733,45466
"361",12776,2016-06-16 08:00:00,532,73,73,0,0,0,2016-06-16 08:00:00,532,39,53,27,80,119,2016-06-16 08:00:00,532,47922,47631
"362",12777,2016-06-16 09:00:00,532,110,110,0,0,0,2016-06-16 09:00:00,532,57,49,19,68,125,2016-06-16 09:00:00,532,47562,47276
"363",12778,2016-06-16 10:00:00,532,83,83,0,0,0,2016-06-16 10:00:00,532,73,59,34,93,166,2016-06-16 10:00:00,532,44660,44392
"364",12779,2016-06-16 11:00:00,532,134,134,0,0,0,2016-06-16 11:00:00,532,136,140,77,217,353,2016-06-16 11:00:00,532,47609,47346
"365",12780,2016-06-16 12:00:00,532,108,108,0,0,0,2016-06-16 12:00:00,532,310,296,184,480,790,2016-06-16 12:00:00,532,57673,57413
"366",12781,2016-06-16 13:00:00,532,174,174,0,0,0,2016-06-16 13:00:00,532,497,565,305,870,1367,2016-06-16 13:00:00,532,68742,68350
"367",12782,2016-06-16 14:00:00,532,276,276,0,0,0,2016-06-16 14:00:00,532,706,740,392,1132,1838,2016-06-16 14:00:00,532,72915,72490
"368",12783,2016-06-16 15:00:00,532,261,261,0,0,0,2016-06-16 15:00:00,532,728,937,477,1414,2142,2016-06-16 15:00:00,532,71597,71172
"369",12784,2016-06-16 16:00:00,532,292,292,0,0,0,2016-06-16 16:00:00,532,777,1030,527,1557,2334,2016-06-16 16:00:00,532,65187,64814
"370",12785,2016-06-16 17:00:00,532,255,255,0,0,0,2016-06-16 17:00:00,532,815,1168,554,1722,2537,2016-06-16 17:00:00,532,60549,60208
"371",12786,2016-06-16 18:00:00,532,263,263,0,0,0,2016-06-16 18:00:00,532,781,1256,614,1870,2651,2016-06-16 18:00:00,532,61250,60912
"372",12787,2016-06-16 19:00:00,532,248,248,0,0,0,2016-06-16 19:00:00,532,815,1323,627,1950,2765,2016-06-16 19:00:00,532,58259,57943
"373",12788,2016-06-16 20:00:00,532,268,268,0,0,0,2016-06-16 20:00:00,532,830,1450,687,2137,2967,2016-06-16 20:00:00,532,53581,53302
"374",12789,2016-06-16 21:00:00,532,254,254,0,0,0,2016-06-16 21:00:00,532,704,1532,732,2264,2968,2016-06-16 21:00:00,532,44478,44265
"375",12790,2016-06-16 22:00:00,532,216,216,0,0,0,2016-06-16 22:00:00,532,689,1649,744,2393,3082,2016-06-16 22:00:00,532,36574,36406
"376",12791,2016-06-16 23:00:00,532,223,223,0,0,0,2016-06-16 23:00:00,532,628,1398,611,2009,2637,2016-06-16 23:00:00,532,32596,32462
"377",12792,2016-06-17 00:00:00,533,201,201,0,0,0,2016-06-17 00:00:00,533,496,1351,600,1951,2447,2016-06-17 00:00:00,533,31018,30851
"378",12793,2016-06-17 01:00:00,533,195,195,0,0,0,2016-06-17 01:00:00,533,450,1114,470,1584,2034,2016-06-17 01:00:00,533,31460,31296
"379",12794,2016-06-17 02:00:00,533,178,178,0,0,0,2016-06-17 02:00:00,533,367,936,389,1325,1692,2016-06-17 02:00:00,533,31704,31534
"380",12795,2016-06-17 03:00:00,533,176,176,0,0,0,2016-06-17 03:00:00,533,251,621,271,892,1143,2016-06-17 03:00:00,533,29896,29755
"381",12796,2016-06-17 04:00:00,533,131,131,0,0,0,2016-06-17 04:00:00,533,210,585,264,849,1059,2016-06-17 04:00:00,533,28456,28307
"382",12797,2016-06-17 05:00:00,533,159,159,0,0,0,2016-06-17 05:00:00,533,115,258,113,371,486,2016-06-17 05:00:00,533,28880,28737
"383",12798,2016-06-17 06:00:00,533,106,106,0,0,0,2016-06-17 06:00:00,533,94,157,59,216,310,2016-06-17 06:00:00,533,35617,35452
"384",12799,2016-06-17 07:00:00,533,76,76,0,0,0,2016-06-17 07:00:00,533,65,71,36,107,172,2016-06-17 07:00:00,533,39038,38780
"385",12800,2016-06-17 08:00:00,533,81,81,0,0,0,2016-06-17 08:00:00,533,52,45,13,58,110,2016-06-17 08:00:00,533,40213,39993
"386",12801,2016-06-17 09:00:00,533,96,96,0,0,0,2016-06-17 09:00:00,533,66,50,28,78,144,2016-06-17 09:00:00,533,39618,39402
"387",12802,2016-06-17 10:00:00,533,99,99,0,0,0,2016-06-17 10:00:00,533,62,89,53,142,204,2016-06-17 10:00:00,533,37114,36922
"388",12803,2016-06-17 11:00:00,533,104,104,0,0,0,2016-06-17 11:00:00,533,121,113,69,182,303,2016-06-17 11:00:00,533,40727,40515
"389",12804,2016-06-17 12:00:00,533,145,145,0,0,0,2016-06-17 12:00:00,533,259,255,150,405,664,2016-06-17 12:00:00,533,47909,47672
"390",12805,2016-06-17 13:00:00,533,160,160,0,0,0,2016-06-17 13:00:00,533,501,660,379,1039,1540,2016-06-17 13:00:00,533,57201,56919
"391",12806,2016-06-17 14:00:00,533,244,244,0,0,0,2016-06-17 14:00:00,533,659,709,361,1070,1729,2016-06-17 14:00:00,533,59955,59662
"392",12807,2016-06-17 15:00:00,533,236,236,0,0,0,2016-06-17 15:00:00,533,728,935,492,1427,2155,2016-06-17 15:00:00,533,59420,59086
"393",12808,2016-06-17 16:00:00,533,277,277,0,0,0,2016-06-17 16:00:00,533,689,1055,526,1581,2270,2016-06-17 16:00:00,533,52337,52039
"394",12809,2016-06-17 17:00:00,533,242,242,0,0,0,2016-06-17 17:00:00,533,780,1033,515,1548,2328,2016-06-17 17:00:00,533,50440,50173
"395",12810,2016-06-17 18:00:00,533,248,248,0,0,0,2016-06-17 18:00:00,533,782,1276,612,1888,2670,2016-06-17 18:00:00,533,51077,50808
"396",12811,2016-06-17 19:00:00,533,236,236,0,0,0,2016-06-17 19:00:00,533,751,1394,626,2020,2771,2016-06-17 19:00:00,533,48214,47951
"397",12812,2016-06-17 20:00:00,533,226,226,0,0,0,2016-06-17 20:00:00,533,743,1383,667,2050,2793,2016-06-17 20:00:00,533,43736,43510
"398",12813,2016-06-17 21:00:00,533,255,255,0,0,0,2016-06-17 21:00:00,533,605,1463,725,2188,2793,2016-06-17 21:00:00,533,36658,36468
"399",12814,2016-06-17 22:00:00,533,217,217,0,0,0,2016-06-17 22:00:00,533,552,1535,680,2215,2767,2016-06-17 22:00:00,533,29905,29752
"400",12815,2016-06-17 23:00:00,533,165,165,0,0,0,2016-06-17 23:00:00,533,465,1399,677,2076,2541,2016-06-17 23:00:00,533,25399,25286
"401",12816,2016-06-18 00:00:00,534,169,169,0,0,0,2016-06-18 00:00:00,534,422,1302,580,1882,2304,2016-06-18 00:00:00,534,22805,22687
"402",12817,2016-06-18 01:00:00,534,135,135,0,0,0,2016-06-18 01:00:00,534,372,1113,474,1587,1959,2016-06-18 01:00:00,534,22459,22374
"403",12818,2016-06-18 02:00:00,534,133,133,0,0,0,2016-06-18 02:00:00,534,282,1052,474,1526,1808,2016-06-18 02:00:00,534,22473,22362
"404",12819,2016-06-18 03:00:00,534,129,129,0,0,0,2016-06-18 03:00:00,534,227,786,347,1133,1360,2016-06-18 03:00:00,534,22059,21964
"405",12820,2016-06-18 04:00:00,534,117,117,0,0,0,2016-06-18 04:00:00,534,158,545,269,814,972,2016-06-18 04:00:00,534,21156,21067
"406",12821,2016-06-18 05:00:00,534,84,84,0,0,0,2016-06-18 05:00:00,534,142,348,142,490,632,2016-06-18 05:00:00,534,20524,20444
"407",12822,2016-06-18 06:00:00,534,80,80,0,0,0,2016-06-18 06:00:00,534,86,194,99,293,379,2016-06-18 06:00:00,534,20668,20581
"408",12823,2016-06-18 07:00:00,534,67,67,0,0,0,2016-06-18 07:00:00,534,71,126,55,181,252,2016-06-18 07:00:00,534,21261,21169
"409",12824,2016-06-18 08:00:00,534,64,64,0,0,0,2016-06-18 08:00:00,534,41,56,25,81,122,2016-06-18 08:00:00,534,20896,20808
"410",12825,2016-06-18 09:00:00,534,88,88,0,0,0,2016-06-18 09:00:00,534,24,66,34,100,124,2016-06-18 09:00:00,534,21096,20996
"411",12826,2016-06-18 10:00:00,534,87,87,0,0,0,2016-06-18 10:00:00,534,60,81,33,114,174,2016-06-18 10:00:00,534,21379,21270
"412",12827,2016-06-18 11:00:00,534,80,80,0,0,0,2016-06-18 11:00:00,534,108,108,61,169,277,2016-06-18 11:00:00,534,22116,22017
"413",12828,2016-06-18 12:00:00,534,63,63,0,0,0,2016-06-18 12:00:00,534,187,278,146,424,611,2016-06-18 12:00:00,534,24075,23959
"414",12829,2016-06-18 13:00:00,534,88,88,0,0,0,2016-06-18 13:00:00,534,250,558,304,862,1112,2016-06-18 13:00:00,534,25768,25663
"415",12830,2016-06-18 14:00:00,534,141,141,0,0,0,2016-06-18 14:00:00,534,438,678,353,1031,1469,2016-06-18 14:00:00,534,27085,26946
"416",12831,2016-06-18 15:00:00,534,149,149,0,0,0,2016-06-18 15:00:00,534,453,852,408,1260,1713,2016-06-18 15:00:00,534,28502,28369
"417",12832,2016-06-18 16:00:00,534,199,199,0,0,0,2016-06-18 16:00:00,534,550,1032,499,1531,2081,2016-06-18 16:00:00,534,28192,28051
"418",12833,2016-06-18 17:00:00,534,196,196,0,0,0,2016-06-18 17:00:00,534,455,1053,484,1537,1992,2016-06-18 17:00:00,534,27404,27278
"419",12834,2016-06-18 18:00:00,534,201,201,0,0,0,2016-06-18 18:00:00,534,478,1184,535,1719,2197,2016-06-18 18:00:00,534,26497,26372
"420",12835,2016-06-18 19:00:00,534,204,204,0,0,0,2016-06-18 19:00:00,534,488,1163,540,1703,2191,2016-06-18 19:00:00,534,25877,25763
"421",12836,2016-06-18 20:00:00,534,179,179,0,0,0,2016-06-18 20:00:00,534,479,1220,544,1764,2243,2016-06-18 20:00:00,534,24271,24150
"422",12837,2016-06-18 21:00:00,534,167,167,0,0,0,2016-06-18 21:00:00,534,408,1338,594,1932,2340,2016-06-18 21:00:00,534,22878,22785
"423",12838,2016-06-18 22:00:00,534,145,145,0,0,0,2016-06-18 22:00:00,534,401,1252,595,1847,2248,2016-06-18 22:00:00,534,21353,21268
"424",12839,2016-06-18 23:00:00,534,174,174,0,0,0,2016-06-18 23:00:00,534,410,1235,572,1807,2217,2016-06-18 23:00:00,534,20059,19952
"425",12840,2016-06-19 00:00:00,535,141,141,0,0,0,2016-06-19 00:00:00,535,358,1146,517,1663,2021,2016-06-19 00:00:00,535,19931,19848
"426",12841,2016-06-19 01:00:00,535,137,137,0,0,0,2016-06-19 01:00:00,535,330,973,398,1371,1701,2016-06-19 01:00:00,535,19892,19811
"427",12842,2016-06-19 02:00:00,535,124,124,0,0,0,2016-06-19 02:00:00,535,241,881,373,1254,1495,2016-06-19 02:00:00,535,20429,20351
"428",12843,2016-06-19 03:00:00,535,136,136,0,0,0,2016-06-19 03:00:00,535,187,669,287,956,1143,2016-06-19 03:00:00,535,19774,19692
"429",12844,2016-06-19 04:00:00,535,100,100,0,0,0,2016-06-19 04:00:00,535,114,554,262,816,930,2016-06-19 04:00:00,535,19743,19669
"430",12845,2016-06-19 05:00:00,535,94,94,0,0,0,2016-06-19 05:00:00,535,70,255,106,361,431,2016-06-19 05:00:00,535,19238,19157
"431",12846,2016-06-19 06:00:00,535,61,61,0,0,0,2016-06-19 06:00:00,535,78,138,62,200,278,2016-06-19 06:00:00,535,19444,19360
"432",12847,2016-06-19 07:00:00,535,83,83,0,0,0,2016-06-19 07:00:00,535,60,73,27,100,160,2016-06-19 07:00:00,535,20251,20147
"433",12848,2016-06-19 08:00:00,535,88,88,0,0,0,2016-06-19 08:00:00,535,46,38,16,54,100,2016-06-19 08:00:00,535,20205,20103
"434",12849,2016-06-19 09:00:00,535,82,82,0,0,0,2016-06-19 09:00:00,535,50,35,22,57,107,2016-06-19 09:00:00,535,20709,20615
"435",12850,2016-06-19 10:00:00,535,79,79,0,0,0,2016-06-19 10:00:00,535,51,46,22,68,119,2016-06-19 10:00:00,535,20989,20897
"436",12851,2016-06-19 11:00:00,535,93,93,0,0,0,2016-06-19 11:00:00,535,84,82,48,130,214,2016-06-19 11:00:00,535,21397,21291
"437",12852,2016-06-19 12:00:00,535,109,109,0,0,0,2016-06-19 12:00:00,535,108,210,107,317,425,2016-06-19 12:00:00,535,22821,22703
"438",12853,2016-06-19 13:00:00,535,130,130,0,0,0,2016-06-19 13:00:00,535,182,415,236,651,833,2016-06-19 13:00:00,535,24036,23918
"439",12854,2016-06-19 14:00:00,535,158,158,0,0,0,2016-06-19 14:00:00,535,303,499,277,776,1079,2016-06-19 14:00:00,535,25680,25563
"440",12855,2016-06-19 15:00:00,535,159,159,0,0,0,2016-06-19 15:00:00,535,337,675,332,1007,1344,2016-06-19 15:00:00,535,26945,26833
"441",12856,2016-06-19 16:00:00,535,169,169,0,0,0,2016-06-19 16:00:00,535,321,821,395,1216,1537,2016-06-19 16:00:00,535,26612,26494
"442",12857,2016-06-19 17:00:00,535,167,167,0,0,0,2016-06-19 17:00:00,535,377,913,441,1354,1731,2016-06-19 17:00:00,535,26393,26268
"443",12858,2016-06-19 18:00:00,535,193,193,0,0,0,2016-06-19 18:00:00,535,425,1012,470,1482,1907,2016-06-19 18:00:00,535,26210,26096
"444",12859,2016-06-19 19:00:00,535,171,171,0,0,0,2016-06-19 19:00:00,535,444,1094,479,1573,2017,2016-06-19 19:00:00,535,25342,25212
"445",12860,2016-06-19 20:00:00,535,164,164,0,0,0,2016-06-19 20:00:00,535,469,1101,514,1615,2084,2016-06-19 20:00:00,535,24198,24076
"446",12861,2016-06-19 21:00:00,535,160,160,0,0,0,2016-06-19 21:00:00,535,370,1154,540,1694,2064,2016-06-19 21:00:00,535,23660,23554
"447",12862,2016-06-19 22:00:00,535,161,161,0,0,0,2016-06-19 22:00:00,535,328,1146,512,1658,1986,2016-06-19 22:00:00,535,22227,22122
"448",12863,2016-06-19 23:00:00,535,169,169,0,0,0,2016-06-19 23:00:00,535,332,1165,487,1652,1984,2016-06-19 23:00:00,535,22509,22396
"449",12864,2016-06-20 00:00:00,536,156,156,0,0,0,2016-06-20 00:00:00,536,309,1024,472,1496,1805,2016-06-20 00:00:00,536,23642,23530
"450",12865,2016-06-20 01:00:00,536,193,193,0,0,0,2016-06-20 01:00:00,536,260,824,355,1179,1439,2016-06-20 01:00:00,536,26842,26707
"451",12866,2016-06-20 02:00:00,536,151,151,0,0,0,2016-06-20 02:00:00,536,227,709,312,1021,1248,2016-06-20 02:00:00,536,27164,27013
"452",12867,2016-06-20 03:00:00,536,139,139,0,0,0,2016-06-20 03:00:00,536,160,735,314,1049,1209,2016-06-20 03:00:00,536,27219,27073
"453",12868,2016-06-20 04:00:00,536,136,136,0,0,0,2016-06-20 04:00:00,536,139,522,240,762,901,2016-06-20 04:00:00,536,27305,27181
"454",12869,2016-06-20 05:00:00,536,120,120,0,0,0,2016-06-20 05:00:00,536,74,227,109,336,410,2016-06-20 05:00:00,536,28657,28504
"455",12870,2016-06-20 06:00:00,536,95,95,0,0,0,2016-06-20 06:00:00,536,61,99,44,143,204,2016-06-20 06:00:00,536,34951,34754
"456",12871,2016-06-20 07:00:00,536,99,99,0,0,0,2016-06-20 07:00:00,536,55,82,27,109,164,2016-06-20 07:00:00,536,40049,39831
"457",12872,2016-06-20 08:00:00,536,112,112,0,0,0,2016-06-20 08:00:00,536,48,29,11,40,88,2016-06-20 08:00:00,536,42588,42334
"458",12873,2016-06-20 09:00:00,536,107,107,0,0,0,2016-06-20 09:00:00,536,39,35,10,45,84,2016-06-20 09:00:00,536,42668,42417
"459",12874,2016-06-20 10:00:00,536,112,112,0,0,0,2016-06-20 10:00:00,536,54,53,20,73,127,2016-06-20 10:00:00,536,40246,39992
"460",12875,2016-06-20 11:00:00,536,115,115,0,0,0,2016-06-20 11:00:00,536,136,119,67,186,322,2016-06-20 11:00:00,536,42302,42065
"461",12876,2016-06-20 12:00:00,536,142,142,0,0,0,2016-06-20 12:00:00,536,246,263,150,413,659,2016-06-20 12:00:00,536,51042,50770
"462",12877,2016-06-20 13:00:00,536,187,187,0,0,0,2016-06-20 13:00:00,536,481,593,327,920,1401,2016-06-20 13:00:00,536,61854,61538
"463",12878,2016-06-20 14:00:00,536,275,275,0,0,0,2016-06-20 14:00:00,536,608,701,395,1096,1704,2016-06-20 14:00:00,536,66449,66066
"464",12879,2016-06-20 15:00:00,536,244,244,0,0,0,2016-06-20 15:00:00,536,731,989,524,1513,2244,2016-06-20 15:00:00,536,64945,64595
"465",12880,2016-06-20 16:00:00,536,228,228,0,0,0,2016-06-20 16:00:00,536,791,1087,554,1641,2432,2016-06-20 16:00:00,536,57351,57028
"466",12881,2016-06-20 17:00:00,536,255,255,0,0,0,2016-06-20 17:00:00,536,735,1193,605,1798,2533,2016-06-20 17:00:00,536,56178,55862
"467",12882,2016-06-20 18:00:00,536,321,321,0,0,0,2016-06-20 18:00:00,536,897,1270,568,1838,2735,2016-06-20 18:00:00,536,58001,57668
"468",12883,2016-06-20 19:00:00,536,265,265,0,0,0,2016-06-20 19:00:00,536,852,1477,710,2187,3039,2016-06-20 19:00:00,536,55985,55666
"469",12884,2016-06-20 20:00:00,536,264,264,0,0,0,2016-06-20 20:00:00,536,927,1538,776,2314,3241,2016-06-20 20:00:00,536,51675,51382
"470",12885,2016-06-20 21:00:00,536,230,230,0,0,0,2016-06-20 21:00:00,536,767,1548,732,2280,3047,2016-06-20 21:00:00,536,43806,43575
"471",12886,2016-06-20 22:00:00,536,253,253,0,0,0,2016-06-20 22:00:00,536,674,1583,776,2359,3033,2016-06-20 22:00:00,536,35672,35495
"472",12887,2016-06-20 23:00:00,536,213,213,0,0,0,2016-06-20 23:00:00,536,586,1704,769,2473,3059,2016-06-20 23:00:00,536,31592,31449
"473",12888,2016-06-21 00:00:00,537,211,211,0,0,0,2016-06-21 00:00:00,537,498,1411,645,2056,2554,2016-06-21 00:00:00,537,30568,30452
"474",12889,2016-06-21 01:00:00,537,206,206,0,0,0,2016-06-21 01:00:00,537,491,1145,471,1616,2107,2016-06-21 01:00:00,537,32052,31895
"475",12890,2016-06-21 02:00:00,537,176,176,0,0,0,2016-06-21 02:00:00,537,390,1029,438,1467,1857,2016-06-21 02:00:00,537,32159,31989
"476",12891,2016-06-21 03:00:00,537,117,117,0,0,0,2016-06-21 03:00:00,537,272,716,331,1047,1319,2016-06-21 03:00:00,537,30207,30040
"477",12892,2016-06-21 04:00:00,537,153,153,0,0,0,2016-06-21 04:00:00,537,169,529,230,759,928,2016-06-21 04:00:00,537,29173,29007
"478",12893,2016-06-21 05:00:00,537,111,111,0,0,0,2016-06-21 05:00:00,537,115,246,107,353,468,2016-06-21 05:00:00,537,30886,30726
"479",12894,2016-06-21 06:00:00,537,94,94,0,0,0,2016-06-21 06:00:00,537,107,98,41,139,246,2016-06-21 06:00:00,537,37164,36970
"480",12895,2016-06-21 07:00:00,537,94,94,0,0,0,2016-06-21 07:00:00,537,68,82,29,111,179,2016-06-21 07:00:00,537,42621,42394
"481",12896,2016-06-21 08:00:00,537,90,90,0,0,0,2016-06-21 08:00:00,537,44,38,18,56,100,2016-06-21 08:00:00,537,44526,44246
"482",12897,2016-06-21 09:00:00,537,97,97,0,0,0,2016-06-21 09:00:00,537,24,52,30,82,106,2016-06-21 09:00:00,537,44303,44049
"483",12898,2016-06-21 10:00:00,537,101,101,0,0,0,2016-06-21 10:00:00,537,66,57,32,89,155,2016-06-21 10:00:00,537,41101,40871
"484",12899,2016-06-21 11:00:00,537,109,109,0,0,0,2016-06-21 11:00:00,537,125,137,82,219,344,2016-06-21 11:00:00,537,44225,43984
"485",12900,2016-06-21 12:00:00,537,126,126,0,0,0,2016-06-21 12:00:00,537,264,280,167,447,711,2016-06-21 12:00:00,537,53714,53442
"486",12901,2016-06-21 13:00:00,537,196,196,0,0,0,2016-06-21 13:00:00,537,510,630,397,1027,1537,2016-06-21 13:00:00,537,64370,64005
"487",12902,2016-06-21 14:00:00,537,287,287,0,0,0,2016-06-21 14:00:00,537,612,748,425,1173,1785,2016-06-21 14:00:00,537,68864,68505
"488",12903,2016-06-21 15:00:00,537,278,278,0,0,0,2016-06-21 15:00:00,537,645,952,490,1442,2087,2016-06-21 15:00:00,537,65966,65590
"489",12904,2016-06-21 16:00:00,537,271,271,0,0,0,2016-06-21 16:00:00,537,718,1110,579,1689,2407,2016-06-21 16:00:00,537,57954,57635
"490",12905,2016-06-21 17:00:00,537,340,340,0,0,0,2016-06-21 17:00:00,537,722,1174,595,1769,2491,2016-06-21 17:00:00,537,57511,57141
"491",12906,2016-06-21 18:00:00,537,255,255,0,0,0,2016-06-21 18:00:00,537,850,1317,650,1967,2817,2016-06-21 18:00:00,537,59081,58731
"492",12907,2016-06-21 19:00:00,537,246,246,0,0,0,2016-06-21 19:00:00,537,838,1336,689,2025,2863,2016-06-21 19:00:00,537,57685,57345
"493",12908,2016-06-21 20:00:00,537,263,263,0,0,0,2016-06-21 20:00:00,537,776,1534,772,2306,3082,2016-06-21 20:00:00,537,53576,53291
"494",12909,2016-06-21 21:00:00,537,258,258,0,0,0,2016-06-21 21:00:00,537,726,1605,786,2391,3117,2016-06-21 21:00:00,537,45027,44831
"495",12910,2016-06-21 22:00:00,537,242,242,0,0,0,2016-06-21 22:00:00,537,688,1542,694,2236,2924,2016-06-21 22:00:00,537,36267,36075
"496",12911,2016-06-21 23:00:00,537,219,219,0,0,0,2016-06-21 23:00:00,537,558,1489,622,2111,2669,2016-06-21 23:00:00,537,32502,32357
"497",12912,2016-06-22 00:00:00,538,214,214,0,0,0,2016-06-22 00:00:00,538,531,1366,627,1993,2524,2016-06-22 00:00:00,538,30742,30596
"498",12913,2016-06-22 01:00:00,538,175,175,0,0,0,2016-06-22 01:00:00,538,422,1201,510,1711,2133,2016-06-22 01:00:00,538,31814,31650
"499",12914,2016-06-22 02:00:00,538,155,155,0,0,0,2016-06-22 02:00:00,538,385,1113,461,1574,1959,2016-06-22 02:00:00,538,32183,32031
"500",12915,2016-06-22 03:00:00,538,177,177,0,0,0,2016-06-22 03:00:00,538,254,807,354,1161,1415,2016-06-22 03:00:00,538,30312,30164
"501",12916,2016-06-22 04:00:00,538,159,159,0,0,0,2016-06-22 04:00:00,538,176,501,202,703,879,2016-06-22 04:00:00,538,29488,29341
"502",12917,2016-06-22 05:00:00,538,125,125,0,0,0,2016-06-22 05:00:00,538,113,226,85,311,424,2016-06-22 05:00:00,538,31317,31141
"503",12918,2016-06-22 06:00:00,538,123,123,0,0,0,2016-06-22 06:00:00,538,79,132,57,189,268,2016-06-22 06:00:00,538,37741,37544
"504",12919,2016-06-22 07:00:00,538,116,116,0,0,0,2016-06-22 07:00:00,538,58,59,25,84,142,2016-06-22 07:00:00,538,42533,42298
"505",12920,2016-06-22 08:00:00,538,99,99,0,0,0,2016-06-22 08:00:00,538,59,53,27,80,139,2016-06-22 08:00:00,538,44663,44415
"506",12921,2016-06-22 09:00:00,538,81,81,0,0,0,2016-06-22 09:00:00,538,51,41,19,60,111,2016-06-22 09:00:00,538,44503,44209
"507",12922,2016-06-22 10:00:00,538,106,106,0,0,0,2016-06-22 10:00:00,538,58,69,42,111,169,2016-06-22 10:00:00,538,41810,41568
"508",12923,2016-06-22 11:00:00,538,122,122,0,0,0,2016-06-22 11:00:00,538,106,151,84,235,341,2016-06-22 11:00:00,538,45375,45148
"509",12924,2016-06-22 12:00:00,538,162,162,0,0,0,2016-06-22 12:00:00,538,263,289,174,463,726,2016-06-22 12:00:00,538,54107,53829
"510",12925,2016-06-22 13:00:00,538,234,234,0,0,0,2016-06-22 13:00:00,538,452,621,382,1003,1455,2016-06-22 13:00:00,538,64927,64528
"511",12926,2016-06-22 14:00:00,538,325,325,0,0,0,2016-06-22 14:00:00,538,628,706,381,1087,1715,2016-06-22 14:00:00,538,69529,69138
"512",12927,2016-06-22 15:00:00,538,299,299,0,0,0,2016-06-22 15:00:00,538,661,814,426,1240,1901,2016-06-22 15:00:00,538,66880,66484
"513",12928,2016-06-22 16:00:00,538,309,309,0,0,0,2016-06-22 16:00:00,538,689,967,480,1447,2136,2016-06-22 16:00:00,538,58854,58544
"514",12929,2016-06-22 17:00:00,538,319,319,0,0,0,2016-06-22 17:00:00,538,774,1107,581,1688,2462,2016-06-22 17:00:00,538,56538,56208
"515",12930,2016-06-22 18:00:00,538,323,323,0,0,0,2016-06-22 18:00:00,538,872,1167,581,1748,2620,2016-06-22 18:00:00,538,58089,57778
"516",12931,2016-06-22 19:00:00,538,290,290,0,0,0,2016-06-22 19:00:00,538,831,1154,550,1704,2535,2016-06-22 19:00:00,538,56444,56116
"517",12932,2016-06-22 20:00:00,538,314,314,0,0,0,2016-06-22 20:00:00,538,784,1443,685,2128,2912,2016-06-22 20:00:00,538,52874,52606
"518",12933,2016-06-22 21:00:00,538,305,305,0,0,0,2016-06-22 21:00:00,538,706,1518,705,2223,2929,2016-06-22 21:00:00,538,44482,44240
"519",12934,2016-06-22 22:00:00,538,258,258,0,0,0,2016-06-22 22:00:00,538,645,1843,824,2667,3312,2016-06-22 22:00:00,538,36494,36331
"520",12935,2016-06-22 23:00:00,538,283,283,0,0,0,2016-06-22 23:00:00,538,589,1479,697,2176,2765,2016-06-22 23:00:00,538,32739,32597
"521",12936,2016-06-23 00:00:00,539,233,233,0,0,0,2016-06-23 00:00:00,539,470,1371,599,1970,2440,2016-06-23 00:00:00,539,30566,30412
"522",12937,2016-06-23 01:00:00,539,220,220,0,0,0,2016-06-23 01:00:00,539,409,1345,553,1898,2307,2016-06-23 01:00:00,539,32372,32216
"523",12938,2016-06-23 02:00:00,539,201,201,0,0,0,2016-06-23 02:00:00,539,335,965,433,1398,1733,2016-06-23 02:00:00,539,32633,32479
"524",12939,2016-06-23 03:00:00,539,215,215,0,0,0,2016-06-23 03:00:00,539,237,693,307,1000,1237,2016-06-23 03:00:00,539,31024,30832
"525",12940,2016-06-23 04:00:00,539,168,168,0,0,0,2016-06-23 04:00:00,539,167,490,216,706,873,2016-06-23 04:00:00,539,30254,30105
"526",12941,2016-06-23 05:00:00,539,117,117,0,0,0,2016-06-23 05:00:00,539,123,238,111,349,472,2016-06-23 05:00:00,539,31288,31121
"527",12942,2016-06-23 06:00:00,539,96,96,0,0,0,2016-06-23 06:00:00,539,82,119,52,171,253,2016-06-23 06:00:00,539,37465,37269
"528",12943,2016-06-23 07:00:00,539,101,101,0,0,0,2016-06-23 07:00:00,539,55,72,31,103,158,2016-06-23 07:00:00,539,42470,42234
"529",12944,2016-06-23 08:00:00,539,93,93,0,0,0,2016-06-23 08:00:00,539,59,40,24,64,123,2016-06-23 08:00:00,539,43527,43255
"530",12945,2016-06-23 09:00:00,539,101,101,0,0,0,2016-06-23 09:00:00,539,35,40,29,69,104,2016-06-23 09:00:00,539,43316,43037
"531",12946,2016-06-23 10:00:00,539,121,121,0,0,0,2016-06-23 10:00:00,539,62,60,31,91,153,2016-06-23 10:00:00,539,40576,40350
"532",12947,2016-06-23 11:00:00,539,123,123,0,0,0,2016-06-23 11:00:00,539,120,115,77,192,312,2016-06-23 11:00:00,539,43422,43196
"533",12948,2016-06-23 12:00:00,539,154,154,0,0,0,2016-06-23 12:00:00,539,111,74,49,123,234,2016-06-23 12:00:00,539,51811,51550
"534",12949,2016-06-23 13:00:00,539,191,191,0,0,0,2016-06-23 13:00:00,539,167,173,112,285,452,2016-06-23 13:00:00,539,62840,62480
"535",12950,2016-06-23 14:00:00,539,274,274,0,0,0,2016-06-23 14:00:00,539,616,866,467,1333,1949,2016-06-23 14:00:00,539,66663,66282
"536",12951,2016-06-23 15:00:00,539,270,270,0,0,0,2016-06-23 15:00:00,539,774,1018,498,1516,2290,2016-06-23 15:00:00,539,64956,64585
"537",12952,2016-06-23 16:00:00,539,313,313,0,0,0,2016-06-23 16:00:00,539,720,1238,619,1857,2577,2016-06-23 16:00:00,539,57726,57388
"538",12953,2016-06-23 17:00:00,539,330,330,0,0,0,2016-06-23 17:00:00,539,778,1304,656,1960,2738,2016-06-23 17:00:00,539,55725,55402
"539",12954,2016-06-23 18:00:00,539,339,339,0,0,0,2016-06-23 18:00:00,539,757,1411,678,2089,2846,2016-06-23 18:00:00,539,56370,56071
"540",12955,2016-06-23 19:00:00,539,320,320,0,0,0,2016-06-23 19:00:00,539,811,1443,641,2084,2895,2016-06-23 19:00:00,539,54980,54650
"541",12956,2016-06-23 20:00:00,539,330,330,0,0,0,2016-06-23 20:00:00,539,837,1623,701,2324,3161,2016-06-23 20:00:00,539,80859,80429
"542",12957,2016-06-23 21:00:00,539,290,290,0,0,0,2016-06-23 21:00:00,539,684,1629,704,2333,3017,2016-06-23 21:00:00,539,43463,43233
"543",12958,2016-06-23 22:00:00,539,266,266,0,0,0,2016-06-23 22:00:00,539,567,1619,689,2308,2875,2016-06-23 22:00:00,539,35033,34860
"544",12959,2016-06-23 23:00:00,539,251,251,0,0,0,2016-06-23 23:00:00,539,513,1633,697,2330,2843,2016-06-23 23:00:00,539,31244,31073
"545",12960,2016-06-24 00:00:00,540,260,260,0,0,0,2016-06-24 00:00:00,540,474,1335,549,1884,2358,2016-06-24 00:00:00,540,82593,82319
"546",12961,2016-06-24 01:00:00,540,229,229,0,0,0,2016-06-24 01:00:00,540,424,1301,530,1831,2255,2016-06-24 01:00:00,540,34125,33953
"547",12962,2016-06-24 02:00:00,540,229,229,0,0,0,2016-06-24 02:00:00,540,345,1048,426,1474,1819,2016-06-24 02:00:00,540,95197,94746
"548",12963,2016-06-24 03:00:00,540,211,211,0,0,0,2016-06-24 03:00:00,540,258,738,290,1028,1286,2016-06-24 03:00:00,540,88692,88285
"549",12964,2016-06-24 04:00:00,540,171,171,0,0,0,2016-06-24 04:00:00,540,177,556,213,769,946,2016-06-24 04:00:00,540,81845,81467
"550",12965,2016-06-24 05:00:00,540,155,155,0,0,0,2016-06-24 05:00:00,540,108,307,118,425,533,2016-06-24 05:00:00,540,79000,78619
"551",12966,2016-06-24 06:00:00,540,149,149,0,0,0,2016-06-24 06:00:00,540,79,164,71,235,314,2016-06-24 06:00:00,540,83670,83232
"552",12967,2016-06-24 07:00:00,540,96,96,0,0,0,2016-06-24 07:00:00,540,62,87,38,125,187,2016-06-24 07:00:00,540,83255,82824
"553",12968,2016-06-24 08:00:00,540,119,119,0,0,0,2016-06-24 08:00:00,540,57,44,16,60,117,2016-06-24 08:00:00,540,80991,80556
"554",12969,2016-06-24 09:00:00,540,92,92,0,0,0,2016-06-24 09:00:00,540,56,50,18,68,124,2016-06-24 09:00:00,540,83669,83198
"555",12970,2016-06-24 10:00:00,540,110,110,0,0,0,2016-06-24 10:00:00,540,80,77,36,113,193,2016-06-24 10:00:00,540,89158,88750
"556",12971,2016-06-24 11:00:00,540,145,145,0,0,0,2016-06-24 11:00:00,540,125,117,63,180,305,2016-06-24 11:00:00,540,113106,112670
"557",12972,2016-06-24 12:00:00,540,165,165,0,0,0,2016-06-24 12:00:00,540,202,300,166,466,668,2016-06-24 12:00:00,540,145657,145143
"558",12973,2016-06-24 13:00:00,540,218,218,0,0,0,2016-06-24 13:00:00,540,446,654,333,987,1433,2016-06-24 13:00:00,540,126276,125757
"559",12974,2016-06-24 14:00:00,540,230,230,0,0,0,2016-06-24 14:00:00,540,573,669,369,1038,1611,2016-06-24 14:00:00,540,62278,61901
"560",12975,2016-06-24 15:00:00,540,251,251,0,0,0,2016-06-24 15:00:00,540,665,962,462,1424,2089,2016-06-24 15:00:00,540,60334,59977
"561",12976,2016-06-24 16:00:00,540,263,263,0,0,0,2016-06-24 16:00:00,540,617,1081,494,1575,2192,2016-06-24 16:00:00,540,53136,52845
"562",12977,2016-06-24 17:00:00,540,320,320,0,0,0,2016-06-24 17:00:00,540,703,1179,530,1709,2412,2016-06-24 17:00:00,540,51359,51083
"563",12978,2016-06-24 18:00:00,540,307,307,0,0,0,2016-06-24 18:00:00,540,773,1253,549,1802,2575,2016-06-24 18:00:00,540,51325,51002
"564",12979,2016-06-24 19:00:00,540,278,278,0,0,0,2016-06-24 19:00:00,540,764,1386,647,2033,2797,2016-06-24 19:00:00,540,49006,48732
"565",12980,2016-06-24 20:00:00,540,276,276,0,0,0,2016-06-24 20:00:00,540,736,1440,641,2081,2817,2016-06-24 20:00:00,540,44814,44586
"566",12981,2016-06-24 21:00:00,540,223,223,0,0,0,2016-06-24 21:00:00,540,683,1568,731,2299,2982,2016-06-24 21:00:00,540,37228,37015
"567",12982,2016-06-24 22:00:00,540,207,207,0,0,0,2016-06-24 22:00:00,540,584,1401,614,2015,2599,2016-06-24 22:00:00,540,50806,50629
"568",12983,2016-06-24 23:00:00,540,181,181,0,0,0,2016-06-24 23:00:00,540,485,1349,569,1918,2403,2016-06-24 23:00:00,540,86053,85617
"569",12984,2016-06-25 00:00:00,541,190,190,0,0,0,2016-06-25 00:00:00,541,489,1216,495,1711,2200,2016-06-25 00:00:00,541,80451,80079
"570",12985,2016-06-25 01:00:00,541,228,228,0,0,0,2016-06-25 01:00:00,541,371,1267,524,1791,2162,2016-06-25 01:00:00,541,81190,80775
"571",12986,2016-06-25 02:00:00,541,235,235,0,0,0,2016-06-25 02:00:00,541,342,1058,454,1512,1854,2016-06-25 02:00:00,541,79709,79298
"572",12987,2016-06-25 03:00:00,541,211,211,0,0,0,2016-06-25 03:00:00,541,259,832,348,1180,1439,2016-06-25 03:00:00,541,75443,75032
"573",12988,2016-06-25 04:00:00,541,179,179,0,0,0,2016-06-25 04:00:00,541,179,708,292,1000,1179,2016-06-25 04:00:00,541,70360,70012
"574",12989,2016-06-25 05:00:00,541,118,118,0,0,0,2016-06-25 05:00:00,541,143,427,173,600,743,2016-06-25 05:00:00,541,66529,66185
"575",12990,2016-06-25 06:00:00,541,146,146,0,0,0,2016-06-25 06:00:00,541,99,181,81,262,361,2016-06-25 06:00:00,541,63678,63377
"576",12991,2016-06-25 07:00:00,541,121,121,0,0,0,2016-06-25 07:00:00,541,58,114,57,171,229,2016-06-25 07:00:00,541,60645,60314
"577",12992,2016-06-25 08:00:00,541,122,122,0,0,0,2016-06-25 08:00:00,541,34,69,22,91,125,2016-06-25 08:00:00,541,57801,57477
"578",12993,2016-06-25 09:00:00,541,133,133,0,0,0,2016-06-25 09:00:00,541,40,53,26,79,119,2016-06-25 09:00:00,541,58805,58477
"579",12994,2016-06-25 10:00:00,541,123,123,0,0,0,2016-06-25 10:00:00,541,50,59,22,81,131,2016-06-25 10:00:00,541,61848,61505
"580",12995,2016-06-25 11:00:00,541,123,123,0,0,0,2016-06-25 11:00:00,541,85,116,59,175,260,2016-06-25 11:00:00,541,71156,70846
"581",12996,2016-06-25 12:00:00,541,103,103,0,0,0,2016-06-25 12:00:00,541,175,207,123,330,505,2016-06-25 12:00:00,541,82442,82073
"582",12997,2016-06-25 13:00:00,541,193,193,0,0,0,2016-06-25 13:00:00,541,292,567,297,864,1156,2016-06-25 13:00:00,541,93104,92677
"583",12998,2016-06-25 14:00:00,541,217,217,0,0,0,2016-06-25 14:00:00,541,443,656,369,1025,1468,2016-06-25 14:00:00,541,100185,99704
"584",12999,2016-06-25 15:00:00,541,290,290,0,0,0,2016-06-25 15:00:00,541,464,816,388,1204,1668,2016-06-25 15:00:00,541,103860,103302
"585",13000,2016-06-25 16:00:00,541,279,279,0,0,0,2016-06-25 16:00:00,541,535,1037,484,1521,2056,2016-06-25 16:00:00,541,102959,102434
"586",13001,2016-06-25 17:00:00,541,242,242,0,0,0,2016-06-25 17:00:00,541,530,1114,508,1622,2152,2016-06-25 17:00:00,541,99447,98958
"587",13002,2016-06-25 18:00:00,541,223,223,0,0,0,2016-06-25 18:00:00,541,536,1274,565,1839,2375,2016-06-25 18:00:00,541,97790,97295
"588",13003,2016-06-25 19:00:00,541,236,236,0,0,0,2016-06-25 19:00:00,541,573,1333,587,1920,2493,2016-06-25 19:00:00,541,93303,92763
"589",13004,2016-06-25 20:00:00,541,226,226,0,0,0,2016-06-25 20:00:00,541,504,1311,588,1899,2403,2016-06-25 20:00:00,541,89266,88807
"590",13005,2016-06-25 21:00:00,541,211,211,0,0,0,2016-06-25 21:00:00,541,474,1364,617,1981,2455,2016-06-25 21:00:00,541,82541,82077
"591",13006,2016-06-25 22:00:00,541,172,172,0,0,0,2016-06-25 22:00:00,541,407,1234,552,1786,2193,2016-06-25 22:00:00,541,78014,77622
"592",13007,2016-06-25 23:00:00,541,177,177,0,0,0,2016-06-25 23:00:00,541,426,1299,586,1885,2311,2016-06-25 23:00:00,541,74012,73638
"593",13008,2016-06-26 00:00:00,542,185,185,0,0,0,2016-06-26 00:00:00,542,342,1199,594,1793,2135,2016-06-26 00:00:00,542,73421,73008
"594",13009,2016-06-26 01:00:00,542,151,151,0,0,0,2016-06-26 01:00:00,542,316,1010,416,1426,1742,2016-06-26 01:00:00,542,72852,72475
"595",13010,2016-06-26 02:00:00,542,161,161,0,0,0,2016-06-26 02:00:00,542,251,832,368,1200,1451,2016-06-26 02:00:00,542,72595,72235
"596",13011,2016-06-26 03:00:00,542,173,173,0,0,0,2016-06-26 03:00:00,542,188,709,332,1041,1229,2016-06-26 03:00:00,542,70666,70306
"597",13012,2016-06-26 04:00:00,542,144,144,0,0,0,2016-06-26 04:00:00,542,141,587,257,844,985,2016-06-26 04:00:00,542,67786,67448
"598",13013,2016-06-26 05:00:00,542,117,117,0,0,0,2016-06-26 05:00:00,542,110,321,131,452,562,2016-06-26 05:00:00,542,65578,65214
"599",13014,2016-06-26 06:00:00,542,97,97,0,0,0,2016-06-26 06:00:00,542,72,152,61,213,285,2016-06-26 06:00:00,542,62729,62405
"600",13015,2016-06-26 07:00:00,542,134,134,0,0,0,2016-06-26 07:00:00,542,37,84,38,122,159,2016-06-26 07:00:00,542,60720,60412
"601",13016,2016-06-26 08:00:00,542,123,123,0,0,0,2016-06-26 08:00:00,542,58,47,23,70,128,2016-06-26 08:00:00,542,58046,57772
"602",13017,2016-06-26 09:00:00,542,110,110,0,0,0,2016-06-26 09:00:00,542,30,40,24,64,94,2016-06-26 09:00:00,542,58385,58053
"603",13018,2016-06-26 10:00:00,542,112,112,0,0,0,2016-06-26 10:00:00,542,43,37,19,56,99,2016-06-26 10:00:00,542,61154,60857
"604",13019,2016-06-26 11:00:00,542,120,120,0,0,0,2016-06-26 11:00:00,542,72,68,35,103,175,2016-06-26 11:00:00,542,67392,67070
"605",13020,2016-06-26 12:00:00,542,174,174,0,0,0,2016-06-26 12:00:00,542,144,147,82,229,373,2016-06-26 12:00:00,542,75264,74912
"606",13021,2016-06-26 13:00:00,542,162,162,0,0,0,2016-06-26 13:00:00,542,190,456,246,702,892,2016-06-26 13:00:00,542,84035,83621
"607",13022,2016-06-26 14:00:00,542,226,226,0,0,0,2016-06-26 14:00:00,542,293,574,276,850,1143,2016-06-26 14:00:00,542,91558,91123
"608",13023,2016-06-26 15:00:00,542,243,243,0,0,0,2016-06-26 15:00:00,542,332,715,358,1073,1405,2016-06-26 15:00:00,542,98192,97668
"609",13024,2016-06-26 16:00:00,542,250,250,0,0,0,2016-06-26 16:00:00,542,400,885,424,1309,1709,2016-06-26 16:00:00,542,99055,98576
"610",13025,2016-06-26 17:00:00,542,241,241,0,0,0,2016-06-26 17:00:00,542,422,998,461,1459,1881,2016-06-26 17:00:00,542,97881,97337
"611",13026,2016-06-26 18:00:00,542,258,258,0,0,0,2016-06-26 18:00:00,542,426,1201,562,1763,2189,2016-06-26 18:00:00,542,99298,98773
"612",13027,2016-06-26 19:00:00,542,230,230,0,0,0,2016-06-26 19:00:00,542,470,1369,625,1994,2464,2016-06-26 19:00:00,542,97100,96596
"613",13028,2016-06-26 20:00:00,542,255,255,0,0,0,2016-06-26 20:00:00,542,452,1439,662,2101,2553,2016-06-26 20:00:00,542,93837,93363
"614",13029,2016-06-26 21:00:00,542,189,189,0,0,0,2016-06-26 21:00:00,542,467,1301,582,1883,2350,2016-06-26 21:00:00,542,90209,89748
"615",13030,2016-06-26 22:00:00,542,241,241,0,0,0,2016-06-26 22:00:00,542,392,1253,547,1800,2192,2016-06-26 22:00:00,542,86111,85697
"616",13031,2016-06-26 23:00:00,542,250,250,0,0,0,2016-06-26 23:00:00,542,369,1233,517,1750,2119,2016-06-26 23:00:00,542,88230,87775
"617",13032,2016-06-27 00:00:00,543,241,241,0,0,0,2016-06-27 00:00:00,543,308,1108,504,1612,1920,2016-06-27 00:00:00,543,96593,96152
"618",13033,2016-06-27 01:00:00,543,252,252,0,0,0,2016-06-27 01:00:00,543,277,1024,445,1469,1746,2016-06-27 01:00:00,543,103590,103155
"619",13034,2016-06-27 02:00:00,543,240,240,0,0,0,2016-06-27 02:00:00,543,242,870,410,1280,1522,2016-06-27 02:00:00,543,101742,101273
"620",13035,2016-06-27 03:00:00,543,232,232,0,0,0,2016-06-27 03:00:00,543,166,655,317,972,1138,2016-06-27 03:00:00,543,91919,91497
"621",13036,2016-06-27 04:00:00,543,185,185,0,0,0,2016-06-27 04:00:00,543,107,472,211,683,790,2016-06-27 04:00:00,543,88130,87727
"622",13037,2016-06-27 05:00:00,543,144,144,0,0,0,2016-06-27 05:00:00,543,100,263,114,377,477,2016-06-27 05:00:00,543,88825,88382
"623",13038,2016-06-27 06:00:00,543,137,137,0,0,0,2016-06-27 06:00:00,543,78,121,53,174,252,2016-06-27 06:00:00,543,95829,95341
"624",13039,2016-06-27 07:00:00,543,149,149,0,0,0,2016-06-27 07:00:00,543,57,71,32,103,160,2016-06-27 07:00:00,543,97835,97333
"625",13040,2016-06-27 08:00:00,543,136,136,0,0,0,2016-06-27 08:00:00,543,33,53,23,76,109,2016-06-27 08:00:00,543,96721,96215
"626",13041,2016-06-27 09:00:00,543,139,139,0,0,0,2016-06-27 09:00:00,543,47,46,19,65,112,2016-06-27 09:00:00,543,100018,99494
"627",13042,2016-06-27 10:00:00,543,115,115,0,0,0,2016-06-27 10:00:00,543,53,61,37,98,151,2016-06-27 10:00:00,543,112252,111778
"628",13043,2016-06-27 11:00:00,543,161,161,0,0,0,2016-06-27 11:00:00,543,103,124,67,191,294,2016-06-27 11:00:00,543,167085,166554
"629",13044,2016-06-27 12:00:00,543,192,192,0,0,0,2016-06-27 12:00:00,543,223,277,170,447,670,2016-06-27 12:00:00,543,246112,245426
"630",13045,2016-06-27 13:00:00,543,258,258,0,0,0,2016-06-27 13:00:00,543,441,681,428,1109,1550,2016-06-27 13:00:00,543,267425,266585
"631",13046,2016-06-27 14:00:00,543,377,377,0,0,0,2016-06-27 14:00:00,543,596,823,446,1269,1865,2016-06-27 14:00:00,543,252711,251772
"632",13047,2016-06-27 15:00:00,543,332,332,0,0,0,2016-06-27 15:00:00,543,739,1126,610,1736,2475,2016-06-27 15:00:00,543,238805,237856
"633",13048,2016-06-27 16:00:00,543,345,345,0,0,0,2016-06-27 16:00:00,543,731,1308,691,1999,2730,2016-06-27 16:00:00,543,205916,205048
"634",13049,2016-06-27 17:00:00,543,370,370,0,0,0,2016-06-27 17:00:00,543,821,1408,730,2138,2959,2016-06-27 17:00:00,543,193632,192803
"635",13050,2016-06-27 18:00:00,543,378,378,0,0,0,2016-06-27 18:00:00,543,916,1552,743,2295,3211,2016-06-27 18:00:00,543,193316,192424
"636",13051,2016-06-27 19:00:00,543,351,351,0,0,0,2016-06-27 19:00:00,543,936,1600,798,2398,3334,2016-06-27 19:00:00,543,180226,179424
"637",13052,2016-06-27 20:00:00,543,380,380,0,0,0,2016-06-27 20:00:00,543,900,1625,797,2422,3322,2016-06-27 20:00:00,543,162611,161879
"638",13053,2016-06-27 21:00:00,543,291,291,0,0,0,2016-06-27 21:00:00,543,755,1736,898,2634,3389,2016-06-27 21:00:00,543,144689,143997
"639",13054,2016-06-27 22:00:00,543,297,297,0,0,0,2016-06-27 22:00:00,543,672,1677,764,2441,3113,2016-06-27 22:00:00,543,124010,123423
"640",13055,2016-06-27 23:00:00,543,289,289,0,0,0,2016-06-27 23:00:00,543,569,1562,703,2265,2834,2016-06-27 23:00:00,543,112590,112044
"641",13056,2016-06-28 00:00:00,544,290,290,0,0,0,2016-06-28 00:00:00,544,578,1411,603,2014,2592,2016-06-28 00:00:00,544,109865,109294
"642",13057,2016-06-28 01:00:00,544,260,260,0,0,0,2016-06-28 01:00:00,544,483,1215,536,1751,2234,2016-06-28 01:00:00,544,110432,109892
"643",13058,2016-06-28 02:00:00,544,243,243,0,0,0,2016-06-28 02:00:00,544,383,1057,465,1522,1905,2016-06-28 02:00:00,544,105716,105160
"644",13059,2016-06-28 03:00:00,544,232,232,0,0,0,2016-06-28 03:00:00,544,261,709,318,1027,1288,2016-06-28 03:00:00,544,96986,96522
"645",13060,2016-06-28 04:00:00,544,179,179,0,0,0,2016-06-28 04:00:00,544,197,563,248,811,1008,2016-06-28 04:00:00,544,89734,89305
"646",13061,2016-06-28 05:00:00,544,167,167,0,0,0,2016-06-28 05:00:00,544,93,250,107,357,450,2016-06-28 05:00:00,544,88677,88237
"647",13062,2016-06-28 06:00:00,544,122,122,0,0,0,2016-06-28 06:00:00,544,76,157,61,218,294,2016-06-28 06:00:00,544,97320,96821
"648",13063,2016-06-28 07:00:00,544,142,142,0,0,0,2016-06-28 07:00:00,544,74,76,30,106,180,2016-06-28 07:00:00,544,100888,100325
"649",13064,2016-06-28 08:00:00,544,134,134,0,0,0,2016-06-28 08:00:00,544,34,66,31,97,131,2016-06-28 08:00:00,544,101274,100753
"650",13065,2016-06-28 09:00:00,544,148,148,0,0,0,2016-06-28 09:00:00,544,50,61,25,86,136,2016-06-28 09:00:00,544,101820,101229
"651",13066,2016-06-28 10:00:00,544,133,133,0,0,0,2016-06-28 10:00:00,544,74,85,50,135,209,2016-06-28 10:00:00,544,105410,104886
"652",13067,2016-06-28 11:00:00,544,161,161,0,0,0,2016-06-28 11:00:00,544,121,145,82,227,348,2016-06-28 11:00:00,544,130942,130427
"653",13068,2016-06-28 12:00:00,544,139,139,0,0,0,2016-06-28 12:00:00,544,235,307,186,493,728,2016-06-28 12:00:00,544,175105,174375
"654",13069,2016-06-28 13:00:00,544,247,247,0,0,0,2016-06-28 13:00:00,544,424,635,366,1001,1425,2016-06-28 13:00:00,544,205652,204819
"655",13070,2016-06-28 14:00:00,544,346,346,0,0,0,2016-06-28 14:00:00,544,616,846,463,1309,1925,2016-06-28 14:00:00,544,221074,220089
"656",13071,2016-06-28 15:00:00,544,336,336,0,0,0,2016-06-28 15:00:00,544,691,988,511,1499,2190,2016-06-28 15:00:00,544,208265,207300
"657",13072,2016-06-28 16:00:00,544,385,385,0,0,0,2016-06-28 16:00:00,544,727,1189,593,1782,2509,2016-06-28 16:00:00,544,191128,190211
"658",13073,2016-06-28 17:00:00,544,391,391,0,0,0,2016-06-28 17:00:00,544,711,1300,641,1941,2652,2016-06-28 17:00:00,544,184514,183664
"659",13074,2016-06-28 18:00:00,544,421,421,0,0,0,2016-06-28 18:00:00,544,829,1401,680,2081,2910,2016-06-28 18:00:00,544,185216,184337
"660",13075,2016-06-28 19:00:00,544,422,422,0,0,0,2016-06-28 19:00:00,544,836,1472,700,2172,3008,2016-06-28 19:00:00,544,178779,177827
"661",13076,2016-06-28 20:00:00,544,401,401,0,0,0,2016-06-28 20:00:00,544,808,1563,671,2234,3042,2016-06-28 20:00:00,544,166184,165342
"662",13077,2016-06-28 21:00:00,544,361,361,0,0,0,2016-06-28 21:00:00,544,695,1481,730,2211,2906,2016-06-28 21:00:00,544,140888,140198
"663",13078,2016-06-28 22:00:00,544,357,357,0,0,0,2016-06-28 22:00:00,544,615,1503,722,2225,2840,2016-06-28 22:00:00,544,117917,117305
"664",13079,2016-06-28 23:00:00,544,318,318,0,0,0,2016-06-28 23:00:00,544,574,1533,707,2240,2814,2016-06-28 23:00:00,544,107068,106527
"665",13080,2016-06-29 00:00:00,545,284,284,0,0,0,2016-06-29 00:00:00,545,535,1428,652,2080,2615,2016-06-29 00:00:00,545,103699,103179
"666",13081,2016-06-29 01:00:00,545,264,264,0,0,0,2016-06-29 01:00:00,545,451,1280,581,1861,2312,2016-06-29 01:00:00,545,104560,104006
"667",13082,2016-06-29 02:00:00,545,264,264,0,0,0,2016-06-29 02:00:00,545,370,981,409,1390,1760,2016-06-29 02:00:00,545,100701,100186
"668",13083,2016-06-29 03:00:00,545,260,260,0,0,0,2016-06-29 03:00:00,545,260,772,317,1089,1349,2016-06-29 03:00:00,545,93180,92684
"669",13084,2016-06-29 04:00:00,545,185,185,0,0,0,2016-06-29 04:00:00,545,206,573,240,813,1019,2016-06-29 04:00:00,545,87749,87311
"670",13085,2016-06-29 05:00:00,545,166,166,0,0,0,2016-06-29 05:00:00,545,112,291,133,424,536,2016-06-29 05:00:00,545,85681,85228
"671",13086,2016-06-29 06:00:00,545,121,121,0,0,0,2016-06-29 06:00:00,545,98,166,67,233,331,2016-06-29 06:00:00,545,93237,92746
"672",13087,2016-06-29 07:00:00,545,148,148,0,0,0,2016-06-29 07:00:00,545,71,91,35,126,197,2016-06-29 07:00:00,545,97817,97253
"673",13088,2016-06-29 08:00:00,545,144,144,0,0,0,2016-06-29 08:00:00,545,60,64,27,91,151,2016-06-29 08:00:00,545,98750,98197
"674",13089,2016-06-29 09:00:00,545,148,148,0,0,0,2016-06-29 09:00:00,545,57,60,23,83,140,2016-06-29 09:00:00,545,99912,99353
"675",13090,2016-06-29 10:00:00,545,141,141,0,0,0,2016-06-29 10:00:00,545,62,69,32,101,163,2016-06-29 10:00:00,545,101396,100840
"676",13091,2016-06-29 11:00:00,545,190,190,0,0,0,2016-06-29 11:00:00,545,88,148,99,247,335,2016-06-29 11:00:00,545,120293,119714
"677",13092,2016-06-29 12:00:00,545,225,225,0,0,0,2016-06-29 12:00:00,545,228,314,166,480,708,2016-06-29 12:00:00,545,154760,154068
"678",13093,2016-06-29 13:00:00,545,245,245,0,0,0,2016-06-29 13:00:00,545,482,612,365,977,1459,2016-06-29 13:00:00,545,184479,183685
"679",13094,2016-06-29 14:00:00,545,360,360,0,0,0,2016-06-29 14:00:00,545,653,740,401,1141,1794,2016-06-29 14:00:00,545,197080,196148
"680",13095,2016-06-29 15:00:00,545,354,354,0,0,0,2016-06-29 15:00:00,545,751,903,466,1369,2120,2016-06-29 15:00:00,545,193202,192297
"681",13096,2016-06-29 16:00:00,545,392,392,0,0,0,2016-06-29 16:00:00,545,747,1052,553,1605,2352,2016-06-29 16:00:00,545,177021,176116
"682",13097,2016-06-29 17:00:00,545,399,399,0,0,0,2016-06-29 17:00:00,545,815,1228,603,1831,2646,2016-06-29 17:00:00,545,173936,173063
"683",13098,2016-06-29 18:00:00,545,406,406,0,0,0,2016-06-29 18:00:00,545,811,1229,591,1820,2631,2016-06-29 18:00:00,545,173842,172989
"684",13099,2016-06-29 19:00:00,545,417,417,0,0,0,2016-06-29 19:00:00,545,829,1356,646,2002,2831,2016-06-29 19:00:00,545,168380,167540
"685",13100,2016-06-29 20:00:00,545,393,393,0,0,0,2016-06-29 20:00:00,545,785,1526,753,2279,3064,2016-06-29 20:00:00,545,159349,158543
"686",13101,2016-06-29 21:00:00,545,371,371,0,0,0,2016-06-29 21:00:00,545,721,1505,666,2171,2892,2016-06-29 21:00:00,545,135582,134927
"687",13102,2016-06-29 22:00:00,545,333,333,0,0,0,2016-06-29 22:00:00,545,620,1607,783,2390,3010,2016-06-29 22:00:00,545,113601,113070
"688",13103,2016-06-29 23:00:00,545,279,279,0,0,0,2016-06-29 23:00:00,545,517,1512,669,2181,2698,2016-06-29 23:00:00,545,104114,103648
"689",13104,2016-06-30 00:00:00,546,273,273,0,0,0,2016-06-30 00:00:00,546,475,1310,596,1906,2381,2016-06-30 00:00:00,546,102687,102184
"690",13105,2016-06-30 01:00:00,546,295,295,0,0,0,2016-06-30 01:00:00,546,482,1344,583,1927,2409,2016-06-30 01:00:00,546,105739,105233
"691",13106,2016-06-30 02:00:00,546,256,256,0,0,0,2016-06-30 02:00:00,546,352,988,442,1430,1782,2016-06-30 02:00:00,546,101434,100957
"692",13107,2016-06-30 03:00:00,546,203,203,0,0,0,2016-06-30 03:00:00,546,251,726,314,1040,1291,2016-06-30 03:00:00,546,94328,93886
"693",13108,2016-06-30 04:00:00,546,203,203,0,0,0,2016-06-30 04:00:00,546,161,570,259,829,990,2016-06-30 04:00:00,546,88291,87862
"694",13109,2016-06-30 05:00:00,546,151,151,0,0,0,2016-06-30 05:00:00,546,102,261,115,376,478,2016-06-30 05:00:00,546,88186,87774
"695",13110,2016-06-30 06:00:00,546,99,99,0,0,0,2016-06-30 06:00:00,546,78,167,58,225,303,2016-06-30 06:00:00,546,95948,95491
"696",13111,2016-06-30 07:00:00,546,136,136,0,0,0,2016-06-30 07:00:00,546,67,83,42,125,192,2016-06-30 07:00:00,546,99380,98903
"697",13112,2016-06-30 08:00:00,546,114,114,0,0,0,2016-06-30 08:00:00,546,43,67,21,88,131,2016-06-30 08:00:00,546,98623,98115
"698",13113,2016-06-30 09:00:00,546,115,115,0,0,0,2016-06-30 09:00:00,546,48,45,26,71,119,2016-06-30 09:00:00,546,101118,100619
"699",13114,2016-06-30 10:00:00,546,116,116,0,0,0,2016-06-30 10:00:00,546,78,59,33,92,170,2016-06-30 10:00:00,546,104226,103731
"700",13115,2016-06-30 11:00:00,546,142,142,0,0,0,2016-06-30 11:00:00,546,116,117,85,202,318,2016-06-30 11:00:00,546,133562,132990
"701",13116,2016-06-30 12:00:00,546,173,173,0,0,0,2016-06-30 12:00:00,546,260,289,150,439,699,2016-06-30 12:00:00,546,184231,183520
"702",13117,2016-06-30 13:00:00,546,232,232,0,0,0,2016-06-30 13:00:00,546,420,589,349,938,1358,2016-06-30 13:00:00,546,213131,212307
"703",13118,2016-06-30 14:00:00,546,335,335,0,0,0,2016-06-30 14:00:00,546,587,727,375,1102,1689,2016-06-30 14:00:00,546,217647,216701
"704",13119,2016-06-30 15:00:00,546,292,292,0,0,0,2016-06-30 15:00:00,546,654,922,481,1403,2057,2016-06-30 15:00:00,546,212808,211913
"705",13120,2016-06-30 16:00:00,546,337,337,0,0,0,2016-06-30 16:00:00,546,730,1040,534,1574,2304,2016-06-30 16:00:00,546,191526,190678
"706",13121,2016-06-30 17:00:00,546,385,385,0,0,0,2016-06-30 17:00:00,546,728,1095,552,1647,2375,2016-06-30 17:00:00,546,185913,185073
"707",13122,2016-06-30 18:00:00,546,375,375,0,0,0,2016-06-30 18:00:00,546,834,1086,535,1621,2455,2016-06-30 18:00:00,546,183841,183006
"708",13123,2016-06-30 19:00:00,546,390,390,0,0,0,2016-06-30 19:00:00,546,816,1202,587,1789,2605,2016-06-30 19:00:00,546,174589,173783
"709",13124,2016-06-30 20:00:00,546,370,370,0,0,0,2016-06-30 20:00:00,546,791,1353,653,2006,2797,2016-06-30 20:00:00,546,163980,163234
"710",13125,2016-06-30 21:00:00,546,327,327,0,0,0,2016-06-30 21:00:00,546,721,1428,711,2139,2860,2016-06-30 21:00:00,546,139726,139091
"711",13126,2016-06-30 22:00:00,546,317,317,0,0,0,2016-06-30 22:00:00,546,601,1293,615,1908,2509,2016-06-30 22:00:00,546,117966,117460
"712",13127,2016-06-30 23:00:00,546,245,245,0,0,0,2016-06-30 23:00:00,546,545,1324,599,1923,2468,2016-06-30 23:00:00,546,107249,106755
"713",13128,2016-07-01 00:00:00,547,278,278,0,0,0,2016-07-01 00:00:00,547,445,1269,579,1848,2293,2016-07-01 00:00:00,547,101990,101520
"714",13129,2016-07-01 01:00:00,547,261,261,0,0,0,2016-07-01 01:00:00,547,396,1136,485,1621,2017,2016-07-01 01:00:00,547,102559,102104
"715",13130,2016-07-01 02:00:00,547,228,228,0,0,0,2016-07-01 02:00:00,547,338,933,386,1319,1657,2016-07-01 02:00:00,547,98982,98544
"716",13131,2016-07-01 03:00:00,547,198,198,0,0,0,2016-07-01 03:00:00,547,237,725,328,1053,1290,2016-07-01 03:00:00,547,91258,90838
"717",13132,2016-07-01 04:00:00,547,190,190,0,0,0,2016-07-01 04:00:00,547,165,567,247,814,979,2016-07-01 04:00:00,547,83576,83157
"718",13133,2016-07-01 05:00:00,547,162,162,0,0,0,2016-07-01 05:00:00,547,131,265,117,382,513,2016-07-01 05:00:00,547,81770,81401
"719",13134,2016-07-01 06:00:00,547,139,139,0,0,0,2016-07-01 06:00:00,547,89,137,58,195,284,2016-07-01 06:00:00,547,86986,86572
"720",13135,2016-07-01 07:00:00,547,124,124,0,0,0,2016-07-01 07:00:00,547,66,101,52,153,219,2016-07-01 07:00:00,547,89178,88706
"721",13136,2016-07-01 08:00:00,547,132,132,0,0,0,2016-07-01 08:00:00,547,49,65,31,96,145,2016-07-01 08:00:00,547,89906,89426
"722",13137,2016-07-01 09:00:00,547,134,134,0,0,0,2016-07-01 09:00:00,547,43,52,33,85,128,2016-07-01 09:00:00,547,91085,90656
"723",13138,2016-07-01 10:00:00,547,127,127,0,0,0,2016-07-01 10:00:00,547,65,66,41,107,172,2016-07-01 10:00:00,547,95476,95021
"724",13139,2016-07-01 11:00:00,547,143,143,0,0,0,2016-07-01 11:00:00,547,124,149,98,247,371,2016-07-01 11:00:00,547,122971,122530
"725",13140,2016-07-01 12:00:00,547,142,142,0,0,0,2016-07-01 12:00:00,547,283,313,214,527,810,2016-07-01 12:00:00,547,164549,163907
"726",13141,2016-07-01 13:00:00,547,221,221,0,0,0,2016-07-01 13:00:00,547,462,664,406,1070,1532,2016-07-01 13:00:00,547,187483,186790
"727",13142,2016-07-01 14:00:00,547,303,303,0,0,0,2016-07-01 14:00:00,547,521,798,433,1231,1752,2016-07-01 14:00:00,547,189522,188661
"728",13143,2016-07-01 15:00:00,547,292,292,0,0,0,2016-07-01 15:00:00,547,725,993,543,1536,2261,2016-07-01 15:00:00,547,183821,183008
"729",13144,2016-07-01 16:00:00,547,327,327,0,0,0,2016-07-01 16:00:00,547,650,1163,602,1765,2415,2016-07-01 16:00:00,547,164880,164133
"730",13145,2016-07-01 17:00:00,547,363,363,0,0,0,2016-07-01 17:00:00,547,768,1191,569,1760,2528,2016-07-01 17:00:00,547,155836,155138
"731",13146,2016-07-01 18:00:00,547,382,382,0,0,0,2016-07-01 18:00:00,547,774,1241,610,1851,2625,2016-07-01 18:00:00,547,151836,151129
"732",13147,2016-07-01 19:00:00,547,307,307,0,0,0,2016-07-01 19:00:00,547,734,1343,701,2044,2778,2016-07-01 19:00:00,547,141184,140479
"733",13148,2016-07-01 20:00:00,547,332,332,0,0,0,2016-07-01 20:00:00,547,675,1408,694,2102,2777,2016-07-01 20:00:00,547,128846,128212
"734",13149,2016-07-01 21:00:00,547,271,271,0,0,0,2016-07-01 21:00:00,547,626,1361,653,2014,2640,2016-07-01 21:00:00,547,111991,111461
"735",13150,2016-07-01 22:00:00,547,264,264,0,0,0,2016-07-01 22:00:00,547,626,1451,676,2127,2753,2016-07-01 22:00:00,547,96212,95752
"736",13151,2016-07-01 23:00:00,547,211,211,0,0,0,2016-07-01 23:00:00,547,552,1301,650,1951,2503,2016-07-01 23:00:00,547,85377,84975
"737",13152,2016-07-02 00:00:00,548,261,261,0,0,0,2016-07-02 00:00:00,548,465,1364,623,1987,2452,2016-07-02 00:00:00,548,81378,80983
"738",13153,2016-07-02 01:00:00,548,230,230,0,0,0,2016-07-02 01:00:00,548,375,1089,496,1585,1960,2016-07-02 01:00:00,548,79879,79464
"739",13154,2016-07-02 02:00:00,548,226,226,0,0,0,2016-07-02 02:00:00,548,303,962,456,1418,1721,2016-07-02 02:00:00,548,77917,77518
"740",13155,2016-07-02 03:00:00,548,222,222,0,0,0,2016-07-02 03:00:00,548,215,828,391,1219,1434,2016-07-02 03:00:00,548,73916,73543
"741",13156,2016-07-02 04:00:00,548,178,178,0,0,0,2016-07-02 04:00:00,548,167,637,297,934,1101,2016-07-02 04:00:00,548,69801,69483
"742",13157,2016-07-02 05:00:00,548,118,118,0,0,0,2016-07-02 05:00:00,548,104,328,154,482,586,2016-07-02 05:00:00,548,66067,65764
"743",13158,2016-07-02 06:00:00,548,104,104,0,0,0,2016-07-02 06:00:00,548,85,146,72,218,303,2016-07-02 06:00:00,548,63047,62708
"744",13159,2016-07-02 07:00:00,548,139,139,0,0,0,2016-07-02 07:00:00,548,58,128,66,194,252,2016-07-02 07:00:00,548,61693,61359
"745",13160,2016-07-02 08:00:00,548,125,125,0,0,0,2016-07-02 08:00:00,548,50,59,32,91,141,2016-07-02 08:00:00,548,60832,60526
"746",13161,2016-07-02 09:00:00,548,136,136,0,0,0,2016-07-02 09:00:00,548,50,46,24,70,120,2016-07-02 09:00:00,548,62115,61802
"747",13162,2016-07-02 10:00:00,548,128,128,0,0,0,2016-07-02 10:00:00,548,51,80,53,133,184,2016-07-02 10:00:00,548,65132,64788
"748",13163,2016-07-02 11:00:00,548,117,117,0,0,0,2016-07-02 11:00:00,548,100,150,98,248,348,2016-07-02 11:00:00,548,74222,73866
"749",13164,2016-07-02 12:00:00,548,118,118,0,0,0,2016-07-02 12:00:00,548,186,282,165,447,633,2016-07-02 12:00:00,548,83149,82764
"750",13165,2016-07-02 13:00:00,548,192,192,0,0,0,2016-07-02 13:00:00,548,277,597,337,934,1211,2016-07-02 13:00:00,548,93492,93065
"751",13166,2016-07-02 14:00:00,548,237,237,0,0,0,2016-07-02 14:00:00,548,368,659,364,1023,1391,2016-07-02 14:00:00,548,100530,100052
"752",13167,2016-07-02 15:00:00,548,193,193,0,0,0,2016-07-02 15:00:00,548,476,944,494,1438,1914,2016-07-02 15:00:00,548,103343,102796
"753",13168,2016-07-02 16:00:00,548,288,288,0,0,0,2016-07-02 16:00:00,548,468,961,486,1447,1915,2016-07-02 16:00:00,548,101961,101459
"754",13169,2016-07-02 17:00:00,548,221,221,0,0,0,2016-07-02 17:00:00,548,533,996,516,1512,2045,2016-07-02 17:00:00,548,99252,98733
"755",13170,2016-07-02 18:00:00,548,314,314,0,0,0,2016-07-02 18:00:00,548,495,1086,552,1638,2133,2016-07-02 18:00:00,548,95738,95230
"756",13171,2016-07-02 19:00:00,548,281,281,0,0,0,2016-07-02 19:00:00,548,507,1184,567,1751,2258,2016-07-02 19:00:00,548,90777,90320
"757",13172,2016-07-02 20:00:00,548,260,260,0,0,0,2016-07-02 20:00:00,548,489,1243,583,1826,2315,2016-07-02 20:00:00,548,85558,85121
"758",13173,2016-07-02 21:00:00,548,251,251,0,0,0,2016-07-02 21:00:00,548,480,1150,523,1673,2153,2016-07-02 21:00:00,548,78609,78188
"759",13174,2016-07-02 22:00:00,548,251,251,0,0,0,2016-07-02 22:00:00,548,445,1153,559,1712,2157,2016-07-02 22:00:00,548,75449,75041
"760",13175,2016-07-02 23:00:00,548,225,225,0,0,0,2016-07-02 23:00:00,548,410,1065,528,1593,2003,2016-07-02 23:00:00,548,71575,71165
"761",13176,2016-07-03 00:00:00,549,260,260,0,0,0,2016-07-03 00:00:00,549,393,1025,503,1528,1921,2016-07-03 00:00:00,549,70052,69697
"762",13177,2016-07-03 01:00:00,549,264,264,0,0,0,2016-07-03 01:00:00,549,309,869,400,1269,1578,2016-07-03 01:00:00,549,70096,69744
"763",13178,2016-07-03 02:00:00,549,210,210,0,0,0,2016-07-03 02:00:00,549,213,815,396,1211,1424,2016-07-03 02:00:00,549,69770,69428
"764",13179,2016-07-03 03:00:00,549,222,222,0,0,0,2016-07-03 03:00:00,549,185,708,354,1062,1247,2016-07-03 03:00:00,549,67349,67021
"765",13180,2016-07-03 04:00:00,549,167,167,0,0,0,2016-07-03 04:00:00,549,128,475,217,692,820,2016-07-03 04:00:00,549,64509,64190
"766",13181,2016-07-03 05:00:00,549,126,126,0,0,0,2016-07-03 05:00:00,549,89,336,154,490,579,2016-07-03 05:00:00,549,61923,61591
"767",13182,2016-07-03 06:00:00,549,115,115,0,0,0,2016-07-03 06:00:00,549,90,164,80,244,334,2016-07-03 06:00:00,549,59421,59122
"768",13183,2016-07-03 07:00:00,549,94,94,0,0,0,2016-07-03 07:00:00,549,61,99,44,143,204,2016-07-03 07:00:00,549,59210,58911
"769",13184,2016-07-03 08:00:00,549,99,99,0,0,0,2016-07-03 08:00:00,549,54,66,31,97,151,2016-07-03 08:00:00,549,58530,58216
"770",13185,2016-07-03 09:00:00,549,95,95,0,0,0,2016-07-03 09:00:00,549,34,47,19,66,100,2016-07-03 09:00:00,549,58786,58462
"771",13186,2016-07-03 10:00:00,549,111,111,0,0,0,2016-07-03 10:00:00,549,38,52,32,84,122,2016-07-03 10:00:00,549,62244,61955
"772",13187,2016-07-03 11:00:00,549,124,124,0,0,0,2016-07-03 11:00:00,549,73,104,64,168,241,2016-07-03 11:00:00,549,67818,67524
"773",13188,2016-07-03 12:00:00,549,142,142,0,0,0,2016-07-03 12:00:00,549,145,179,110,289,434,2016-07-03 12:00:00,549,75356,75029
"774",13189,2016-07-03 13:00:00,549,180,180,0,0,0,2016-07-03 13:00:00,549,189,406,239,645,834,2016-07-03 13:00:00,549,84021,83639
"775",13190,2016-07-03 14:00:00,549,222,222,0,0,0,2016-07-03 14:00:00,549,254,609,320,929,1183,2016-07-03 14:00:00,549,91238,90807
"776",13191,2016-07-03 15:00:00,549,214,214,0,0,0,2016-07-03 15:00:00,549,314,764,397,1161,1475,2016-07-03 15:00:00,549,94905,94421
"777",13192,2016-07-03 16:00:00,549,250,250,0,0,0,2016-07-03 16:00:00,549,371,915,477,1392,1763,2016-07-03 16:00:00,549,95364,94873
"778",13193,2016-07-03 17:00:00,549,235,235,0,0,0,2016-07-03 17:00:00,549,398,973,426,1399,1797,2016-07-03 17:00:00,549,94461,94012
"779",13194,2016-07-03 18:00:00,549,298,298,0,0,0,2016-07-03 18:00:00,549,429,1123,543,1666,2095,2016-07-03 18:00:00,549,92743,92270
"780",13195,2016-07-03 19:00:00,549,211,211,0,0,0,2016-07-03 19:00:00,549,436,1104,506,1610,2046,2016-07-03 19:00:00,549,89092,88616
"781",13196,2016-07-03 20:00:00,549,219,219,0,0,0,2016-07-03 20:00:00,549,422,1135,540,1675,2097,2016-07-03 20:00:00,549,85022,84566
"782",13197,2016-07-03 21:00:00,549,196,196,0,0,0,2016-07-03 21:00:00,549,363,1082,507,1589,1952,2016-07-03 21:00:00,549,80065,79644
"783",13198,2016-07-03 22:00:00,549,244,244,0,0,0,2016-07-03 22:00:00,549,345,1003,466,1469,1814,2016-07-03 22:00:00,549,75263,74899
"784",13199,2016-07-03 23:00:00,549,219,219,0,0,0,2016-07-03 23:00:00,549,339,975,476,1451,1790,2016-07-03 23:00:00,549,75277,74919
"785",13200,2016-07-04 00:00:00,550,209,209,0,0,0,2016-07-04 00:00:00,550,282,951,432,1383,1665,2016-07-04 00:00:00,550,82510,82135
"786",13201,2016-07-04 01:00:00,550,229,229,0,0,0,2016-07-04 01:00:00,550,269,892,404,1296,1565,2016-07-04 01:00:00,550,88816,88455
"787",13202,2016-07-04 02:00:00,550,217,217,0,0,0,2016-07-04 02:00:00,550,205,789,368,1157,1362,2016-07-04 02:00:00,550,86186,85795
"788",13203,2016-07-04 03:00:00,550,176,176,0,0,0,2016-07-04 03:00:00,550,161,646,293,939,1100,2016-07-04 03:00:00,550,83759,83356
"789",13204,2016-07-04 04:00:00,550,193,193,0,0,0,2016-07-04 04:00:00,550,123,482,240,722,845,2016-07-04 04:00:00,550,83409,83004
"790",13205,2016-07-04 05:00:00,550,177,177,0,0,0,2016-07-04 05:00:00,550,98,276,126,402,500,2016-07-04 05:00:00,550,85450,85074
"791",13206,2016-07-04 06:00:00,550,146,146,0,0,0,2016-07-04 06:00:00,550,64,135,62,197,261,2016-07-04 06:00:00,550,92983,92558
"792",13207,2016-07-04 07:00:00,550,145,145,0,0,0,2016-07-04 07:00:00,550,45,91,50,141,186,2016-07-04 07:00:00,550,95247,94780
"793",13208,2016-07-04 08:00:00,550,138,138,0,0,0,2016-07-04 08:00:00,550,43,65,26,91,134,2016-07-04 08:00:00,550,94954,94463
"794",13209,2016-07-04 09:00:00,550,149,149,0,0,0,2016-07-04 09:00:00,550,36,35,17,52,88,2016-07-04 09:00:00,550,94705,94180
"795",13210,2016-07-04 10:00:00,550,116,116,0,0,0,2016-07-04 10:00:00,550,43,39,19,58,101,2016-07-04 10:00:00,550,93674,93224
"796",13211,2016-07-04 11:00:00,550,164,164,0,0,0,2016-07-04 11:00:00,550,96,70,45,115,211,2016-07-04 11:00:00,550,101604,101118
"797",13212,2016-07-04 12:00:00,550,173,173,0,0,0,2016-07-04 12:00:00,550,117,144,77,221,338,2016-07-04 12:00:00,550,122038,121471
"798",13213,2016-07-04 13:00:00,550,171,171,0,0,0,2016-07-04 13:00:00,550,274,353,184,537,811,2016-07-04 13:00:00,550,126688,126063
"799",13214,2016-07-04 14:00:00,550,278,278,0,0,0,2016-07-04 14:00:00,550,302,531,283,814,1116,2016-07-04 14:00:00,550,129491,128862
"800",13215,2016-07-04 15:00:00,550,274,274,0,0,0,2016-07-04 15:00:00,550,417,733,370,1103,1520,2016-07-04 15:00:00,550,125625,125074
"801",13216,2016-07-04 16:00:00,550,295,295,0,0,0,2016-07-04 16:00:00,550,434,848,452,1300,1734,2016-07-04 16:00:00,550,118186,117594
"802",13217,2016-07-04 17:00:00,550,303,303,0,0,0,2016-07-04 17:00:00,550,459,948,496,1444,1903,2016-07-04 17:00:00,550,111878,111361
"803",13218,2016-07-04 18:00:00,550,313,313,0,0,0,2016-07-04 18:00:00,550,427,999,502,1501,1928,2016-07-04 18:00:00,550,109261,108689
"804",13219,2016-07-04 19:00:00,550,261,261,0,0,0,2016-07-04 19:00:00,550,469,998,480,1478,1947,2016-07-04 19:00:00,550,104952,104434
"805",13220,2016-07-04 20:00:00,550,298,298,0,0,0,2016-07-04 20:00:00,550,423,959,466,1425,1848,2016-07-04 20:00:00,550,98811,98307
"806",13221,2016-07-04 21:00:00,550,262,262,0,0,0,2016-07-04 21:00:00,550,388,1044,474,1518,1906,2016-07-04 21:00:00,550,89602,89101
"807",13222,2016-07-04 22:00:00,550,266,266,0,0,0,2016-07-04 22:00:00,550,329,957,433,1390,1719,2016-07-04 22:00:00,550,82605,82176
"808",13223,2016-07-04 23:00:00,550,214,214,0,0,0,2016-07-04 23:00:00,550,296,889,402,1291,1587,2016-07-04 23:00:00,550,79156,78796
"809",13224,2016-07-05 00:00:00,551,221,221,0,0,0,2016-07-05 00:00:00,551,267,868,421,1289,1556,2016-07-05 00:00:00,551,80974,80554
"810",13225,2016-07-05 01:00:00,551,182,182,0,0,0,2016-07-05 01:00:00,551,247,697,341,1038,1285,2016-07-05 01:00:00,551,81913,81561
"811",13226,2016-07-05 02:00:00,551,166,166,0,0,0,2016-07-05 02:00:00,551,194,628,300,928,1122,2016-07-05 02:00:00,551,79980,79539
"812",13227,2016-07-05 03:00:00,551,197,197,0,0,0,2016-07-05 03:00:00,551,169,523,243,766,935,2016-07-05 03:00:00,551,76872,76509
"813",13228,2016-07-05 04:00:00,551,146,146,0,0,0,2016-07-05 04:00:00,551,122,404,186,590,712,2016-07-05 04:00:00,551,73736,73389
"814",13229,2016-07-05 05:00:00,551,125,125,0,0,0,2016-07-05 05:00:00,551,74,208,102,310,384,2016-07-05 05:00:00,551,75961,75609
"815",13230,2016-07-05 06:00:00,551,91,91,0,0,0,2016-07-05 06:00:00,551,63,127,53,180,243,2016-07-05 06:00:00,551,84189,83767
"816",13231,2016-07-05 07:00:00,551,144,144,0,0,0,2016-07-05 07:00:00,551,50,83,38,121,171,2016-07-05 07:00:00,551,87500,87035
"817",13232,2016-07-05 08:00:00,551,118,118,0,0,0,2016-07-05 08:00:00,551,33,43,18,61,94,2016-07-05 08:00:00,551,88477,88015
"818",13233,2016-07-05 09:00:00,551,128,128,0,0,0,2016-07-05 09:00:00,551,40,46,27,73,113,2016-07-05 09:00:00,551,93387,92918
"819",13234,2016-07-05 10:00:00,551,130,130,0,0,0,2016-07-05 10:00:00,551,51,59,40,99,150,2016-07-05 10:00:00,551,105372,104904
"820",13235,2016-07-05 11:00:00,551,138,138,0,0,0,2016-07-05 11:00:00,551,112,104,72,176,288,2016-07-05 11:00:00,551,161174,160703
"821",13236,2016-07-05 12:00:00,551,154,154,0,0,0,2016-07-05 12:00:00,551,256,249,157,406,662,2016-07-05 12:00:00,551,238411,237762
"822",13237,2016-07-05 13:00:00,551,243,243,0,0,0,2016-07-05 13:00:00,551,504,565,353,918,1422,2016-07-05 13:00:00,551,253667,252874
"823",13238,2016-07-05 14:00:00,551,390,390,0,0,0,2016-07-05 14:00:00,551,615,744,450,1194,1809,2016-07-05 14:00:00,551,239221,238357
"824",13239,2016-07-05 15:00:00,551,361,361,0,0,0,2016-07-05 15:00:00,551,686,1078,595,1673,2359,2016-07-05 15:00:00,551,222605,221754
"825",13240,2016-07-05 16:00:00,551,379,379,0,0,0,2016-07-05 16:00:00,551,765,1189,673,1862,2627,2016-07-05 16:00:00,551,193692,192841
"826",13241,2016-07-05 17:00:00,551,391,391,0,0,0,2016-07-05 17:00:00,551,785,1302,704,2006,2791,2016-07-05 17:00:00,551,182526,181705
"827",13242,2016-07-05 18:00:00,551,410,410,0,0,0,2016-07-05 18:00:00,551,907,1586,867,2453,3360,2016-07-05 18:00:00,551,180055,179266
"828",13243,2016-07-05 19:00:00,551,399,399,0,0,0,2016-07-05 19:00:00,551,913,1666,866,2532,3445,2016-07-05 19:00:00,551,172739,171942
"829",13244,2016-07-05 20:00:00,551,385,385,0,0,0,2016-07-05 20:00:00,551,867,1809,928,2737,3604,2016-07-05 20:00:00,551,159599,158872
"830",13245,2016-07-05 21:00:00,551,386,386,0,0,0,2016-07-05 21:00:00,551,700,1723,921,2644,3344,2016-07-05 21:00:00,551,136006,135390
"831",13246,2016-07-05 22:00:00,551,314,314,0,0,0,2016-07-05 22:00:00,551,667,1703,841,2544,3211,2016-07-05 22:00:00,551,113975,113455
"832",13247,2016-07-05 23:00:00,551,298,298,0,0,0,2016-07-05 23:00:00,551,596,1641,785,2426,3022,2016-07-05 23:00:00,551,102307,101831
"833",13248,2016-07-06 00:00:00,552,311,311,0,0,0,2016-07-06 00:00:00,552,516,1535,770,2305,2821,2016-07-06 00:00:00,552,95153,94727
"834",13249,2016-07-06 01:00:00,552,251,251,0,0,0,2016-07-06 01:00:00,552,412,1259,599,1858,2270,2016-07-06 01:00:00,552,94524,94055
"835",13250,2016-07-06 02:00:00,552,253,253,0,0,0,2016-07-06 02:00:00,552,331,1043,473,1516,1847,2016-07-06 02:00:00,552,90899,90470
"836",13251,2016-07-06 03:00:00,552,207,207,0,0,0,2016-07-06 03:00:00,552,247,733,333,1066,1313,2016-07-06 03:00:00,552,83091,82722
"837",13252,2016-07-06 04:00:00,552,178,178,0,0,0,2016-07-06 04:00:00,552,180,600,294,894,1074,2016-07-06 04:00:00,552,76173,75821
"838",13253,2016-07-06 05:00:00,552,127,127,0,0,0,2016-07-06 05:00:00,552,133,307,125,432,565,2016-07-06 05:00:00,552,74054,73728
"839",13254,2016-07-06 06:00:00,552,121,121,0,0,0,2016-07-06 06:00:00,552,75,157,67,224,299,2016-07-06 06:00:00,552,79902,79493
"840",13255,2016-07-06 07:00:00,552,116,116,0,0,0,2016-07-06 07:00:00,552,67,95,37,132,199,2016-07-06 07:00:00,552,81963,81522
"841",13256,2016-07-06 08:00:00,552,106,106,0,0,0,2016-07-06 08:00:00,552,50,55,22,77,127,2016-07-06 08:00:00,552,84231,83808
"842",13257,2016-07-06 09:00:00,552,93,93,0,0,0,2016-07-06 09:00:00,552,39,32,18,50,89,2016-07-06 09:00:00,552,84338,83873
"843",13258,2016-07-06 10:00:00,552,102,102,0,0,0,2016-07-06 10:00:00,552,64,77,42,119,183,2016-07-06 10:00:00,552,89257,88830
"844",13259,2016-07-06 11:00:00,552,114,114,0,0,0,2016-07-06 11:00:00,552,111,170,105,275,386,2016-07-06 11:00:00,552,112645,112185
"845",13260,2016-07-06 12:00:00,552,127,127,0,0,0,2016-07-06 12:00:00,552,259,291,170,461,720,2016-07-06 12:00:00,552,152600,152044
"846",13261,2016-07-06 13:00:00,552,174,174,0,0,0,2016-07-06 13:00:00,552,449,641,414,1055,1504,2016-07-06 13:00:00,552,182417,181667
"847",13262,2016-07-06 14:00:00,552,199,199,0,0,0,2016-07-06 14:00:00,552,663,785,429,1214,1877,2016-07-06 14:00:00,552,190511,189632
"848",13263,2016-07-06 15:00:00,552,203,203,0,0,0,2016-07-06 15:00:00,552,711,891,480,1371,2082,2016-07-06 15:00:00,552,188606,187754
"849",13264,2016-07-06 16:00:00,552,280,280,0,0,0,2016-07-06 16:00:00,552,739,1075,603,1678,2417,2016-07-06 16:00:00,552,173823,173026
"850",13265,2016-07-06 17:00:00,552,358,358,0,0,0,2016-07-06 17:00:00,552,771,1286,693,1979,2750,2016-07-06 17:00:00,552,169569,168756
"851",13266,2016-07-06 18:00:00,552,416,416,0,0,0,2016-07-06 18:00:00,552,833,1373,719,2092,2925,2016-07-06 18:00:00,552,168753,167938
"852",13267,2016-07-06 19:00:00,552,393,393,0,0,0,2016-07-06 19:00:00,552,795,1453,747,2200,2995,2016-07-06 19:00:00,552,162647,161882
"853",13268,2016-07-06 20:00:00,552,353,353,0,0,0,2016-07-06 20:00:00,552,818,1476,737,2213,3031,2016-07-06 20:00:00,552,151709,150960
"854",13269,2016-07-06 21:00:00,552,374,374,0,0,0,2016-07-06 21:00:00,552,742,1584,795,2379,3121,2016-07-06 21:00:00,552,131837,131217
"855",13270,2016-07-06 22:00:00,552,344,344,0,0,0,2016-07-06 22:00:00,552,651,1587,772,2359,3010,2016-07-06 22:00:00,552,109181,108654
"856",13271,2016-07-06 23:00:00,552,272,272,0,0,0,2016-07-06 23:00:00,552,620,1720,798,2518,3138,2016-07-06 23:00:00,552,99125,98658
"857",13272,2016-07-07 00:00:00,553,278,278,0,0,0,2016-07-07 00:00:00,553,442,1481,701,2182,2624,2016-07-07 00:00:00,553,95267,94814
"858",13273,2016-07-07 01:00:00,553,247,247,0,0,0,2016-07-07 01:00:00,553,420,1256,577,1833,2253,2016-07-07 01:00:00,553,97174,96677
"859",13274,2016-07-07 02:00:00,553,249,249,0,0,0,2016-07-07 02:00:00,553,343,1040,475,1515,1858,2016-07-07 02:00:00,553,92587,92137
"860",13275,2016-07-07 03:00:00,553,223,223,0,0,0,2016-07-07 03:00:00,553,277,718,319,1037,1314,2016-07-07 03:00:00,553,85091,84677
"861",13276,2016-07-07 04:00:00,553,199,199,0,0,0,2016-07-07 04:00:00,553,164,602,277,879,1043,2016-07-07 04:00:00,553,77489,77103
"862",13277,2016-07-07 05:00:00,553,213,213,0,0,0,2016-07-07 05:00:00,553,121,298,124,422,543,2016-07-07 05:00:00,553,75971,75613
"863",13278,2016-07-07 06:00:00,553,159,159,0,0,0,2016-07-07 06:00:00,553,75,104,66,170,245,2016-07-07 06:00:00,553,82855,82442
"864",13279,2016-07-07 07:00:00,553,150,150,0,0,0,2016-07-07 07:00:00,553,82,98,46,144,226,2016-07-07 07:00:00,553,84779,84363
"865",13280,2016-07-07 08:00:00,553,137,137,0,0,0,2016-07-07 08:00:00,553,34,62,34,96,130,2016-07-07 08:00:00,553,85477,85033
"866",13281,2016-07-07 09:00:00,553,132,132,0,0,0,2016-07-07 09:00:00,553,48,41,21,62,110,2016-07-07 09:00:00,553,87030,86613
"867",13282,2016-07-07 10:00:00,553,120,120,0,0,0,2016-07-07 10:00:00,553,70,69,41,110,180,2016-07-07 10:00:00,553,89583,89152
"868",13283,2016-07-07 11:00:00,553,136,136,0,0,0,2016-07-07 11:00:00,553,106,124,82,206,312,2016-07-07 11:00:00,553,108179,107706
"869",13284,2016-07-07 12:00:00,553,189,189,0,0,0,2016-07-07 12:00:00,553,238,349,208,557,795,2016-07-07 12:00:00,553,142570,142017
"870",13285,2016-07-07 13:00:00,553,260,260,0,0,0,2016-07-07 13:00:00,553,449,627,390,1017,1466,2016-07-07 13:00:00,553,171573,170800
"871",13286,2016-07-07 14:00:00,553,331,331,0,0,0,2016-07-07 14:00:00,553,507,712,403,1115,1622,2016-07-07 14:00:00,553,181551,180767
"872",13287,2016-07-07 15:00:00,553,367,367,0,0,0,2016-07-07 15:00:00,553,674,845,450,1295,1969,2016-07-07 15:00:00,553,180141,179324
"873",13288,2016-07-07 16:00:00,553,313,313,0,0,0,2016-07-07 16:00:00,553,731,1085,584,1669,2400,2016-07-07 16:00:00,553,164431,163645
"874",13289,2016-07-07 17:00:00,553,378,378,0,0,0,2016-07-07 17:00:00,553,757,1259,654,1913,2670,2016-07-07 17:00:00,553,161896,161159
"875",13290,2016-07-07 18:00:00,553,390,390,0,0,0,2016-07-07 18:00:00,553,782,1295,628,1923,2705,2016-07-07 18:00:00,553,162572,161782
"876",13291,2016-07-07 19:00:00,553,364,364,0,0,0,2016-07-07 19:00:00,553,856,1536,778,2314,3170,2016-07-07 19:00:00,553,156573,155796
"877",13292,2016-07-07 20:00:00,553,315,315,0,0,0,2016-07-07 20:00:00,553,823,1630,812,2442,3265,2016-07-07 20:00:00,553,145195,144479
"878",13293,2016-07-07 21:00:00,553,335,335,0,0,0,2016-07-07 21:00:00,553,729,1521,700,2221,2950,2016-07-07 21:00:00,553,127941,127309
"879",13294,2016-07-07 22:00:00,553,296,296,0,0,0,2016-07-07 22:00:00,553,680,1666,801,2467,3147,2016-07-07 22:00:00,553,108395,107869
"880",13295,2016-07-07 23:00:00,553,294,294,0,0,0,2016-07-07 23:00:00,553,581,1410,644,2054,2635,2016-07-07 23:00:00,553,99032,98596
"881",13296,2016-07-08 00:00:00,554,286,286,0,0,0,2016-07-08 00:00:00,554,517,1259,583,1842,2359,2016-07-08 00:00:00,554,95018,94543
"882",13297,2016-07-08 01:00:00,554,284,284,0,0,0,2016-07-08 01:00:00,554,442,1233,516,1749,2191,2016-07-08 01:00:00,554,95933,95482
"883",13298,2016-07-08 02:00:00,554,253,253,0,0,0,2016-07-08 02:00:00,554,336,975,438,1413,1749,2016-07-08 02:00:00,554,90661,90231
"884",13299,2016-07-08 03:00:00,554,208,208,0,0,0,2016-07-08 03:00:00,554,229,764,340,1104,1333,2016-07-08 03:00:00,554,83047,82614
"885",13300,2016-07-08 04:00:00,554,220,220,0,0,0,2016-07-08 04:00:00,554,168,539,240,779,947,2016-07-08 04:00:00,554,77794,77414
"886",13301,2016-07-08 05:00:00,554,179,179,0,0,0,2016-07-08 05:00:00,554,131,293,123,416,547,2016-07-08 05:00:00,554,75378,75023
"887",13302,2016-07-08 06:00:00,554,127,127,0,0,0,2016-07-08 06:00:00,554,80,155,74,229,309,2016-07-08 06:00:00,554,81171,80799
"888",13303,2016-07-08 07:00:00,554,122,122,0,0,0,2016-07-08 07:00:00,554,50,73,41,114,164,2016-07-08 07:00:00,554,82901,82487
"889",13304,2016-07-08 08:00:00,554,124,124,0,0,0,2016-07-08 08:00:00,554,48,66,23,89,137,2016-07-08 08:00:00,554,83859,83422
"890",13305,2016-07-08 09:00:00,554,98,98,0,0,0,2016-07-08 09:00:00,554,40,36,22,58,98,2016-07-08 09:00:00,554,85152,84714
"891",13306,2016-07-08 10:00:00,554,110,110,0,0,0,2016-07-08 10:00:00,554,80,107,51,158,238,2016-07-08 10:00:00,554,89932,89546
"892",13307,2016-07-08 11:00:00,554,147,147,0,0,0,2016-07-08 11:00:00,554,119,136,63,199,318,2016-07-08 11:00:00,554,117351,116932
"893",13308,2016-07-08 12:00:00,554,169,169,0,0,0,2016-07-08 12:00:00,554,222,303,160,463,685,2016-07-08 12:00:00,554,163463,162939
"894",13309,2016-07-08 13:00:00,554,220,220,0,0,0,2016-07-08 13:00:00,554,485,648,332,980,1465,2016-07-08 13:00:00,554,191731,190999
"895",13310,2016-07-08 14:00:00,554,306,306,0,0,0,2016-07-08 14:00:00,554,534,697,372,1069,1603,2016-07-08 14:00:00,554,192785,191996
"896",13311,2016-07-08 15:00:00,554,282,282,0,0,0,2016-07-08 15:00:00,554,632,890,496,1386,2018,2016-07-08 15:00:00,554,189331,188526
"897",13312,2016-07-08 16:00:00,554,324,324,0,0,0,2016-07-08 16:00:00,554,656,1065,562,1627,2283,2016-07-08 16:00:00,554,170779,170018
"898",13313,2016-07-08 17:00:00,554,359,359,0,0,0,2016-07-08 17:00:00,554,750,1187,573,1760,2510,2016-07-08 17:00:00,554,164227,163536
"899",13314,2016-07-08 18:00:00,554,350,350,0,0,0,2016-07-08 18:00:00,554,812,1369,648,2017,2829,2016-07-08 18:00:00,554,161165,160452
"900",13315,2016-07-08 19:00:00,554,304,304,0,0,0,2016-07-08 19:00:00,554,873,1589,720,2309,3182,2016-07-08 19:00:00,554,154022,153311
"901",13316,2016-07-08 20:00:00,554,335,335,0,0,0,2016-07-08 20:00:00,554,782,1624,726,2350,3132,2016-07-08 20:00:00,554,141630,140980
"902",13317,2016-07-08 21:00:00,554,325,325,0,0,0,2016-07-08 21:00:00,554,703,1689,761,2450,3153,2016-07-08 21:00:00,554,119122,118543
"903",13318,2016-07-08 22:00:00,554,274,274,0,0,0,2016-07-08 22:00:00,554,579,1577,701,2278,2857,2016-07-08 22:00:00,554,99116,98635
"904",13319,2016-07-08 23:00:00,554,244,244,0,0,0,2016-07-08 23:00:00,554,497,1524,673,2197,2694,2016-07-08 23:00:00,554,85846,85442
"905",13320,2016-07-09 00:00:00,555,241,241,0,0,0,2016-07-09 00:00:00,555,374,1373,564,1937,2311,2016-07-09 00:00:00,555,78021,77649
"906",13321,2016-07-09 01:00:00,555,241,241,0,0,0,2016-07-09 01:00:00,555,320,1176,497,1673,1993,2016-07-09 01:00:00,555,75316,74967
"907",13322,2016-07-09 02:00:00,555,220,220,0,0,0,2016-07-09 02:00:00,555,285,937,418,1355,1640,2016-07-09 02:00:00,555,73658,73293
"908",13323,2016-07-09 03:00:00,555,216,216,0,0,0,2016-07-09 03:00:00,555,199,829,340,1169,1368,2016-07-09 03:00:00,555,70317,69986
"909",13324,2016-07-09 04:00:00,555,166,166,0,0,0,2016-07-09 04:00:00,555,178,594,263,857,1035,2016-07-09 04:00:00,555,66084,65773
"910",13325,2016-07-09 05:00:00,555,144,144,0,0,0,2016-07-09 05:00:00,555,111,387,168,555,666,2016-07-09 05:00:00,555,61455,61166
"911",13326,2016-07-09 06:00:00,555,109,109,0,0,0,2016-07-09 06:00:00,555,65,168,69,237,302,2016-07-09 06:00:00,555,59098,58796
"912",13327,2016-07-09 07:00:00,555,114,114,0,0,0,2016-07-09 07:00:00,555,72,98,44,142,214,2016-07-09 07:00:00,555,57549,57272
"913",13328,2016-07-09 08:00:00,555,110,110,0,0,0,2016-07-09 08:00:00,555,53,62,28,90,143,2016-07-09 08:00:00,555,57062,56752
"914",13329,2016-07-09 09:00:00,555,123,123,0,0,0,2016-07-09 09:00:00,555,45,58,29,87,132,2016-07-09 09:00:00,555,58045,57724
"915",13330,2016-07-09 10:00:00,555,113,113,0,0,0,2016-07-09 10:00:00,555,59,57,32,89,148,2016-07-09 10:00:00,555,61479,61182
"916",13331,2016-07-09 11:00:00,555,113,113,0,0,0,2016-07-09 11:00:00,555,86,103,62,165,251,2016-07-09 11:00:00,555,70407,70103
"917",13332,2016-07-09 12:00:00,555,137,137,0,0,0,2016-07-09 12:00:00,555,194,217,111,328,522,2016-07-09 12:00:00,555,80670,80288
"918",13333,2016-07-09 13:00:00,555,190,190,0,0,0,2016-07-09 13:00:00,555,320,558,297,855,1175,2016-07-09 13:00:00,555,90381,89998
"919",13334,2016-07-09 14:00:00,555,237,237,0,0,0,2016-07-09 14:00:00,555,412,717,355,1072,1484,2016-07-09 14:00:00,555,97398,96971
"920",13335,2016-07-09 15:00:00,555,259,259,0,0,0,2016-07-09 15:00:00,555,407,879,434,1313,1720,2016-07-09 15:00:00,555,101913,101460
"921",13336,2016-07-09 16:00:00,555,280,280,0,0,0,2016-07-09 16:00:00,555,490,1058,514,1572,2062,2016-07-09 16:00:00,555,101050,100502
"922",13337,2016-07-09 17:00:00,555,250,250,0,0,0,2016-07-09 17:00:00,555,492,1154,547,1701,2193,2016-07-09 17:00:00,555,98378,97843
"923",13338,2016-07-09 18:00:00,555,297,297,0,0,0,2016-07-09 18:00:00,555,524,1176,568,1744,2268,2016-07-09 18:00:00,555,95969,95507
"924",13339,2016-07-09 19:00:00,555,279,279,0,0,0,2016-07-09 19:00:00,555,492,1336,588,1924,2416,2016-07-09 19:00:00,555,91789,91291
"925",13340,2016-07-09 20:00:00,555,242,242,0,0,0,2016-07-09 20:00:00,555,497,1333,600,1933,2430,2016-07-09 20:00:00,555,86403,85927
"926",13341,2016-07-09 21:00:00,555,207,207,0,0,0,2016-07-09 21:00:00,555,449,1398,666,2064,2513,2016-07-09 21:00:00,555,80594,80169
"927",13342,2016-07-09 22:00:00,555,249,249,0,0,0,2016-07-09 22:00:00,555,397,1277,568,1845,2242,2016-07-09 22:00:00,555,74629,74232
"928",13343,2016-07-09 23:00:00,555,254,254,0,0,0,2016-07-09 23:00:00,555,382,1306,586,1892,2274,2016-07-09 23:00:00,555,70363,69983
"929",13344,2016-07-10 00:00:00,556,225,225,0,0,0,2016-07-10 00:00:00,556,338,1286,549,1835,2173,2016-07-10 00:00:00,556,68300,67951
"930",13345,2016-07-10 01:00:00,556,245,245,0,0,0,2016-07-10 01:00:00,556,309,1283,530,1813,2122,2016-07-10 01:00:00,556,69211,68881
"931",13346,2016-07-10 02:00:00,556,236,236,0,0,0,2016-07-10 02:00:00,556,257,1214,492,1706,1963,2016-07-10 02:00:00,556,71656,71291
"932",13347,2016-07-10 03:00:00,556,214,214,0,0,0,2016-07-10 03:00:00,556,190,1065,457,1522,1712,2016-07-10 03:00:00,556,70338,69993
"933",13348,2016-07-10 04:00:00,556,181,181,0,0,0,2016-07-10 04:00:00,556,142,579,272,851,993,2016-07-10 04:00:00,556,65722,65413
"934",13349,2016-07-10 05:00:00,556,180,180,0,0,0,2016-07-10 05:00:00,556,154,328,138,466,620,2016-07-10 05:00:00,556,62489,62185
"935",13350,2016-07-10 06:00:00,556,115,115,0,0,0,2016-07-10 06:00:00,556,83,155,58,213,296,2016-07-10 06:00:00,556,58734,58456
"936",13351,2016-07-10 07:00:00,556,131,131,0,0,0,2016-07-10 07:00:00,556,63,103,41,144,207,2016-07-10 07:00:00,556,57256,56944
"937",13352,2016-07-10 08:00:00,556,119,119,0,0,0,2016-07-10 08:00:00,556,47,56,25,81,128,2016-07-10 08:00:00,556,56213,55926
"938",13353,2016-07-10 09:00:00,556,115,115,0,0,0,2016-07-10 09:00:00,556,48,47,24,71,119,2016-07-10 09:00:00,556,57031,56739
"939",13354,2016-07-10 10:00:00,556,91,91,0,0,0,2016-07-10 10:00:00,556,47,53,24,77,124,2016-07-10 10:00:00,556,59922,59619
"940",13355,2016-07-10 11:00:00,556,91,91,0,0,0,2016-07-10 11:00:00,556,80,66,26,92,172,2016-07-10 11:00:00,556,65774,65463
"941",13356,2016-07-10 12:00:00,556,135,135,0,0,0,2016-07-10 12:00:00,556,123,180,92,272,395,2016-07-10 12:00:00,556,73616,73288
"942",13357,2016-07-10 13:00:00,556,208,208,0,0,0,2016-07-10 13:00:00,556,214,380,188,568,782,2016-07-10 13:00:00,556,81619,81251
"943",13358,2016-07-10 14:00:00,556,243,243,0,0,0,2016-07-10 14:00:00,556,252,476,252,728,980,2016-07-10 14:00:00,556,88945,88511
"944",13359,2016-07-10 15:00:00,556,203,203,0,0,0,2016-07-10 15:00:00,556,293,734,393,1127,1420,2016-07-10 15:00:00,556,92210,91791
"945",13360,2016-07-10 16:00:00,556,252,252,0,0,0,2016-07-10 16:00:00,556,351,889,431,1320,1671,2016-07-10 16:00:00,556,93513,93027
"946",13361,2016-07-10 17:00:00,556,226,226,0,0,0,2016-07-10 17:00:00,556,407,1026,495,1521,1928,2016-07-10 17:00:00,556,94440,93980
"947",13362,2016-07-10 18:00:00,556,283,283,0,0,0,2016-07-10 18:00:00,556,466,1157,532,1689,2155,2016-07-10 18:00:00,556,93164,92676
"948",13363,2016-07-10 19:00:00,556,249,249,0,0,0,2016-07-10 19:00:00,556,463,1337,619,1956,2419,2016-07-10 19:00:00,556,89853,89399
"949",13364,2016-07-10 20:00:00,556,216,216,0,0,0,2016-07-10 20:00:00,556,514,1301,609,1910,2424,2016-07-10 20:00:00,556,87121,86654
"950",13365,2016-07-10 21:00:00,556,264,264,0,0,0,2016-07-10 21:00:00,556,449,1332,616,1948,2397,2016-07-10 21:00:00,556,80710,80281
"951",13366,2016-07-10 22:00:00,556,239,239,0,0,0,2016-07-10 22:00:00,556,398,1236,526,1762,2160,2016-07-10 22:00:00,556,79210,78812
"952",13367,2016-07-10 23:00:00,556,216,216,0,0,0,2016-07-10 23:00:00,556,407,1150,494,1644,2051,2016-07-10 23:00:00,556,80309,79898
"953",13368,2016-07-11 00:00:00,557,251,251,0,0,0,2016-07-11 00:00:00,557,310,1143,532,1675,1985,2016-07-11 00:00:00,557,87473,87083
"954",13369,2016-07-11 01:00:00,557,255,255,0,0,0,2016-07-11 01:00:00,557,324,1013,432,1445,1769,2016-07-11 01:00:00,557,94512,94088
"955",13370,2016-07-11 02:00:00,557,235,235,0,0,0,2016-07-11 02:00:00,557,264,883,368,1251,1515,2016-07-11 02:00:00,557,89081,88633
"956",13371,2016-07-11 03:00:00,557,201,201,0,0,0,2016-07-11 03:00:00,557,193,752,340,1092,1285,2016-07-11 03:00:00,557,84476,84096
"957",13372,2016-07-11 04:00:00,557,200,200,0,0,0,2016-07-11 04:00:00,557,143,545,234,779,922,2016-07-11 04:00:00,557,81792,81454
"958",13373,2016-07-11 05:00:00,557,160,160,0,0,0,2016-07-11 05:00:00,557,95,241,119,360,455,2016-07-11 05:00:00,557,83241,82882
"959",13374,2016-07-11 06:00:00,557,125,125,0,0,0,2016-07-11 06:00:00,557,76,140,53,193,269,2016-07-11 06:00:00,557,90473,90052
"960",13375,2016-07-11 07:00:00,557,131,131,0,0,0,2016-07-11 07:00:00,557,41,81,27,108,149,2016-07-11 07:00:00,557,92859,92425
"961",13376,2016-07-11 08:00:00,557,148,148,0,0,0,2016-07-11 08:00:00,557,66,42,17,59,125,2016-07-11 08:00:00,557,93730,93281
"962",13377,2016-07-11 09:00:00,557,130,130,0,0,0,2016-07-11 09:00:00,557,37,37,18,55,92,2016-07-11 09:00:00,557,96907,96408
"963",13378,2016-07-11 10:00:00,557,158,158,0,0,0,2016-07-11 10:00:00,557,50,37,24,61,111,2016-07-11 10:00:00,557,105219,104774
"964",13379,2016-07-11 11:00:00,557,137,137,0,0,0,2016-07-11 11:00:00,557,94,101,63,164,258,2016-07-11 11:00:00,557,146665,146163
"965",13380,2016-07-11 12:00:00,557,171,171,0,0,0,2016-07-11 12:00:00,557,252,248,144,392,644,2016-07-11 12:00:00,557,211711,211069
"966",13381,2016-07-11 13:00:00,557,189,189,0,0,0,2016-07-11 13:00:00,557,451,612,376,988,1439,2016-07-11 13:00:00,557,237250,236485
"967",13382,2016-07-11 14:00:00,557,355,355,0,0,0,2016-07-11 14:00:00,557,586,658,372,1030,1616,2016-07-11 14:00:00,557,232796,231952
"968",13383,2016-07-11 15:00:00,557,347,347,0,0,0,2016-07-11 15:00:00,557,625,847,433,1280,1905,2016-07-11 15:00:00,557,223028,222127
"969",13384,2016-07-11 16:00:00,557,380,380,0,0,0,2016-07-11 16:00:00,557,700,1046,548,1594,2294,2016-07-11 16:00:00,557,203024,202200
"970",13385,2016-07-11 17:00:00,557,331,331,0,0,0,2016-07-11 17:00:00,557,786,1179,609,1788,2574,2016-07-11 17:00:00,557,188064,187281
"971",13386,2016-07-11 18:00:00,557,393,393,0,0,0,2016-07-11 18:00:00,557,785,1398,671,2069,2854,2016-07-11 18:00:00,557,187069,186259
"972",13387,2016-07-11 19:00:00,557,367,367,0,0,0,2016-07-11 19:00:00,557,942,1510,747,2257,3199,2016-07-11 19:00:00,557,178978,178142
"973",13388,2016-07-11 20:00:00,557,367,367,0,0,0,2016-07-11 20:00:00,557,826,1487,717,2204,3030,2016-07-11 20:00:00,557,166423,165697
"974",13389,2016-07-11 21:00:00,557,344,344,0,0,0,2016-07-11 21:00:00,557,735,1559,778,2337,3072,2016-07-11 21:00:00,557,140326,139751
"975",13390,2016-07-11 22:00:00,557,357,357,0,0,0,2016-07-11 22:00:00,557,710,1585,760,2345,3055,2016-07-11 22:00:00,557,114943,114463
"976",13391,2016-07-11 23:00:00,557,331,331,0,0,0,2016-07-11 23:00:00,557,604,1508,688,2196,2800,2016-07-11 23:00:00,557,102834,102378
"977",13392,2016-07-12 00:00:00,558,254,254,0,0,0,2016-07-12 00:00:00,558,536,1395,594,1989,2525,2016-07-12 00:00:00,558,98349,97907
"978",13393,2016-07-12 01:00:00,558,276,276,0,0,0,2016-07-12 01:00:00,558,420,1157,499,1656,2076,2016-07-12 01:00:00,558,98962,98500
"979",13394,2016-07-12 02:00:00,558,270,270,0,0,0,2016-07-12 02:00:00,558,339,993,422,1415,1754,2016-07-12 02:00:00,558,93809,93379
"980",13395,2016-07-12 03:00:00,558,209,209,0,0,0,2016-07-12 03:00:00,558,250,727,308,1035,1285,2016-07-12 03:00:00,558,87025,86594
"981",13396,2016-07-12 04:00:00,558,201,201,0,0,0,2016-07-12 04:00:00,558,184,567,270,837,1021,2016-07-12 04:00:00,558,81829,81430
"982",13397,2016-07-12 05:00:00,558,152,152,0,0,0,2016-07-12 05:00:00,558,121,287,126,413,534,2016-07-12 05:00:00,558,80345,79950
"983",13398,2016-07-12 06:00:00,558,161,161,0,0,0,2016-07-12 06:00:00,558,82,123,55,178,260,2016-07-12 06:00:00,558,87562,87135
"984",13399,2016-07-12 07:00:00,558,139,139,0,0,0,2016-07-12 07:00:00,558,78,74,27,101,179,2016-07-12 07:00:00,558,91016,90570
"985",13400,2016-07-12 08:00:00,558,120,120,0,0,0,2016-07-12 08:00:00,558,41,39,18,57,98,2016-07-12 08:00:00,558,93278,92765
"986",13401,2016-07-12 09:00:00,558,93,93,0,0,0,2016-07-12 09:00:00,558,55,35,15,50,105,2016-07-12 09:00:00,558,95082,94587
"987",13402,2016-07-12 10:00:00,558,115,115,0,0,0,2016-07-12 10:00:00,558,79,76,36,112,191,2016-07-12 10:00:00,558,98145,97648
"988",13403,2016-07-12 11:00:00,558,139,139,0,0,0,2016-07-12 11:00:00,558,120,91,62,153,273,2016-07-12 11:00:00,558,125093,124577
"989",13404,2016-07-12 12:00:00,558,130,130,0,0,0,2016-07-12 12:00:00,558,274,284,160,444,718,2016-07-12 12:00:00,558,169577,168982
"990",13405,2016-07-12 13:00:00,558,227,227,0,0,0,2016-07-12 13:00:00,558,458,550,285,835,1293,2016-07-12 13:00:00,558,195113,194282
"991",13406,2016-07-12 14:00:00,558,373,373,0,0,0,2016-07-12 14:00:00,558,553,647,360,1007,1560,2016-07-12 14:00:00,558,199064,198183
"992",13407,2016-07-12 15:00:00,558,340,340,0,0,0,2016-07-12 15:00:00,558,667,822,404,1226,1893,2016-07-12 15:00:00,558,195588,194662
"993",13408,2016-07-12 16:00:00,558,376,376,0,0,0,2016-07-12 16:00:00,558,686,1021,498,1519,2205,2016-07-12 16:00:00,558,176758,175935
"994",13409,2016-07-12 17:00:00,558,397,397,0,0,0,2016-07-12 17:00:00,558,760,1097,494,1591,2351,2016-07-12 17:00:00,558,173224,172419
"995",13410,2016-07-12 18:00:00,558,401,401,0,0,0,2016-07-12 18:00:00,558,780,1231,548,1779,2559,2016-07-12 18:00:00,558,174548,173681
"996",13411,2016-07-12 19:00:00,558,373,373,0,0,0,2016-07-12 19:00:00,558,800,1227,518,1745,2545,2016-07-12 19:00:00,558,168897,168079
"997",13412,2016-07-12 20:00:00,558,394,394,0,0,0,2016-07-12 20:00:00,558,776,1336,603,1939,2715,2016-07-12 20:00:00,558,159167,158399
"998",13413,2016-07-12 21:00:00,558,327,327,0,0,0,2016-07-12 21:00:00,558,688,1390,605,1995,2683,2016-07-12 21:00:00,558,134766,134159
"999",13414,2016-07-12 22:00:00,558,348,348,0,0,0,2016-07-12 22:00:00,558,616,1201,515,1716,2332,2016-07-12 22:00:00,558,112398,111827
"1000",13415,2016-07-12 23:00:00,558,295,295,0,0,0,2016-07-12 23:00:00,558,567,1334,518,1852,2419,2016-07-12 23:00:00,558,102097,101602
"1001",13416,2016-07-13 00:00:00,559,295,295,0,0,0,2016-07-13 00:00:00,559,459,1215,490,1705,2164,2016-07-13 00:00:00,559,97020,96611
"1002",13417,2016-07-13 01:00:00,559,283,283,0,0,0,2016-07-13 01:00:00,559,395,1056,421,1477,1872,2016-07-13 01:00:00,559,98888,98383
"1003",13418,2016-07-13 02:00:00,559,224,224,0,0,0,2016-07-13 02:00:00,559,338,884,337,1221,1559,2016-07-13 02:00:00,559,96298,95791
"1004",13419,2016-07-13 03:00:00,559,231,231,0,0,0,2016-07-13 03:00:00,559,257,706,304,1010,1267,2016-07-13 03:00:00,559,90616,90184
"1005",13420,2016-07-13 04:00:00,559,202,202,0,0,0,2016-07-13 04:00:00,559,186,481,180,661,847,2016-07-13 04:00:00,559,86343,85895
"1006",13421,2016-07-13 05:00:00,559,162,162,0,0,0,2016-07-13 05:00:00,559,126,259,102,361,487,2016-07-13 05:00:00,559,83879,83477
"1007",13422,2016-07-13 06:00:00,559,133,133,0,0,0,2016-07-13 06:00:00,559,80,136,37,173,253,2016-07-13 06:00:00,559,90954,90498
"1008",13423,2016-07-13 07:00:00,559,121,121,0,0,0,2016-07-13 07:00:00,559,49,74,31,105,154,2016-07-13 07:00:00,559,97625,97137
"1009",13424,2016-07-13 08:00:00,559,121,121,0,0,0,2016-07-13 08:00:00,559,54,58,22,80,134,2016-07-13 08:00:00,559,98077,97545
"1010",13425,2016-07-13 09:00:00,559,151,151,0,0,0,2016-07-13 09:00:00,559,54,42,16,58,112,2016-07-13 09:00:00,559,99641,99113
"1011",13426,2016-07-13 10:00:00,559,142,142,0,0,0,2016-07-13 10:00:00,559,64,55,32,87,151,2016-07-13 10:00:00,559,101879,101385
"1012",13427,2016-07-13 11:00:00,559,157,157,0,0,0,2016-07-13 11:00:00,559,129,126,58,184,313,2016-07-13 11:00:00,559,119970,119441
"1013",13428,2016-07-13 12:00:00,559,178,178,0,0,0,2016-07-13 12:00:00,559,259,242,134,376,635,2016-07-13 12:00:00,559,154726,154022
"1014",13429,2016-07-13 13:00:00,559,233,233,0,0,0,2016-07-13 13:00:00,559,512,509,269,778,1290,2016-07-13 13:00:00,559,184035,183195
"1015",13430,2016-07-13 14:00:00,559,375,375,0,0,0,2016-07-13 14:00:00,559,609,532,277,809,1418,2016-07-13 14:00:00,559,192673,191764
"1016",13431,2016-07-13 15:00:00,559,377,377,0,0,0,2016-07-13 15:00:00,559,712,742,385,1127,1839,2016-07-13 15:00:00,559,191873,190877
"1017",13432,2016-07-13 16:00:00,559,400,400,0,0,0,2016-07-13 16:00:00,559,724,867,402,1269,1993,2016-07-13 16:00:00,559,177257,176417
"1018",13433,2016-07-13 17:00:00,559,448,448,0,0,0,2016-07-13 17:00:00,559,787,1185,539,1724,2511,2016-07-13 17:00:00,559,172076,171251
"1019",13434,2016-07-13 18:00:00,559,434,434,0,0,0,2016-07-13 18:00:00,559,825,1302,530,1832,2657,2016-07-13 18:00:00,559,172358,171454
"1020",13435,2016-07-13 19:00:00,559,404,404,0,0,0,2016-07-13 19:00:00,559,783,1324,599,1923,2706,2016-07-13 19:00:00,559,168071,167238
"1021",13436,2016-07-13 20:00:00,559,402,402,0,0,0,2016-07-13 20:00:00,559,676,1073,467,1540,2216,2016-07-13 20:00:00,559,156924,156149
"1022",13437,2016-07-13 21:00:00,559,355,355,0,0,0,2016-07-13 21:00:00,559,664,1150,507,1657,2321,2016-07-13 21:00:00,559,134034,133389
"1023",13438,2016-07-13 22:00:00,559,358,358,0,0,0,2016-07-13 22:00:00,559,638,1251,532,1783,2421,2016-07-13 22:00:00,559,111963,111406
"1024",13439,2016-07-13 23:00:00,559,335,335,0,0,0,2016-07-13 23:00:00,559,574,1201,462,1663,2237,2016-07-13 23:00:00,559,101266,100762
"1025",13440,2016-07-14 00:00:00,560,293,293,0,0,0,2016-07-14 00:00:00,560,536,1138,439,1577,2113,2016-07-14 00:00:00,560,99870,99381
"1026",13441,2016-07-14 01:00:00,560,279,279,0,0,0,2016-07-14 01:00:00,560,474,1155,439,1594,2068,2016-07-14 01:00:00,560,102087,101627
"1027",13442,2016-07-14 02:00:00,560,245,245,0,0,0,2016-07-14 02:00:00,560,317,850,276,1126,1443,2016-07-14 02:00:00,560,97723,97238
"1028",13443,2016-07-14 03:00:00,560,234,234,0,0,0,2016-07-14 03:00:00,560,263,654,223,877,1140,2016-07-14 03:00:00,560,91470,91043
"1029",13444,2016-07-14 04:00:00,560,212,212,0,0,0,2016-07-14 04:00:00,560,221,533,189,722,943,2016-07-14 04:00:00,560,86559,86168
"1030",13445,2016-07-14 05:00:00,560,206,206,0,0,0,2016-07-14 05:00:00,560,106,273,93,366,472,2016-07-14 05:00:00,560,86178,85746
"1031",13446,2016-07-14 06:00:00,560,148,148,0,0,0,2016-07-14 06:00:00,560,84,124,42,166,250,2016-07-14 06:00:00,560,92862,92415
"1032",13447,2016-07-14 07:00:00,560,140,140,0,0,0,2016-07-14 07:00:00,560,62,68,23,91,153,2016-07-14 07:00:00,560,99142,98663
"1033",13448,2016-07-14 08:00:00,560,131,131,0,0,0,2016-07-14 08:00:00,560,44,54,18,72,116,2016-07-14 08:00:00,560,98756,98187
"1034",13449,2016-07-14 09:00:00,560,145,145,0,0,0,2016-07-14 09:00:00,560,55,36,14,50,105,2016-07-14 09:00:00,560,98875,98387
"1035",13450,2016-07-14 10:00:00,560,138,138,0,0,0,2016-07-14 10:00:00,560,83,76,42,118,201,2016-07-14 10:00:00,560,103107,102590
"1036",13451,2016-07-14 11:00:00,560,171,171,0,0,0,2016-07-14 11:00:00,560,138,119,53,172,310,2016-07-14 11:00:00,560,127571,127050
"1037",13452,2016-07-14 12:00:00,560,189,189,0,0,0,2016-07-14 12:00:00,560,341,274,146,420,761,2016-07-14 12:00:00,560,171864,171237
"1038",13453,2016-07-14 13:00:00,560,287,287,0,0,0,2016-07-14 13:00:00,560,585,505,257,762,1347,2016-07-14 13:00:00,560,203779,202959
"1039",13454,2016-07-14 14:00:00,560,348,348,0,0,0,2016-07-14 14:00:00,560,686,615,283,898,1584,2016-07-14 14:00:00,560,209918,208988
"1040",13455,2016-07-14 15:00:00,560,317,317,0,0,0,2016-07-14 15:00:00,560,760,750,366,1116,1876,2016-07-14 15:00:00,560,206753,205857
"1041",13456,2016-07-14 16:00:00,560,398,398,0,0,0,2016-07-14 16:00:00,560,781,832,416,1248,2029,2016-07-14 16:00:00,560,188035,187190
"1042",13457,2016-07-14 17:00:00,560,445,445,0,0,0,2016-07-14 17:00:00,560,872,916,457,1373,2245,2016-07-14 17:00:00,560,183239,182439
"1043",13458,2016-07-14 18:00:00,560,386,386,0,0,0,2016-07-14 18:00:00,560,945,1096,477,1573,2518,2016-07-14 18:00:00,560,184518,183678
"1044",13459,2016-07-14 19:00:00,560,364,364,0,0,0,2016-07-14 19:00:00,560,903,1098,444,1542,2445,2016-07-14 19:00:00,560,178773,177907
"1045",13460,2016-07-14 20:00:00,560,387,387,0,0,0,2016-07-14 20:00:00,560,912,1217,534,1751,2663,2016-07-14 20:00:00,560,165400,164627
"1046",13461,2016-07-14 21:00:00,560,349,349,0,0,0,2016-07-14 21:00:00,560,775,1165,455,1620,2395,2016-07-14 21:00:00,560,138697,138029
"1047",13462,2016-07-14 22:00:00,560,332,332,0,0,0,2016-07-14 22:00:00,560,658,1229,489,1718,2376,2016-07-14 22:00:00,560,113525,113008
"1048",13463,2016-07-14 23:00:00,560,275,275,0,0,0,2016-07-14 23:00:00,560,619,1243,537,1780,2399,2016-07-14 23:00:00,560,100882,100442
"1049",13464,2016-07-15 00:00:00,561,272,272,0,0,0,2016-07-15 00:00:00,561,526,1352,574,1926,2452,2016-07-15 00:00:00,561,97129,96701
"1050",13465,2016-07-15 01:00:00,561,274,274,0,0,0,2016-07-15 01:00:00,561,436,1193,472,1665,2101,2016-07-15 01:00:00,561,98653,98182
"1051",13466,2016-07-15 02:00:00,561,261,261,0,0,0,2016-07-15 02:00:00,561,379,845,326,1171,1550,2016-07-15 02:00:00,561,93898,93453
"1052",13467,2016-07-15 03:00:00,561,212,212,0,0,0,2016-07-15 03:00:00,561,242,722,253,975,1217,2016-07-15 03:00:00,561,86675,86252
"1053",13468,2016-07-15 04:00:00,561,215,215,0,0,0,2016-07-15 04:00:00,561,216,565,209,774,990,2016-07-15 04:00:00,561,80089,79737
"1054",13469,2016-07-15 05:00:00,561,174,174,0,0,0,2016-07-15 05:00:00,561,116,273,96,369,485,2016-07-15 05:00:00,561,77286,76925
"1055",13470,2016-07-15 06:00:00,561,142,142,0,0,0,2016-07-15 06:00:00,561,92,134,61,195,287,2016-07-15 06:00:00,561,83221,82840
"1056",13471,2016-07-15 07:00:00,561,124,124,0,0,0,2016-07-15 07:00:00,561,67,66,26,92,159,2016-07-15 07:00:00,561,86490,86073
"1057",13472,2016-07-15 08:00:00,561,122,122,0,0,0,2016-07-15 08:00:00,561,49,48,19,67,116,2016-07-15 08:00:00,561,87495,87032
"1058",13473,2016-07-15 09:00:00,561,117,117,0,0,0,2016-07-15 09:00:00,561,63,46,19,65,128,2016-07-15 09:00:00,561,89079,88575
"1059",13474,2016-07-15 10:00:00,561,82,82,0,0,0,2016-07-15 10:00:00,561,45,62,35,97,142,2016-07-15 10:00:00,561,94019,93553
"1060",13475,2016-07-15 11:00:00,561,136,136,0,0,0,2016-07-15 11:00:00,561,123,136,78,214,337,2016-07-15 11:00:00,561,121160,120711
"1061",13476,2016-07-15 12:00:00,561,142,142,0,0,0,2016-07-15 12:00:00,561,243,243,129,372,615,2016-07-15 12:00:00,561,164770,164133
"1062",13477,2016-07-15 13:00:00,561,159,159,0,0,0,2016-07-15 13:00:00,561,489,522,273,795,1284,2016-07-15 13:00:00,561,188863,188160
"1063",13478,2016-07-15 14:00:00,561,300,300,0,0,0,2016-07-15 14:00:00,561,634,705,342,1047,1681,2016-07-15 14:00:00,561,191166,190392
"1064",13479,2016-07-15 15:00:00,561,264,264,0,0,0,2016-07-15 15:00:00,561,720,806,382,1188,1908,2016-07-15 15:00:00,561,185699,184819
"1065",13480,2016-07-15 16:00:00,561,334,334,0,0,0,2016-07-15 16:00:00,561,805,960,487,1447,2252,2016-07-15 16:00:00,561,167184,166447
"1066",13481,2016-07-15 17:00:00,561,305,305,0,0,0,2016-07-15 17:00:00,561,761,1012,473,1485,2246,2016-07-15 17:00:00,561,160488,159737
"1067",13482,2016-07-15 18:00:00,561,386,386,0,0,0,2016-07-15 18:00:00,561,864,1096,483,1579,2443,2016-07-15 18:00:00,561,158219,157435
"1068",13483,2016-07-15 19:00:00,561,277,277,0,0,0,2016-07-15 19:00:00,561,855,1110,493,1603,2458,2016-07-15 19:00:00,561,150610,149879
"1069",13484,2016-07-15 20:00:00,561,299,299,0,0,0,2016-07-15 20:00:00,561,798,1266,530,1796,2594,2016-07-15 20:00:00,561,138155,137521
"1070",13485,2016-07-15 21:00:00,561,291,291,0,0,0,2016-07-15 21:00:00,561,665,1300,566,1866,2531,2016-07-15 21:00:00,561,115058,114490
"1071",13486,2016-07-15 22:00:00,561,259,259,0,0,0,2016-07-15 22:00:00,561,635,1190,485,1675,2310,2016-07-15 22:00:00,561,96481,96029
"1072",13487,2016-07-15 23:00:00,561,245,245,0,0,0,2016-07-15 23:00:00,561,540,1141,439,1580,2120,2016-07-15 23:00:00,561,84175,83766
"1073",13488,2016-07-16 00:00:00,562,250,250,0,0,0,2016-07-16 00:00:00,562,485,1181,455,1636,2121,2016-07-16 00:00:00,562,78157,77792
"1074",13489,2016-07-16 01:00:00,562,236,236,0,0,0,2016-07-16 01:00:00,562,396,1052,413,1465,1861,2016-07-16 01:00:00,562,77001,76636
"1075",13490,2016-07-16 02:00:00,562,228,228,0,0,0,2016-07-16 02:00:00,562,286,963,365,1328,1614,2016-07-16 02:00:00,562,76196,75816
"1076",13491,2016-07-16 03:00:00,562,195,195,0,0,0,2016-07-16 03:00:00,562,213,799,322,1121,1334,2016-07-16 03:00:00,562,72370,72017
"1077",13492,2016-07-16 04:00:00,562,184,184,0,0,0,2016-07-16 04:00:00,562,222,579,217,796,1018,2016-07-16 04:00:00,562,68257,67896
"1078",13493,2016-07-16 05:00:00,562,133,133,0,0,0,2016-07-16 05:00:00,562,159,287,115,402,561,2016-07-16 05:00:00,562,63847,63505
"1079",13494,2016-07-16 06:00:00,562,117,117,0,0,0,2016-07-16 06:00:00,562,85,168,66,234,319,2016-07-16 06:00:00,562,61116,60779
"1080",13495,2016-07-16 07:00:00,562,117,117,0,0,0,2016-07-16 07:00:00,562,88,96,42,138,226,2016-07-16 07:00:00,562,61194,60863
"1081",13496,2016-07-16 08:00:00,562,127,127,0,0,0,2016-07-16 08:00:00,562,53,65,29,94,147,2016-07-16 08:00:00,562,59723,59446
"1082",13497,2016-07-16 09:00:00,562,110,110,0,0,0,2016-07-16 09:00:00,562,35,42,22,64,99,2016-07-16 09:00:00,562,60575,60226
"1083",13498,2016-07-16 10:00:00,562,113,113,0,0,0,2016-07-16 10:00:00,562,71,58,28,86,157,2016-07-16 10:00:00,562,64801,64493
"1084",13499,2016-07-16 11:00:00,562,118,118,0,0,0,2016-07-16 11:00:00,562,109,127,66,193,302,2016-07-16 11:00:00,562,73403,73045
"1085",13500,2016-07-16 12:00:00,562,150,150,0,0,0,2016-07-16 12:00:00,562,171,225,110,335,506,2016-07-16 12:00:00,562,84247,83883
"1086",13501,2016-07-16 13:00:00,562,178,178,0,0,0,2016-07-16 13:00:00,562,247,491,244,735,982,2016-07-16 13:00:00,562,93860,93423
"1087",13502,2016-07-16 14:00:00,562,205,205,0,0,0,2016-07-16 14:00:00,562,449,638,314,952,1401,2016-07-16 14:00:00,562,100347,99845
"1088",13503,2016-07-16 15:00:00,562,236,236,0,0,0,2016-07-16 15:00:00,562,556,785,372,1157,1713,2016-07-16 15:00:00,562,102782,102269
"1089",13504,2016-07-16 16:00:00,562,310,310,0,0,0,2016-07-16 16:00:00,562,538,940,440,1380,1918,2016-07-16 16:00:00,562,102315,101798
"1090",13505,2016-07-16 17:00:00,562,249,249,0,0,0,2016-07-16 17:00:00,562,593,984,417,1401,1994,2016-07-16 17:00:00,562,100562,100026
"1091",13506,2016-07-16 18:00:00,562,288,288,0,0,0,2016-07-16 18:00:00,562,500,1053,461,1514,2014,2016-07-16 18:00:00,562,96872,96314
"1092",13507,2016-07-16 19:00:00,562,196,196,0,0,0,2016-07-16 19:00:00,562,590,1290,529,1819,2409,2016-07-16 19:00:00,562,94142,93634
"1093",13508,2016-07-16 20:00:00,562,242,242,0,0,0,2016-07-16 20:00:00,562,553,1343,510,1853,2406,2016-07-16 20:00:00,562,89363,88896
"1094",13509,2016-07-16 21:00:00,562,229,229,0,0,0,2016-07-16 21:00:00,562,496,1219,549,1768,2264,2016-07-16 21:00:00,562,81726,81295
"1095",13510,2016-07-16 22:00:00,562,251,251,0,0,0,2016-07-16 22:00:00,562,465,1202,492,1694,2159,2016-07-16 22:00:00,562,75008,74597
"1096",13511,2016-07-16 23:00:00,562,204,204,0,0,0,2016-07-16 23:00:00,562,410,1013,371,1384,1794,2016-07-16 23:00:00,562,70677,70287
"1097",13512,2016-07-17 00:00:00,563,220,220,0,0,0,2016-07-17 00:00:00,563,398,1062,441,1503,1901,2016-07-17 00:00:00,563,68399,68043
"1098",13513,2016-07-17 01:00:00,563,232,232,0,0,0,2016-07-17 01:00:00,563,334,936,406,1342,1676,2016-07-17 01:00:00,563,69056,68712
"1099",13514,2016-07-17 02:00:00,563,213,213,0,0,0,2016-07-17 02:00:00,563,226,842,329,1171,1397,2016-07-17 02:00:00,563,68781,68397
"1100",13515,2016-07-17 03:00:00,563,185,185,0,0,0,2016-07-17 03:00:00,563,184,640,263,903,1087,2016-07-17 03:00:00,563,68070,67738
"1101",13516,2016-07-17 04:00:00,563,151,151,0,0,0,2016-07-17 04:00:00,563,148,500,216,716,864,2016-07-17 04:00:00,563,66397,66074
"1102",13517,2016-07-17 05:00:00,563,88,88,0,0,0,2016-07-17 05:00:00,563,109,275,113,388,497,2016-07-17 05:00:00,563,61943,61619
"1103",13518,2016-07-17 06:00:00,563,89,89,0,0,0,2016-07-17 06:00:00,563,66,158,44,202,268,2016-07-17 06:00:00,563,60033,59723
"1104",13519,2016-07-17 07:00:00,563,131,131,0,0,0,2016-07-17 07:00:00,563,50,103,34,137,187,2016-07-17 07:00:00,563,59886,59573
"1105",13520,2016-07-17 08:00:00,563,143,143,0,0,0,2016-07-17 08:00:00,563,57,60,20,80,137,2016-07-17 08:00:00,563,59254,58909
"1106",13521,2016-07-17 09:00:00,563,105,105,0,0,0,2016-07-17 09:00:00,563,39,39,15,54,93,2016-07-17 09:00:00,563,59559,59225
"1107",13522,2016-07-17 10:00:00,563,115,115,0,0,0,2016-07-17 10:00:00,563,53,50,23,73,126,2016-07-17 10:00:00,563,62140,61820
"1108",13523,2016-07-17 11:00:00,563,110,110,0,0,0,2016-07-17 11:00:00,563,79,79,32,111,190,2016-07-17 11:00:00,563,68743,68396
"1109",13524,2016-07-17 12:00:00,563,131,131,0,0,0,2016-07-17 12:00:00,563,157,168,84,252,409,2016-07-17 12:00:00,563,76059,75682
"1110",13525,2016-07-17 13:00:00,563,172,172,0,0,0,2016-07-17 13:00:00,563,272,338,148,486,758,2016-07-17 13:00:00,563,85501,85092
"1111",13526,2016-07-17 14:00:00,563,255,255,0,0,0,2016-07-17 14:00:00,563,340,505,225,730,1070,2016-07-17 14:00:00,563,92720,92258
"1112",13527,2016-07-17 15:00:00,563,226,226,0,0,0,2016-07-17 15:00:00,563,329,641,260,901,1230,2016-07-17 15:00:00,563,96129,95644
"1113",13528,2016-07-17 16:00:00,563,300,300,0,0,0,2016-07-17 16:00:00,563,400,767,323,1090,1490,2016-07-17 16:00:00,563,96452,95930
"1114",13529,2016-07-17 17:00:00,563,279,279,0,0,0,2016-07-17 17:00:00,563,455,891,352,1243,1698,2016-07-17 17:00:00,563,95762,95273
"1115",13530,2016-07-17 18:00:00,563,274,274,0,0,0,2016-07-17 18:00:00,563,525,954,369,1323,1848,2016-07-17 18:00:00,563,96215,95674
"1116",13531,2016-07-17 19:00:00,563,249,249,0,0,0,2016-07-17 19:00:00,563,490,1075,386,1461,1951,2016-07-17 19:00:00,563,94994,94444
"1117",13532,2016-07-17 20:00:00,563,196,196,0,0,0,2016-07-17 20:00:00,563,484,1137,463,1600,2084,2016-07-17 20:00:00,563,90380,89886
"1118",13533,2016-07-17 21:00:00,563,249,249,0,0,0,2016-07-17 21:00:00,563,478,1173,455,1628,2106,2016-07-17 21:00:00,563,85477,84989
"1119",13534,2016-07-17 22:00:00,563,251,251,0,0,0,2016-07-17 22:00:00,563,509,1189,469,1658,2167,2016-07-17 22:00:00,563,80467,80036
"1120",13535,2016-07-17 23:00:00,563,198,198,0,0,0,2016-07-17 23:00:00,563,388,1003,378,1381,1769,2016-07-17 23:00:00,563,81109,80676
"1121",13536,2016-07-18 00:00:00,564,242,242,0,0,0,2016-07-18 00:00:00,564,341,1088,409,1497,1838,2016-07-18 00:00:00,564,89151,88728
"1122",13537,2016-07-18 01:00:00,564,248,248,0,0,0,2016-07-18 01:00:00,564,293,979,360,1339,1632,2016-07-18 01:00:00,564,95610,95179
"1123",13538,2016-07-18 02:00:00,564,218,218,0,0,0,2016-07-18 02:00:00,564,293,785,281,1066,1359,2016-07-18 02:00:00,564,91001,90524
"1124",13539,2016-07-18 03:00:00,564,236,236,0,0,0,2016-07-18 03:00:00,564,226,624,248,872,1098,2016-07-18 03:00:00,564,86623,86206
"1125",13540,2016-07-18 04:00:00,564,212,212,0,0,0,2016-07-18 04:00:00,564,161,435,173,608,769,2016-07-18 04:00:00,564,84442,84057
"1126",13541,2016-07-18 05:00:00,564,180,180,0,0,0,2016-07-18 05:00:00,564,89,218,73,291,380,2016-07-18 05:00:00,564,85077,84707
"1127",13542,2016-07-18 06:00:00,564,175,175,0,0,0,2016-07-18 06:00:00,564,80,110,38,148,228,2016-07-18 06:00:00,564,92434,92012
"1128",13543,2016-07-18 07:00:00,564,153,153,0,0,0,2016-07-18 07:00:00,564,55,52,23,75,130,2016-07-18 07:00:00,564,100847,100302
"1129",13544,2016-07-18 08:00:00,564,148,148,0,0,0,2016-07-18 08:00:00,564,34,33,15,48,82,2016-07-18 08:00:00,564,106113,105562
"1130",13545,2016-07-18 09:00:00,564,134,134,0,0,0,2016-07-18 09:00:00,564,47,25,11,36,83,2016-07-18 09:00:00,564,99762,99209
"1131",13546,2016-07-18 10:00:00,564,139,139,0,0,0,2016-07-18 10:00:00,564,62,54,25,79,141,2016-07-18 10:00:00,564,110895,110382
"1132",13547,2016-07-18 11:00:00,564,124,124,0,0,0,2016-07-18 11:00:00,564,97,81,43,124,221,2016-07-18 11:00:00,564,159444,158894
"1133",13548,2016-07-18 12:00:00,564,149,149,0,0,0,2016-07-18 12:00:00,564,264,205,100,305,569,2016-07-18 12:00:00,564,231861,231216
"1134",13549,2016-07-18 13:00:00,564,204,204,0,0,0,2016-07-18 13:00:00,564,554,518,265,783,1337,2016-07-18 13:00:00,564,255717,254830
"1135",13550,2016-07-18 14:00:00,564,315,315,0,0,0,2016-07-18 14:00:00,564,661,635,314,949,1610,2016-07-18 14:00:00,564,235931,235044
"1136",13551,2016-07-18 15:00:00,564,242,242,0,0,0,2016-07-18 15:00:00,564,780,899,447,1346,2126,2016-07-18 15:00:00,564,226995,226077
"1137",13552,2016-07-18 16:00:00,564,402,402,0,0,0,2016-07-18 16:00:00,564,861,1078,511,1589,2450,2016-07-18 16:00:00,564,202799,201967
"1138",13553,2016-07-18 17:00:00,564,394,394,0,0,0,2016-07-18 17:00:00,564,882,1143,511,1654,2536,2016-07-18 17:00:00,564,189254,188387
"1139",13554,2016-07-18 18:00:00,564,390,390,0,0,0,2016-07-18 18:00:00,564,937,1163,522,1685,2622,2016-07-18 18:00:00,564,186141,185276
"1140",13555,2016-07-18 19:00:00,564,411,411,0,0,0,2016-07-18 19:00:00,564,874,1224,536,1760,2634,2016-07-18 19:00:00,564,177575,176739
"1141",13556,2016-07-18 20:00:00,564,362,362,0,0,0,2016-07-18 20:00:00,564,959,1579,630,2209,3168,2016-07-18 20:00:00,564,164358,163538
"1142",13557,2016-07-18 21:00:00,564,328,328,0,0,0,2016-07-18 21:00:00,564,815,1712,648,2360,3175,2016-07-18 21:00:00,564,140039,139397
"1143",13558,2016-07-18 22:00:00,564,352,352,0,0,0,2016-07-18 22:00:00,564,728,1651,609,2260,2988,2016-07-18 22:00:00,564,115471,114927
"1144",13559,2016-07-18 23:00:00,564,370,370,0,0,0,2016-07-18 23:00:00,564,656,1413,581,1994,2650,2016-07-18 23:00:00,564,103781,103320
"1145",13560,2016-07-19 00:00:00,565,281,281,0,0,0,2016-07-19 00:00:00,565,617,1290,531,1821,2438,2016-07-19 00:00:00,565,99014,98574
"1146",13561,2016-07-19 01:00:00,565,241,241,0,0,0,2016-07-19 01:00:00,565,485,1034,370,1404,1889,2016-07-19 01:00:00,565,100004,99520
"1147",13562,2016-07-19 02:00:00,565,239,239,0,0,0,2016-07-19 02:00:00,565,383,826,316,1142,1525,2016-07-19 02:00:00,565,93572,93098
"1148",13563,2016-07-19 03:00:00,565,232,232,0,0,0,2016-07-19 03:00:00,565,265,698,251,949,1214,2016-07-19 03:00:00,565,86964,86569
"1149",13564,2016-07-19 04:00:00,565,202,202,0,0,0,2016-07-19 04:00:00,565,182,507,193,700,882,2016-07-19 04:00:00,565,80840,80478
"1150",13565,2016-07-19 05:00:00,565,182,182,0,0,0,2016-07-19 05:00:00,565,130,264,98,362,492,2016-07-19 05:00:00,565,80866,80474
"1151",13566,2016-07-19 06:00:00,565,116,116,0,0,0,2016-07-19 06:00:00,565,85,124,50,174,259,2016-07-19 06:00:00,565,86982,86559
"1152",13567,2016-07-19 07:00:00,565,188,188,0,0,0,2016-07-19 07:00:00,565,69,77,30,107,176,2016-07-19 07:00:00,565,91820,91340
"1153",13568,2016-07-19 08:00:00,565,128,128,0,0,0,2016-07-19 08:00:00,565,54,48,18,66,120,2016-07-19 08:00:00,565,92334,91819
"1154",13569,2016-07-19 09:00:00,565,146,146,0,0,0,2016-07-19 09:00:00,565,55,41,23,64,119,2016-07-19 09:00:00,565,93408,92881
"1155",13570,2016-07-19 10:00:00,565,138,138,0,0,0,2016-07-19 10:00:00,565,73,39,23,62,135,2016-07-19 10:00:00,565,97561,97068
"1156",13571,2016-07-19 11:00:00,565,113,113,0,0,0,2016-07-19 11:00:00,565,149,121,63,184,333,2016-07-19 11:00:00,565,122064,121526
"1157",13572,2016-07-19 12:00:00,565,188,188,0,0,0,2016-07-19 12:00:00,565,281,242,129,371,652,2016-07-19 12:00:00,565,163985,163359
"1158",13573,2016-07-19 13:00:00,565,272,272,0,0,0,2016-07-19 13:00:00,565,465,503,252,755,1220,2016-07-19 13:00:00,565,191383,190576
"1159",13574,2016-07-19 14:00:00,565,404,404,0,0,0,2016-07-19 14:00:00,565,624,651,323,974,1598,2016-07-19 14:00:00,565,198646,197733
"1160",13575,2016-07-19 15:00:00,565,394,394,0,0,0,2016-07-19 15:00:00,565,704,787,362,1149,1853,2016-07-19 15:00:00,565,204119,203225
"1161",13576,2016-07-19 16:00:00,565,440,440,0,0,0,2016-07-19 16:00:00,565,781,912,426,1338,2119,2016-07-19 16:00:00,565,176107,175279
"1162",13577,2016-07-19 17:00:00,565,415,415,0,0,0,2016-07-19 17:00:00,565,845,927,448,1375,2220,2016-07-19 17:00:00,565,172547,171741
"1163",13578,2016-07-19 18:00:00,565,417,417,0,0,0,2016-07-19 18:00:00,565,829,1118,493,1611,2440,2016-07-19 18:00:00,565,171786,170923
"1164",13579,2016-07-19 19:00:00,565,370,370,0,0,0,2016-07-19 19:00:00,565,837,1159,502,1661,2498,2016-07-19 19:00:00,565,165829,164990
"1165",13580,2016-07-19 20:00:00,565,424,424,0,0,0,2016-07-19 20:00:00,565,828,1174,505,1679,2507,2016-07-19 20:00:00,565,156070,155330
"1166",13581,2016-07-19 21:00:00,565,370,370,0,0,0,2016-07-19 21:00:00,565,755,1280,544,1824,2579,2016-07-19 21:00:00,565,131719,131086
"1167",13582,2016-07-19 22:00:00,565,352,352,0,0,0,2016-07-19 22:00:00,565,660,1248,512,1760,2420,2016-07-19 22:00:00,565,110108,109595
"1168",13583,2016-07-19 23:00:00,565,364,364,0,0,0,2016-07-19 23:00:00,565,576,1210,482,1692,2268,2016-07-19 23:00:00,565,98964,98469
"1169",13584,2016-07-20 00:00:00,566,303,303,0,0,0,2016-07-20 00:00:00,566,532,993,414,1407,1939,2016-07-20 00:00:00,566,94693,94218
"1170",13585,2016-07-20 01:00:00,566,272,272,0,0,0,2016-07-20 01:00:00,566,432,961,406,1367,1799,2016-07-20 01:00:00,566,96070,95619
"1171",13586,2016-07-20 02:00:00,566,202,202,0,0,0,2016-07-20 02:00:00,566,338,848,344,1192,1530,2016-07-20 02:00:00,566,92821,92354
"1172",13587,2016-07-20 03:00:00,566,191,191,0,0,0,2016-07-20 03:00:00,566,262,724,279,1003,1265,2016-07-20 03:00:00,566,86817,86383
"1173",13588,2016-07-20 04:00:00,566,194,194,0,0,0,2016-07-20 04:00:00,566,217,466,177,643,860,2016-07-20 04:00:00,566,81528,81139
"1174",13589,2016-07-20 05:00:00,566,153,153,0,0,0,2016-07-20 05:00:00,566,120,221,88,309,429,2016-07-20 05:00:00,566,80781,80418
"1175",13590,2016-07-20 06:00:00,566,157,157,0,0,0,2016-07-20 06:00:00,566,85,93,33,126,211,2016-07-20 06:00:00,566,89706,89236
"1176",13591,2016-07-20 07:00:00,566,160,160,0,0,0,2016-07-20 07:00:00,566,65,79,24,103,168,2016-07-20 07:00:00,566,92975,92486
"1177",13592,2016-07-20 08:00:00,566,158,158,0,0,0,2016-07-20 08:00:00,566,68,39,14,53,121,2016-07-20 08:00:00,566,92398,91960
"1178",13593,2016-07-20 09:00:00,566,139,139,0,0,0,2016-07-20 09:00:00,566,59,27,14,41,100,2016-07-20 09:00:00,566,91882,91353
"1179",13594,2016-07-20 10:00:00,566,144,144,0,0,0,2016-07-20 10:00:00,566,73,42,21,63,136,2016-07-20 10:00:00,566,96552,96044
"1180",13595,2016-07-20 11:00:00,566,169,169,0,0,0,2016-07-20 11:00:00,566,162,109,54,163,325,2016-07-20 11:00:00,566,113298,112785
"1181",13596,2016-07-20 12:00:00,566,221,221,0,0,0,2016-07-20 12:00:00,566,329,267,124,391,720,2016-07-20 12:00:00,566,146131,145490
"1182",13597,2016-07-20 13:00:00,566,267,267,0,0,0,2016-07-20 13:00:00,566,519,478,252,730,1249,2016-07-20 13:00:00,566,174152,173356
"1183",13598,2016-07-20 14:00:00,566,398,398,0,0,0,2016-07-20 14:00:00,566,638,564,299,863,1501,2016-07-20 14:00:00,566,184830,183928
"1184",13599,2016-07-20 15:00:00,566,331,331,0,0,0,2016-07-20 15:00:00,566,706,689,298,987,1693,2016-07-20 15:00:00,566,183384,182473
"1185",13600,2016-07-20 16:00:00,566,378,378,0,0,0,2016-07-20 16:00:00,566,700,769,375,1144,1844,2016-07-20 16:00:00,566,168701,167837
"1186",13601,2016-07-20 17:00:00,566,352,352,0,0,0,2016-07-20 17:00:00,566,790,904,420,1324,2114,2016-07-20 17:00:00,566,164243,163395
"1187",13602,2016-07-20 18:00:00,566,372,372,0,0,0,2016-07-20 18:00:00,566,839,1028,458,1486,2325,2016-07-20 18:00:00,566,164724,163910
"1188",13603,2016-07-20 19:00:00,566,382,382,0,0,0,2016-07-20 19:00:00,566,894,1093,500,1593,2487,2016-07-20 19:00:00,566,160312,159486
"1189",13604,2016-07-20 20:00:00,566,349,349,0,0,0,2016-07-20 20:00:00,566,853,1292,564,1856,2709,2016-07-20 20:00:00,566,151256,150508
"1190",13605,2016-07-20 21:00:00,566,324,324,0,0,0,2016-07-20 21:00:00,566,802,1220,487,1707,2509,2016-07-20 21:00:00,566,129588,128929
"1191",13606,2016-07-20 22:00:00,566,322,322,0,0,0,2016-07-20 22:00:00,566,693,1268,534,1802,2495,2016-07-20 22:00:00,566,108496,107974
"1192",13607,2016-07-20 23:00:00,566,327,327,0,0,0,2016-07-20 23:00:00,566,689,1366,559,1925,2614,2016-07-20 23:00:00,566,99090,98616
"1193",13608,2016-07-21 00:00:00,567,306,306,0,0,0,2016-07-21 00:00:00,567,604,1188,488,1676,2280,2016-07-21 00:00:00,567,96428,95992
"1194",13609,2016-07-21 01:00:00,567,248,248,0,0,0,2016-07-21 01:00:00,567,458,1010,380,1390,1848,2016-07-21 01:00:00,567,98918,98490
"1195",13610,2016-07-21 02:00:00,567,211,211,0,0,0,2016-07-21 02:00:00,567,371,806,309,1115,1486,2016-07-21 02:00:00,567,93826,93367
"1196",13611,2016-07-21 03:00:00,567,217,217,0,0,0,2016-07-21 03:00:00,567,275,587,255,842,1117,2016-07-21 03:00:00,567,87554,87132
"1197",13612,2016-07-21 04:00:00,567,207,207,0,0,0,2016-07-21 04:00:00,567,189,477,195,672,861,2016-07-21 04:00:00,567,84116,83697
"1198",13613,2016-07-21 05:00:00,567,130,130,0,0,0,2016-07-21 05:00:00,567,131,207,78,285,416,2016-07-21 05:00:00,567,82128,81718
"1199",13614,2016-07-21 06:00:00,567,133,133,0,0,0,2016-07-21 06:00:00,567,86,123,44,167,253,2016-07-21 06:00:00,567,90274,89843
"1200",13615,2016-07-21 07:00:00,567,170,170,0,0,0,2016-07-21 07:00:00,567,68,69,17,86,154,2016-07-21 07:00:00,567,94274,93800
"1201",13616,2016-07-21 08:00:00,567,175,175,0,0,0,2016-07-21 08:00:00,567,41,42,21,63,104,2016-07-21 08:00:00,567,96044,95538
"1202",13617,2016-07-21 09:00:00,567,155,155,0,0,0,2016-07-21 09:00:00,567,73,43,19,62,135,2016-07-21 09:00:00,567,96201,95686
"1203",13618,2016-07-21 10:00:00,567,161,161,0,0,0,2016-07-21 10:00:00,567,72,55,29,84,156,2016-07-21 10:00:00,567,99829,99371
"1204",13619,2016-07-21 11:00:00,567,157,157,0,0,0,2016-07-21 11:00:00,567,141,102,53,155,296,2016-07-21 11:00:00,567,124934,124431
"1205",13620,2016-07-21 12:00:00,567,188,188,0,0,0,2016-07-21 12:00:00,567,319,232,125,357,676,2016-07-21 12:00:00,567,171028,170398
"1206",13621,2016-07-21 13:00:00,567,273,273,0,0,0,2016-07-21 13:00:00,567,485,483,255,738,1223,2016-07-21 13:00:00,567,200967,200131
"1207",13622,2016-07-21 14:00:00,567,374,374,0,0,0,2016-07-21 14:00:00,567,652,570,276,846,1498,2016-07-21 14:00:00,567,205425,204498
"1208",13623,2016-07-21 15:00:00,567,312,312,0,0,0,2016-07-21 15:00:00,567,757,759,416,1175,1932,2016-07-21 15:00:00,567,203410,202485
"1209",13624,2016-07-21 16:00:00,567,378,378,0,0,0,2016-07-21 16:00:00,567,756,853,405,1258,2014,2016-07-21 16:00:00,567,185266,184394
"1210",13625,2016-07-21 17:00:00,567,411,411,0,0,0,2016-07-21 17:00:00,567,805,992,449,1441,2246,2016-07-21 17:00:00,567,180277,179474
"1211",13626,2016-07-21 18:00:00,567,348,348,0,0,0,2016-07-21 18:00:00,567,878,1074,429,1503,2381,2016-07-21 18:00:00,567,179119,178184
"1212",13627,2016-07-21 19:00:00,567,340,340,0,0,0,2016-07-21 19:00:00,567,873,1095,510,1605,2478,2016-07-21 19:00:00,567,171678,170853
"1213",13628,2016-07-21 20:00:00,567,363,363,0,0,0,2016-07-21 20:00:00,567,810,1215,544,1759,2569,2016-07-21 20:00:00,567,161253,160483
"1214",13629,2016-07-21 21:00:00,567,333,333,0,0,0,2016-07-21 21:00:00,567,756,1207,544,1751,2507,2016-07-21 21:00:00,567,135860,135261
"1215",13630,2016-07-21 22:00:00,567,333,333,0,0,0,2016-07-21 22:00:00,567,687,1307,579,1886,2573,2016-07-21 22:00:00,567,113407,112859
"1216",13631,2016-07-21 23:00:00,567,331,331,0,0,0,2016-07-21 23:00:00,567,596,1219,476,1695,2291,2016-07-21 23:00:00,567,102324,101826
"1217",13632,2016-07-22 00:00:00,568,320,320,0,0,0,2016-07-22 00:00:00,568,563,1136,472,1608,2171,2016-07-22 00:00:00,568,96620,96154
"1218",13633,2016-07-22 01:00:00,568,256,256,0,0,0,2016-07-22 01:00:00,568,428,1016,371,1387,1815,2016-07-22 01:00:00,568,97109,96621
"1219",13634,2016-07-22 02:00:00,568,227,227,0,0,0,2016-07-22 02:00:00,568,339,771,304,1075,1414,2016-07-22 02:00:00,568,88776,88310
"1220",13635,2016-07-22 03:00:00,568,206,206,0,0,0,2016-07-22 03:00:00,568,246,680,258,938,1184,2016-07-22 03:00:00,568,83239,82814
"1221",13636,2016-07-22 04:00:00,568,211,211,0,0,0,2016-07-22 04:00:00,568,196,539,203,742,938,2016-07-22 04:00:00,568,77741,77350
"1222",13637,2016-07-22 05:00:00,568,187,187,0,0,0,2016-07-22 05:00:00,568,162,275,98,373,535,2016-07-22 05:00:00,568,75970,75568
"1223",13638,2016-07-22 06:00:00,568,153,153,0,0,0,2016-07-22 06:00:00,568,98,119,44,163,261,2016-07-22 06:00:00,568,81763,81363
"1224",13639,2016-07-22 07:00:00,568,187,187,0,0,0,2016-07-22 07:00:00,568,78,71,29,100,178,2016-07-22 07:00:00,568,85632,85225
"1225",13640,2016-07-22 08:00:00,568,225,225,0,0,0,2016-07-22 08:00:00,568,59,54,25,79,138,2016-07-22 08:00:00,568,86247,85796
"1226",13641,2016-07-22 09:00:00,568,171,171,0,0,0,2016-07-22 09:00:00,568,49,35,10,45,94,2016-07-22 09:00:00,568,90234,89796
"1227",13642,2016-07-22 10:00:00,568,165,165,0,0,0,2016-07-22 10:00:00,568,60,52,21,73,133,2016-07-22 10:00:00,568,91261,90858
"1228",13643,2016-07-22 11:00:00,568,191,191,0,0,0,2016-07-22 11:00:00,568,156,119,63,182,338,2016-07-22 11:00:00,568,117624,117169
"1229",13644,2016-07-22 12:00:00,568,202,202,0,0,0,2016-07-22 12:00:00,568,293,230,135,365,658,2016-07-22 12:00:00,568,160171,159595
"1230",13645,2016-07-22 13:00:00,568,241,241,0,0,0,2016-07-22 13:00:00,568,472,474,241,715,1187,2016-07-22 13:00:00,568,183963,183205
"1231",13646,2016-07-22 14:00:00,568,337,337,0,0,0,2016-07-22 14:00:00,568,656,523,273,796,1452,2016-07-22 14:00:00,568,187260,186449
"1232",13647,2016-07-22 15:00:00,568,308,308,0,0,0,2016-07-22 15:00:00,568,770,728,374,1102,1872,2016-07-22 15:00:00,568,183654,182786
"1233",13648,2016-07-22 16:00:00,568,444,444,0,0,0,2016-07-22 16:00:00,568,748,870,405,1275,2023,2016-07-22 16:00:00,568,166239,165409
"1234",13649,2016-07-22 17:00:00,568,359,359,0,0,0,2016-07-22 17:00:00,568,788,989,448,1437,2225,2016-07-22 17:00:00,568,159493,158729
"1235",13650,2016-07-22 18:00:00,568,355,355,0,0,0,2016-07-22 18:00:00,568,882,1089,464,1553,2435,2016-07-22 18:00:00,568,157215,156431
"1236",13651,2016-07-22 19:00:00,568,304,304,0,0,0,2016-07-22 19:00:00,568,952,1128,488,1616,2568,2016-07-22 19:00:00,568,150039,149290
"1237",13652,2016-07-22 20:00:00,568,324,324,0,0,0,2016-07-22 20:00:00,568,901,1283,544,1827,2728,2016-07-22 20:00:00,568,138884,138224
"1238",13653,2016-07-22 21:00:00,568,290,290,0,0,0,2016-07-22 21:00:00,568,766,1306,564,1870,2636,2016-07-22 21:00:00,568,117201,116580
"1239",13654,2016-07-22 22:00:00,568,266,266,0,0,0,2016-07-22 22:00:00,568,629,1275,521,1796,2425,2016-07-22 22:00:00,568,96808,96345
"1240",13655,2016-07-22 23:00:00,568,282,282,0,0,0,2016-07-22 23:00:00,568,644,1220,502,1722,2366,2016-07-22 23:00:00,568,86779,86348
"1241",13656,2016-07-23 00:00:00,569,259,259,0,0,0,2016-07-23 00:00:00,569,552,1144,455,1599,2151,2016-07-23 00:00:00,569,78711,78350
"1242",13657,2016-07-23 01:00:00,569,245,245,0,0,0,2016-07-23 01:00:00,569,439,953,379,1332,1771,2016-07-23 01:00:00,569,77012,76628
"1243",13658,2016-07-23 02:00:00,569,248,248,0,0,0,2016-07-23 02:00:00,569,371,925,364,1289,1660,2016-07-23 02:00:00,569,74875,74460
"1244",13659,2016-07-23 03:00:00,569,215,215,0,0,0,2016-07-23 03:00:00,569,268,693,297,990,1258,2016-07-23 03:00:00,569,71522,71199
"1245",13660,2016-07-23 04:00:00,569,172,172,0,0,0,2016-07-23 04:00:00,569,184,508,187,695,879,2016-07-23 04:00:00,569,67972,67611
"1246",13661,2016-07-23 05:00:00,569,129,129,0,0,0,2016-07-23 05:00:00,569,139,316,117,433,572,2016-07-23 05:00:00,569,63928,63607
"1247",13662,2016-07-23 06:00:00,569,111,111,0,0,0,2016-07-23 06:00:00,569,118,172,67,239,357,2016-07-23 06:00:00,569,61744,61406
"1248",13663,2016-07-23 07:00:00,569,118,118,0,0,0,2016-07-23 07:00:00,569,67,110,41,151,218,2016-07-23 07:00:00,569,60432,60083
"1249",13664,2016-07-23 08:00:00,569,133,133,0,0,0,2016-07-23 08:00:00,569,47,53,20,73,120,2016-07-23 08:00:00,569,59124,58816
"1250",13665,2016-07-23 09:00:00,569,134,134,0,0,0,2016-07-23 09:00:00,569,47,28,14,42,89,2016-07-23 09:00:00,569,60030,59727
"1251",13666,2016-07-23 10:00:00,569,126,126,0,0,0,2016-07-23 10:00:00,569,77,66,30,96,173,2016-07-23 10:00:00,569,62847,62538
"1252",13667,2016-07-23 11:00:00,569,138,138,0,0,0,2016-07-23 11:00:00,569,110,82,37,119,229,2016-07-23 11:00:00,569,71990,71650
"1253",13668,2016-07-23 12:00:00,569,177,177,0,0,0,2016-07-23 12:00:00,569,219,218,119,337,556,2016-07-23 12:00:00,569,82597,82202
"1254",13669,2016-07-23 13:00:00,569,261,261,0,0,0,2016-07-23 13:00:00,569,420,458,232,690,1110,2016-07-23 13:00:00,569,92778,92369
"1255",13670,2016-07-23 14:00:00,569,301,301,0,0,0,2016-07-23 14:00:00,569,501,546,266,812,1313,2016-07-23 14:00:00,569,101174,100687
"1256",13671,2016-07-23 15:00:00,569,299,299,0,0,0,2016-07-23 15:00:00,569,549,756,357,1113,1662,2016-07-23 15:00:00,569,104417,103892
"1257",13672,2016-07-23 16:00:00,569,358,358,0,0,0,2016-07-23 16:00:00,569,568,909,428,1337,1905,2016-07-23 16:00:00,569,104723,104164
"1258",13673,2016-07-23 17:00:00,569,307,307,0,0,0,2016-07-23 17:00:00,569,621,969,420,1389,2010,2016-07-23 17:00:00,569,101669,101113
"1259",13674,2016-07-23 18:00:00,569,285,285,0,0,0,2016-07-23 18:00:00,569,666,978,465,1443,2109,2016-07-23 18:00:00,569,98285,97790
"1260",13675,2016-07-23 19:00:00,569,287,287,0,0,0,2016-07-23 19:00:00,569,716,1051,470,1521,2237,2016-07-23 19:00:00,569,95781,95224
"1261",13676,2016-07-23 20:00:00,569,309,309,0,0,0,2016-07-23 20:00:00,569,722,1097,436,1533,2255,2016-07-23 20:00:00,569,90776,90295
"1262",13677,2016-07-23 21:00:00,569,241,241,0,0,0,2016-07-23 21:00:00,569,611,1110,472,1582,2193,2016-07-23 21:00:00,569,83531,83065
"1263",13678,2016-07-23 22:00:00,569,206,206,0,0,0,2016-07-23 22:00:00,569,578,1076,457,1533,2111,2016-07-23 22:00:00,569,77169,76779
"1264",13679,2016-07-23 23:00:00,569,241,241,0,0,0,2016-07-23 23:00:00,569,497,1026,403,1429,1926,2016-07-23 23:00:00,569,72538,72119
"1265",13680,2016-07-24 00:00:00,570,256,256,0,0,0,2016-07-24 00:00:00,570,468,962,391,1353,1821,2016-07-24 00:00:00,570,70898,70496
"1266",13681,2016-07-24 01:00:00,570,182,182,0,0,0,2016-07-24 01:00:00,570,364,867,343,1210,1574,2016-07-24 01:00:00,570,70584,70207
"1267",13682,2016-07-24 02:00:00,570,246,246,0,0,0,2016-07-24 02:00:00,570,279,811,321,1132,1411,2016-07-24 02:00:00,570,69781,69445
"1268",13683,2016-07-24 03:00:00,570,195,195,0,0,0,2016-07-24 03:00:00,570,205,610,219,829,1034,2016-07-24 03:00:00,570,69185,68828
"1269",13684,2016-07-24 04:00:00,570,213,213,0,0,0,2016-07-24 04:00:00,570,159,585,214,799,958,2016-07-24 04:00:00,570,67660,67338
"1270",13685,2016-07-24 05:00:00,570,176,176,0,0,0,2016-07-24 05:00:00,570,154,272,108,380,534,2016-07-24 05:00:00,570,63115,62800
"1271",13686,2016-07-24 06:00:00,570,152,152,0,0,0,2016-07-24 06:00:00,570,76,149,60,209,285,2016-07-24 06:00:00,570,61452,61133
"1272",13687,2016-07-24 07:00:00,570,140,140,0,0,0,2016-07-24 07:00:00,570,73,107,35,142,215,2016-07-24 07:00:00,570,60515,60222
"1273",13688,2016-07-24 08:00:00,570,131,131,0,0,0,2016-07-24 08:00:00,570,69,66,31,97,166,2016-07-24 08:00:00,570,59567,59252
"1274",13689,2016-07-24 09:00:00,570,163,163,0,0,0,2016-07-24 09:00:00,570,48,45,16,61,109,2016-07-24 09:00:00,570,60807,60514
"1275",13690,2016-07-24 10:00:00,570,139,139,0,0,0,2016-07-24 10:00:00,570,64,42,16,58,122,2016-07-24 10:00:00,570,63637,63316
"1276",13691,2016-07-24 11:00:00,570,131,131,0,0,0,2016-07-24 11:00:00,570,97,82,37,119,216,2016-07-24 11:00:00,570,70545,70205
"1277",13692,2016-07-24 12:00:00,570,140,140,0,0,0,2016-07-24 12:00:00,570,178,167,95,262,440,2016-07-24 12:00:00,570,78153,77749
"1278",13693,2016-07-24 13:00:00,570,170,170,0,0,0,2016-07-24 13:00:00,570,249,290,141,431,680,2016-07-24 13:00:00,570,86604,86176
"1279",13694,2016-07-24 14:00:00,570,245,245,0,0,0,2016-07-24 14:00:00,570,412,464,232,696,1108,2016-07-24 14:00:00,570,94896,94436
"1280",13695,2016-07-24 15:00:00,570,200,200,0,0,0,2016-07-24 15:00:00,570,454,693,319,1012,1466,2016-07-24 15:00:00,570,99893,99389
"1281",13696,2016-07-24 16:00:00,570,243,243,0,0,0,2016-07-24 16:00:00,570,558,784,340,1124,1682,2016-07-24 16:00:00,570,100915,100404
"1282",13697,2016-07-24 17:00:00,570,281,281,0,0,0,2016-07-24 17:00:00,570,627,874,380,1254,1881,2016-07-24 17:00:00,570,100844,100310
"1283",13698,2016-07-24 18:00:00,570,231,231,0,0,0,2016-07-24 18:00:00,570,679,960,425,1385,2064,2016-07-24 18:00:00,570,101492,100934
"1284",13699,2016-07-24 19:00:00,570,215,215,0,0,0,2016-07-24 19:00:00,570,652,1012,417,1429,2081,2016-07-24 19:00:00,570,99556,98976
"1285",13700,2016-07-24 20:00:00,570,164,164,0,0,0,2016-07-24 20:00:00,570,685,1035,412,1447,2132,2016-07-24 20:00:00,570,96013,95476
"1286",13701,2016-07-24 21:00:00,570,215,215,0,0,0,2016-07-24 21:00:00,570,624,1072,429,1501,2125,2016-07-24 21:00:00,570,91009,90522
"1287",13702,2016-07-24 22:00:00,570,189,189,0,0,0,2016-07-24 22:00:00,570,543,1209,506,1715,2258,2016-07-24 22:00:00,570,85497,85009
"1288",13703,2016-07-24 23:00:00,570,209,209,0,0,0,2016-07-24 23:00:00,570,488,1118,462,1580,2068,2016-07-24 23:00:00,570,86171,85754
"1289",13704,2016-07-25 00:00:00,571,241,241,0,0,0,2016-07-25 00:00:00,571,449,1033,403,1436,1885,2016-07-25 00:00:00,571,93638,93204
"1290",13705,2016-07-25 01:00:00,571,210,210,0,0,0,2016-07-25 01:00:00,571,358,893,360,1253,1611,2016-07-25 01:00:00,571,101076,100587
"1291",13706,2016-07-25 02:00:00,571,164,164,0,0,0,2016-07-25 02:00:00,571,295,801,319,1120,1415,2016-07-25 02:00:00,571,94479,93999
"1292",13707,2016-07-25 03:00:00,571,159,159,0,0,0,2016-07-25 03:00:00,571,220,639,262,901,1121,2016-07-25 03:00:00,571,90454,90041
"1293",13708,2016-07-25 04:00:00,571,178,178,0,0,0,2016-07-25 04:00:00,571,144,438,176,614,758,2016-07-25 04:00:00,571,86414,86037
"1294",13709,2016-07-25 05:00:00,571,149,149,0,0,0,2016-07-25 05:00:00,571,127,248,95,343,470,2016-07-25 05:00:00,571,86297,85885
"1295",13710,2016-07-25 06:00:00,571,128,128,0,0,0,2016-07-25 06:00:00,571,72,119,50,169,241,2016-07-25 06:00:00,571,94187,93703
"1296",13711,2016-07-25 07:00:00,571,191,191,0,0,0,2016-07-25 07:00:00,571,70,68,35,103,173,2016-07-25 07:00:00,571,96696,96195
"1297",13712,2016-07-25 08:00:00,571,172,172,0,0,0,2016-07-25 08:00:00,571,47,61,27,88,135,2016-07-25 08:00:00,571,97659,97117
"1298",13713,2016-07-25 09:00:00,571,136,136,0,0,0,2016-07-25 09:00:00,571,47,34,14,48,95,2016-07-25 09:00:00,571,99680,99102
"1299",13714,2016-07-25 10:00:00,571,133,133,0,0,0,2016-07-25 10:00:00,571,73,51,22,73,146,2016-07-25 10:00:00,571,110883,110345
"1300",13715,2016-07-25 11:00:00,571,117,117,0,0,0,2016-07-25 11:00:00,571,157,86,52,138,295,2016-07-25 11:00:00,571,158111,157608
"1301",13716,2016-07-25 12:00:00,571,157,157,0,0,0,2016-07-25 12:00:00,571,348,248,140,388,736,2016-07-25 12:00:00,571,229141,228439
"1302",13717,2016-07-25 13:00:00,571,178,178,0,0,0,2016-07-25 13:00:00,571,633,456,250,706,1339,2016-07-25 13:00:00,571,253149,252281
"1303",13718,2016-07-25 14:00:00,571,295,295,0,0,0,2016-07-25 14:00:00,571,825,644,318,962,1787,2016-07-25 14:00:00,571,243089,242235
"1304",13719,2016-07-25 15:00:00,571,255,255,0,0,0,2016-07-25 15:00:00,571,990,935,431,1366,2356,2016-07-25 15:00:00,571,229627,228700
"1305",13720,2016-07-25 16:00:00,571,304,304,0,0,0,2016-07-25 16:00:00,571,994,1051,507,1558,2552,2016-07-25 16:00:00,571,202762,201831
"1306",13721,2016-07-25 17:00:00,571,298,298,0,0,0,2016-07-25 17:00:00,571,1061,1176,543,1719,2780,2016-07-25 17:00:00,571,191587,190764
"1307",13722,2016-07-25 18:00:00,571,316,316,0,0,0,2016-07-25 18:00:00,571,1182,1301,620,1921,3103,2016-07-25 18:00:00,571,190331,189467
"1308",13723,2016-07-25 19:00:00,571,280,280,0,0,0,2016-07-25 19:00:00,571,1089,1338,597,1935,3024,2016-07-25 19:00:00,571,182110,181219
"1309",13724,2016-07-25 20:00:00,571,339,339,0,0,0,2016-07-25 20:00:00,571,1102,1426,576,2002,3104,2016-07-25 20:00:00,571,170521,169716
"1310",13725,2016-07-25 21:00:00,571,346,346,0,0,0,2016-07-25 21:00:00,571,927,1626,701,2327,3254,2016-07-25 21:00:00,571,144597,143889
"1311",13726,2016-07-25 22:00:00,571,332,332,0,0,0,2016-07-25 22:00:00,571,866,1409,576,1985,2851,2016-07-25 22:00:00,571,120434,119820
"1312",13727,2016-07-25 23:00:00,571,343,343,0,0,0,2016-07-25 23:00:00,571,841,1374,571,1945,2786,2016-07-25 23:00:00,571,109711,109183
"1313",13728,2016-07-26 00:00:00,572,299,299,0,0,0,2016-07-26 00:00:00,572,730,1130,490,1620,2350,2016-07-26 00:00:00,572,107744,107218
"1314",13729,2016-07-26 01:00:00,572,289,289,0,0,0,2016-07-26 01:00:00,572,639,1191,479,1670,2309,2016-07-26 01:00:00,572,105652,105071
"1315",13730,2016-07-26 02:00:00,572,292,292,0,0,0,2016-07-26 02:00:00,572,441,839,317,1156,1597,2016-07-26 02:00:00,572,99106,98602
"1316",13731,2016-07-26 03:00:00,572,260,260,0,0,0,2016-07-26 03:00:00,572,305,747,289,1036,1341,2016-07-26 03:00:00,572,91779,91298
"1317",13732,2016-07-26 04:00:00,572,297,297,0,0,0,2016-07-26 04:00:00,572,319,524,194,718,1037,2016-07-26 04:00:00,572,85857,85451
"1318",13733,2016-07-26 05:00:00,572,178,178,0,0,0,2016-07-26 05:00:00,572,146,228,87,315,461,2016-07-26 05:00:00,572,84219,83813
"1319",13734,2016-07-26 06:00:00,572,163,163,0,0,0,2016-07-26 06:00:00,572,99,111,40,151,250,2016-07-26 06:00:00,572,90849,90396
"1320",13735,2016-07-26 07:00:00,572,182,182,0,0,0,2016-07-26 07:00:00,572,63,79,26,105,168,2016-07-26 07:00:00,572,95184,94668
"1321",13736,2016-07-26 08:00:00,572,175,175,0,0,0,2016-07-26 08:00:00,572,65,48,28,76,141,2016-07-26 08:00:00,572,95915,95360
"1322",13737,2016-07-26 09:00:00,572,179,179,0,0,0,2016-07-26 09:00:00,572,56,32,9,41,97,2016-07-26 09:00:00,572,98508,97991
"1323",13738,2016-07-26 10:00:00,572,145,145,0,0,0,2016-07-26 10:00:00,572,101,60,29,89,190,2016-07-26 10:00:00,572,102432,101951
"1324",13739,2016-07-26 11:00:00,572,157,157,0,0,0,2016-07-26 11:00:00,572,184,105,57,162,346,2016-07-26 11:00:00,572,126353,125808
"1325",13740,2016-07-26 12:00:00,572,224,224,0,0,0,2016-07-26 12:00:00,572,356,279,165,444,800,2016-07-26 12:00:00,572,169123,168397
"1326",13741,2016-07-26 13:00:00,572,310,310,0,0,0,2016-07-26 13:00:00,572,606,578,319,897,1503,2016-07-26 13:00:00,572,196936,196102
"1327",13742,2016-07-26 14:00:00,572,437,437,0,0,0,2016-07-26 14:00:00,572,805,659,341,1000,1805,2016-07-26 14:00:00,572,204334,203389
"1328",13743,2016-07-26 15:00:00,572,386,386,0,0,0,2016-07-26 15:00:00,572,977,843,452,1295,2272,2016-07-26 15:00:00,572,201647,200692
"1329",13744,2016-07-26 16:00:00,572,425,425,0,0,0,2016-07-26 16:00:00,572,1016,1031,522,1553,2569,2016-07-26 16:00:00,572,184181,183305
"1330",13745,2016-07-26 17:00:00,572,450,450,0,0,0,2016-07-26 17:00:00,572,1045,1202,562,1764,2809,2016-07-26 17:00:00,572,179470,178584
"1331",13746,2016-07-26 18:00:00,572,454,454,0,0,0,2016-07-26 18:00:00,572,1097,1112,487,1599,2696,2016-07-26 18:00:00,572,180498,179587
"1332",13747,2016-07-26 19:00:00,572,366,366,0,0,0,2016-07-26 19:00:00,572,1138,1229,578,1807,2945,2016-07-26 19:00:00,572,173982,173062
"1333",13748,2016-07-26 20:00:00,572,395,395,0,0,0,2016-07-26 20:00:00,572,1081,1338,632,1970,3051,2016-07-26 20:00:00,572,162917,162058
"1334",13749,2016-07-26 21:00:00,572,419,419,0,0,0,2016-07-26 21:00:00,572,1003,1347,610,1957,2960,2016-07-26 21:00:00,572,139701,139043
"1335",13750,2016-07-26 22:00:00,572,381,381,0,0,0,2016-07-26 22:00:00,572,850,1381,588,1969,2819,2016-07-26 22:00:00,572,116454,115874
"1336",13751,2016-07-26 23:00:00,572,408,408,0,0,0,2016-07-26 23:00:00,572,793,1308,585,1893,2686,2016-07-26 23:00:00,572,106275,105710
"1337",13752,2016-07-27 00:00:00,573,382,382,0,0,0,2016-07-27 00:00:00,573,628,1217,494,1711,2339,2016-07-27 00:00:00,573,101844,101316
"1338",13753,2016-07-27 01:00:00,573,300,300,0,0,0,2016-07-27 01:00:00,573,621,1040,424,1464,2085,2016-07-27 01:00:00,573,101856,101338
"1339",13754,2016-07-27 02:00:00,573,260,260,0,0,0,2016-07-27 02:00:00,573,483,873,335,1208,1691,2016-07-27 02:00:00,573,97001,96527
"1340",13755,2016-07-27 03:00:00,573,278,278,0,0,0,2016-07-27 03:00:00,573,381,694,291,985,1366,2016-07-27 03:00:00,573,91258,90793
"1341",13756,2016-07-27 04:00:00,573,223,223,0,0,0,2016-07-27 04:00:00,573,248,497,178,675,923,2016-07-27 04:00:00,573,85643,85215
"1342",13757,2016-07-27 05:00:00,573,190,190,0,0,0,2016-07-27 05:00:00,573,154,261,99,360,514,2016-07-27 05:00:00,573,83813,83372
"1343",13758,2016-07-27 06:00:00,573,141,141,0,0,0,2016-07-27 06:00:00,573,122,150,60,210,332,2016-07-27 06:00:00,573,89744,89260
"1344",13759,2016-07-27 07:00:00,573,189,189,0,0,0,2016-07-27 07:00:00,573,92,84,34,118,210,2016-07-27 07:00:00,573,93302,92813
"1345",13760,2016-07-27 08:00:00,573,168,168,0,0,0,2016-07-27 08:00:00,573,77,57,18,75,152,2016-07-27 08:00:00,573,94144,93590
"1346",13761,2016-07-27 09:00:00,573,164,164,0,0,0,2016-07-27 09:00:00,573,52,50,24,74,126,2016-07-27 09:00:00,573,95711,95154
"1347",13762,2016-07-27 10:00:00,573,191,191,0,0,0,2016-07-27 10:00:00,573,71,77,36,113,184,2016-07-27 10:00:00,573,97953,97459
"1348",13763,2016-07-27 11:00:00,573,223,223,0,0,0,2016-07-27 11:00:00,573,183,152,88,240,423,2016-07-27 11:00:00,573,116791,116218
"1349",13764,2016-07-27 12:00:00,573,238,238,0,0,0,2016-07-27 12:00:00,573,359,324,179,503,862,2016-07-27 12:00:00,573,150204,149557
"1350",13765,2016-07-27 13:00:00,573,377,377,0,0,0,2016-07-27 13:00:00,573,626,581,324,905,1531,2016-07-27 13:00:00,573,179492,178663
"1351",13766,2016-07-27 14:00:00,573,383,383,0,0,0,2016-07-27 14:00:00,573,826,697,370,1067,1893,2016-07-27 14:00:00,573,191786,190834
"1352",13767,2016-07-27 15:00:00,573,338,338,0,0,0,2016-07-27 15:00:00,573,833,849,426,1275,2108,2016-07-27 15:00:00,573,191050,190127
"1353",13768,2016-07-27 16:00:00,573,434,434,0,0,0,2016-07-27 16:00:00,573,997,962,462,1424,2421,2016-07-27 16:00:00,573,176020,175195
"1354",13769,2016-07-27 17:00:00,573,388,388,0,0,0,2016-07-27 17:00:00,573,1041,1111,544,1655,2696,2016-07-27 17:00:00,573,173965,173080
"1355",13770,2016-07-27 18:00:00,573,381,381,0,0,0,2016-07-27 18:00:00,573,1045,1032,467,1499,2544,2016-07-27 18:00:00,573,174569,173638
"1356",13771,2016-07-27 19:00:00,573,342,342,0,0,0,2016-07-27 19:00:00,573,1170,1124,528,1652,2822,2016-07-27 19:00:00,573,170324,169419
"1357",13772,2016-07-27 20:00:00,573,383,383,0,0,0,2016-07-27 20:00:00,573,1159,1218,536,1754,2913,2016-07-27 20:00:00,573,160413,159557
"1358",13773,2016-07-27 21:00:00,573,418,418,0,0,0,2016-07-27 21:00:00,573,1059,1317,575,1892,2951,2016-07-27 21:00:00,573,138366,137664
"1359",13774,2016-07-27 22:00:00,573,375,375,0,0,0,2016-07-27 22:00:00,573,911,1422,609,2031,2942,2016-07-27 22:00:00,573,117670,117065
"1360",13775,2016-07-27 23:00:00,573,395,395,0,0,0,2016-07-27 23:00:00,573,842,1366,565,1931,2773,2016-07-27 23:00:00,573,106528,106023
"1361",13776,2016-07-28 00:00:00,574,365,365,0,0,0,2016-07-28 00:00:00,574,762,1357,558,1915,2677,2016-07-28 00:00:00,574,104561,104039
"1362",13777,2016-07-28 01:00:00,574,327,327,0,0,0,2016-07-28 01:00:00,574,645,1382,596,1978,2623,2016-07-28 01:00:00,574,107159,106635
"1363",13778,2016-07-28 02:00:00,574,289,289,0,0,0,2016-07-28 02:00:00,574,530,931,400,1331,1861,2016-07-28 02:00:00,574,102322,101816
"1364",13779,2016-07-28 03:00:00,574,245,245,0,0,0,2016-07-28 03:00:00,574,357,738,306,1044,1401,2016-07-28 03:00:00,574,92214,91770
"1365",13780,2016-07-28 04:00:00,574,205,205,0,0,0,2016-07-28 04:00:00,574,336,458,187,645,981,2016-07-28 04:00:00,574,88835,88386
"1366",13781,2016-07-28 05:00:00,574,139,139,0,0,0,2016-07-28 05:00:00,574,219,269,109,378,597,2016-07-28 05:00:00,574,87042,86574
"1367",13782,2016-07-28 06:00:00,574,213,213,0,0,0,2016-07-28 06:00:00,574,133,183,77,260,393,2016-07-28 06:00:00,574,94301,93818
"1368",13783,2016-07-28 07:00:00,574,182,182,0,0,0,2016-07-28 07:00:00,574,85,91,44,135,220,2016-07-28 07:00:00,574,97696,97157
"1369",13784,2016-07-28 08:00:00,574,211,211,0,0,0,2016-07-28 08:00:00,574,78,55,20,75,153,2016-07-28 08:00:00,574,98469,97920
"1370",13785,2016-07-28 09:00:00,574,154,154,0,0,0,2016-07-28 09:00:00,574,84,43,20,63,147,2016-07-28 09:00:00,574,100181,99610
"1371",13786,2016-07-28 10:00:00,574,202,202,0,0,0,2016-07-28 10:00:00,574,72,85,43,128,200,2016-07-28 10:00:00,574,104865,104348
"1372",13787,2016-07-28 11:00:00,574,241,241,0,0,0,2016-07-28 11:00:00,574,191,165,98,263,454,2016-07-28 11:00:00,574,131929,131390
"1373",13788,2016-07-28 12:00:00,574,259,259,0,0,0,2016-07-28 12:00:00,574,398,257,129,386,784,2016-07-28 12:00:00,574,181137,180415
"1374",13789,2016-07-28 13:00:00,574,330,330,0,0,0,2016-07-28 13:00:00,574,738,559,282,841,1579,2016-07-28 13:00:00,574,212362,211563
"1375",13790,2016-07-28 14:00:00,574,340,340,0,0,0,2016-07-28 14:00:00,574,934,639,332,971,1905,2016-07-28 14:00:00,574,220926,219894
"1376",13791,2016-07-28 15:00:00,574,289,289,0,0,0,2016-07-28 15:00:00,574,1053,846,428,1274,2327,2016-07-28 15:00:00,574,216841,215813
"1377",13792,2016-07-28 16:00:00,574,267,267,0,0,0,2016-07-28 16:00:00,574,1088,1072,527,1599,2687,2016-07-28 16:00:00,574,198461,197538
"1378",13793,2016-07-28 17:00:00,574,233,233,0,0,0,2016-07-28 17:00:00,574,1201,1216,595,1811,3012,2016-07-28 17:00:00,574,192536,191624
"1379",13794,2016-07-28 18:00:00,574,279,279,0,0,0,2016-07-28 18:00:00,574,1302,1847,890,2737,4039,2016-07-28 18:00:00,574,194174,193222
"1380",13795,2016-07-28 19:00:00,574,282,282,0,0,0,2016-07-28 19:00:00,574,1236,1866,858,2724,3960,2016-07-28 19:00:00,574,185296,184387
"1381",13796,2016-07-28 20:00:00,574,246,246,0,0,0,2016-07-28 20:00:00,574,1253,1486,680,2166,3419,2016-07-28 20:00:00,574,174129,173276
"1382",13797,2016-07-28 21:00:00,574,348,348,0,0,0,2016-07-28 21:00:00,574,1177,1405,630,2035,3212,2016-07-28 21:00:00,574,149397,148681
"1383",13798,2016-07-28 22:00:00,574,318,318,0,0,0,2016-07-28 22:00:00,574,1109,1432,594,2026,3135,2016-07-28 22:00:00,574,126526,125892
"1384",13799,2016-07-28 23:00:00,574,316,316,0,0,0,2016-07-28 23:00:00,574,1042,1382,608,1990,3032,2016-07-28 23:00:00,574,114939,114341
"1385",13800,2016-07-29 00:00:00,575,301,301,0,0,0,2016-07-29 00:00:00,575,883,1245,475,1720,2603,2016-07-29 00:00:00,575,111608,111030
"1386",13801,2016-07-29 01:00:00,575,251,251,0,0,0,2016-07-29 01:00:00,575,855,1112,428,1540,2395,2016-07-29 01:00:00,575,111867,111296
"1387",13802,2016-07-29 02:00:00,575,255,255,0,0,0,2016-07-29 02:00:00,575,583,864,363,1227,1810,2016-07-29 02:00:00,575,104004,103440
"1388",13803,2016-07-29 03:00:00,575,290,290,0,0,0,2016-07-29 03:00:00,575,452,675,290,965,1417,2016-07-29 03:00:00,575,95338,94852
"1389",13804,2016-07-29 04:00:00,575,243,243,0,0,0,2016-07-29 04:00:00,575,426,511,184,695,1121,2016-07-29 04:00:00,575,89587,89146
"1390",13805,2016-07-29 05:00:00,575,181,181,0,0,0,2016-07-29 05:00:00,575,310,248,111,359,669,2016-07-29 05:00:00,575,85932,85510
"1391",13806,2016-07-29 06:00:00,575,162,162,0,0,0,2016-07-29 06:00:00,575,163,131,52,183,346,2016-07-29 06:00:00,575,91855,91399
"1392",13807,2016-07-29 07:00:00,575,187,187,0,0,0,2016-07-29 07:00:00,575,125,86,38,124,249,2016-07-29 07:00:00,575,93269,92803
"1393",13808,2016-07-29 08:00:00,575,173,173,0,0,0,2016-07-29 08:00:00,575,99,34,15,49,148,2016-07-29 08:00:00,575,93226,92721
"1394",13809,2016-07-29 09:00:00,575,159,159,0,0,0,2016-07-29 09:00:00,575,84,43,21,64,148,2016-07-29 09:00:00,575,94580,94055
"1395",13810,2016-07-29 10:00:00,575,131,131,0,0,0,2016-07-29 10:00:00,575,133,49,24,73,206,2016-07-29 10:00:00,575,99163,98693
"1396",13811,2016-07-29 11:00:00,575,120,120,0,0,0,2016-07-29 11:00:00,575,244,111,66,177,421,2016-07-29 11:00:00,575,126253,125741
"1397",13812,2016-07-29 12:00:00,575,164,164,0,0,0,2016-07-29 12:00:00,575,476,251,133,384,860,2016-07-29 12:00:00,575,170906,170312
"1398",13813,2016-07-29 13:00:00,575,209,209,0,0,0,2016-07-29 13:00:00,575,868,543,311,854,1722,2016-07-29 13:00:00,575,196193,195410
"1399",13814,2016-07-29 14:00:00,575,272,272,0,0,0,2016-07-29 14:00:00,575,987,691,381,1072,2059,2016-07-29 14:00:00,575,202045,201211
"1400",13815,2016-07-29 15:00:00,575,237,237,0,0,0,2016-07-29 15:00:00,575,1319,887,412,1299,2618,2016-07-29 15:00:00,575,198391,197512
"1401",13816,2016-07-29 16:00:00,575,369,369,0,0,0,2016-07-29 16:00:00,575,1350,955,456,1411,2761,2016-07-29 16:00:00,575,183835,182930
"1402",13817,2016-07-29 17:00:00,575,357,357,0,0,0,2016-07-29 17:00:00,575,1450,1166,554,1720,3170,2016-07-29 17:00:00,575,176350,175505
"1403",13818,2016-07-29 18:00:00,575,295,295,0,0,0,2016-07-29 18:00:00,575,1545,1211,562,1773,3318,2016-07-29 18:00:00,575,174545,173702
"1404",13819,2016-07-29 19:00:00,575,303,303,0,0,0,2016-07-29 19:00:00,575,798,980,479,1459,2257,2016-07-29 19:00:00,575,168656,167751
"1405",13820,2016-07-29 20:00:00,575,300,300,0,0,0,2016-07-29 20:00:00,575,714,994,498,1492,2206,2016-07-29 20:00:00,575,155604,154788
"1406",13821,2016-07-29 21:00:00,575,354,354,0,0,0,2016-07-29 21:00:00,575,801,1081,478,1559,2360,2016-07-29 21:00:00,575,134772,134143
"1407",13822,2016-07-29 22:00:00,575,300,300,0,0,0,2016-07-29 22:00:00,575,1321,1347,589,1936,3257,2016-07-29 22:00:00,575,115060,114463
"1408",13823,2016-07-29 23:00:00,575,247,247,0,0,0,2016-07-29 23:00:00,575,1271,1283,539,1822,3093,2016-07-29 23:00:00,575,102638,102107
"1409",13824,2016-07-30 00:00:00,576,208,208,0,0,0,2016-07-30 00:00:00,576,1153,1222,488,1710,2863,2016-07-30 00:00:00,576,96770,96238
"1410",13825,2016-07-30 01:00:00,576,223,223,0,0,0,2016-07-30 01:00:00,576,1129,1024,384,1408,2537,2016-07-30 01:00:00,576,96168,95655
"1411",13826,2016-07-30 02:00:00,576,205,205,0,0,0,2016-07-30 02:00:00,576,937,870,353,1223,2160,2016-07-30 02:00:00,576,94859,94281
"1412",13827,2016-07-30 03:00:00,576,180,180,0,0,0,2016-07-30 03:00:00,576,707,639,269,908,1615,2016-07-30 03:00:00,576,91124,90654
"1413",13828,2016-07-30 04:00:00,576,187,187,0,0,0,2016-07-30 04:00:00,576,682,426,164,590,1272,2016-07-30 04:00:00,576,82756,82283
"1414",13829,2016-07-30 05:00:00,576,143,143,0,0,0,2016-07-30 05:00:00,576,430,295,113,408,838,2016-07-30 05:00:00,576,74557,74143
"1415",13830,2016-07-30 06:00:00,576,140,140,0,0,0,2016-07-30 06:00:00,576,250,156,56,212,462,2016-07-30 06:00:00,576,69012,68623
"1416",13831,2016-07-30 07:00:00,576,146,146,0,0,0,2016-07-30 07:00:00,576,176,76,30,106,282,2016-07-30 07:00:00,576,66638,66299
"1417",13832,2016-07-30 08:00:00,576,171,171,0,0,0,2016-07-30 08:00:00,576,119,37,18,55,174,2016-07-30 08:00:00,576,63651,63277
"1418",13833,2016-07-30 09:00:00,576,147,147,0,0,0,2016-07-30 09:00:00,576,117,29,17,46,163,2016-07-30 09:00:00,576,64546,64187
"1419",13834,2016-07-30 10:00:00,576,100,100,0,0,0,2016-07-30 10:00:00,576,107,47,19,66,173,2016-07-30 10:00:00,576,66289,65908
"1420",13835,2016-07-30 11:00:00,576,118,118,0,0,0,2016-07-30 11:00:00,576,189,105,45,150,339,2016-07-30 11:00:00,576,74244,73875
"1421",13836,2016-07-30 12:00:00,576,161,161,0,0,0,2016-07-30 12:00:00,576,302,179,85,264,566,2016-07-30 12:00:00,576,84957,84578
"1422",13837,2016-07-30 13:00:00,576,245,245,0,0,0,2016-07-30 13:00:00,576,576,432,195,627,1203,2016-07-30 13:00:00,576,95329,94846
"1423",13838,2016-07-30 14:00:00,576,243,243,0,0,0,2016-07-30 14:00:00,576,766,526,239,765,1531,2016-07-30 14:00:00,576,103328,102777
"1424",13839,2016-07-30 15:00:00,576,209,209,0,0,0,2016-07-30 15:00:00,576,754,780,345,1125,1879,2016-07-30 15:00:00,576,106540,106020
"1425",13840,2016-07-30 16:00:00,576,276,276,0,0,0,2016-07-30 16:00:00,576,827,893,361,1254,2081,2016-07-30 16:00:00,576,104975,104468
"1426",13841,2016-07-30 17:00:00,576,276,276,0,0,0,2016-07-30 17:00:00,576,825,908,392,1300,2125,2016-07-30 17:00:00,576,101235,100690
"1427",13842,2016-07-30 18:00:00,576,277,277,0,0,0,2016-07-30 18:00:00,576,784,1014,447,1461,2245,2016-07-30 18:00:00,576,98050,97523
"1428",13843,2016-07-30 19:00:00,576,263,263,0,0,0,2016-07-30 19:00:00,576,740,1042,437,1479,2219,2016-07-30 19:00:00,576,94630,94094
"1429",13844,2016-07-30 20:00:00,576,249,249,0,0,0,2016-07-30 20:00:00,576,718,1049,437,1486,2204,2016-07-30 20:00:00,576,89159,88680
"1430",13845,2016-07-30 21:00:00,576,246,246,0,0,0,2016-07-30 21:00:00,576,688,1068,413,1481,2169,2016-07-30 21:00:00,576,82620,82209
"1431",13846,2016-07-30 22:00:00,576,267,267,0,0,0,2016-07-30 22:00:00,576,573,1107,410,1517,2090,2016-07-30 22:00:00,576,75420,75034
"1432",13847,2016-07-30 23:00:00,576,229,229,0,0,0,2016-07-30 23:00:00,576,539,1125,403,1528,2067,2016-07-30 23:00:00,576,72156,71771
"1433",13848,2016-07-31 00:00:00,577,254,254,0,0,0,2016-07-31 00:00:00,577,454,1070,407,1477,1931,2016-07-31 00:00:00,577,69385,69022
"1434",13849,2016-07-31 01:00:00,577,293,293,0,0,0,2016-07-31 01:00:00,577,370,957,357,1314,1684,2016-07-31 01:00:00,577,69825,69493
"1435",13850,2016-07-31 02:00:00,577,267,267,0,0,0,2016-07-31 02:00:00,577,303,818,291,1109,1412,2016-07-31 02:00:00,577,69290,68946
"1436",13851,2016-07-31 03:00:00,577,231,231,0,0,0,2016-07-31 03:00:00,577,227,655,249,904,1131,2016-07-31 03:00:00,577,67447,67112
"1437",13852,2016-07-31 04:00:00,577,228,228,0,0,0,2016-07-31 04:00:00,577,153,487,153,640,793,2016-07-31 04:00:00,577,64211,63917
"1438",13853,2016-07-31 05:00:00,577,187,187,0,0,0,2016-07-31 05:00:00,577,113,275,99,374,487,2016-07-31 05:00:00,577,61218,60964
"1439",13854,2016-07-31 06:00:00,577,177,177,0,0,0,2016-07-31 06:00:00,577,81,137,48,185,266,2016-07-31 06:00:00,577,58387,58090
"1440",13855,2016-07-31 07:00:00,577,204,204,0,0,0,2016-07-31 07:00:00,577,75,106,37,143,218,2016-07-31 07:00:00,577,56596,56313
"1441",13856,2016-07-31 08:00:00,577,179,179,0,0,0,2016-07-31 08:00:00,577,41,42,22,64,105,2016-07-31 08:00:00,577,55759,55452
"1442",13857,2016-07-31 09:00:00,577,151,151,0,0,0,2016-07-31 09:00:00,577,54,32,9,41,95,2016-07-31 09:00:00,577,55983,55703
"1443",13858,2016-07-31 10:00:00,577,129,129,0,0,0,2016-07-31 10:00:00,577,43,25,7,32,75,2016-07-31 10:00:00,577,59242,58933
"1444",13859,2016-07-31 11:00:00,577,142,142,0,0,0,2016-07-31 11:00:00,577,86,63,22,85,171,2016-07-31 11:00:00,577,65755,65410
"1445",13860,2016-07-31 12:00:00,577,172,172,0,0,0,2016-07-31 12:00:00,577,152,170,75,245,397,2016-07-31 12:00:00,577,74637,74302
"1446",13861,2016-07-31 13:00:00,577,155,155,0,0,0,2016-07-31 13:00:00,577,268,370,154,524,792,2016-07-31 13:00:00,577,82647,82263
"1447",13862,2016-07-31 14:00:00,577,249,249,0,0,0,2016-07-31 14:00:00,577,364,477,204,681,1045,2016-07-31 14:00:00,577,90675,90232
"1448",13863,2016-07-31 15:00:00,577,201,201,0,0,0,2016-07-31 15:00:00,577,405,624,253,877,1282,2016-07-31 15:00:00,577,95111,94642
"1449",13864,2016-07-31 16:00:00,577,283,283,0,0,0,2016-07-31 16:00:00,577,479,869,336,1205,1684,2016-07-31 16:00:00,577,96268,95804
"1450",13865,2016-07-31 17:00:00,577,274,274,0,0,0,2016-07-31 17:00:00,577,510,946,348,1294,1804,2016-07-31 17:00:00,577,95549,95049
"1451",13866,2016-07-31 18:00:00,577,281,281,0,0,0,2016-07-31 18:00:00,577,506,1034,383,1417,1923,2016-07-31 18:00:00,577,95250,94757
"1452",13867,2016-07-31 19:00:00,577,204,204,0,0,0,2016-07-31 19:00:00,577,534,1053,380,1433,1967,2016-07-31 19:00:00,577,94027,93571
"1453",13868,2016-07-31 20:00:00,577,238,238,0,0,0,2016-07-31 20:00:00,577,545,1158,455,1613,2158,2016-07-31 20:00:00,577,90505,90017
"1454",13869,2016-07-31 21:00:00,577,268,268,0,0,0,2016-07-31 21:00:00,577,479,1213,436,1649,2128,2016-07-31 21:00:00,577,84886,84430
"1455",13870,2016-07-31 22:00:00,577,245,245,0,0,0,2016-07-31 22:00:00,577,425,1141,390,1531,1956,2016-07-31 22:00:00,577,80379,79951
"1456",13871,2016-07-31 23:00:00,577,225,225,0,0,0,2016-07-31 23:00:00,577,422,1094,440,1534,1956,2016-07-31 23:00:00,577,80561,80122
"1457",13872,2016-08-01 00:00:00,578,272,272,0,0,0,2016-08-01 00:00:00,578,352,1005,363,1368,1720,2016-08-01 00:00:00,578,88647,88216
"1458",13873,2016-08-01 01:00:00,578,284,284,0,0,0,2016-08-01 01:00:00,578,329,903,321,1224,1553,2016-08-01 01:00:00,578,95261,94813
"1459",13874,2016-08-01 02:00:00,578,235,235,0,0,0,2016-08-01 02:00:00,578,269,813,323,1136,1405,2016-08-01 02:00:00,578,90112,89707
"1460",13875,2016-08-01 03:00:00,578,224,224,0,0,0,2016-08-01 03:00:00,578,174,636,238,874,1048,2016-08-01 03:00:00,578,84357,83996
"1461",13876,2016-08-01 04:00:00,578,254,254,0,0,0,2016-08-01 04:00:00,578,120,441,163,604,724,2016-08-01 04:00:00,578,81840,81498
"1462",13877,2016-08-01 05:00:00,578,224,224,0,0,0,2016-08-01 05:00:00,578,75,279,109,388,463,2016-08-01 05:00:00,578,81581,81222
"1463",13878,2016-08-01 06:00:00,578,221,221,0,0,0,2016-08-01 06:00:00,578,82,137,63,200,282,2016-08-01 06:00:00,578,87751,87338
"1464",13879,2016-08-01 07:00:00,578,210,210,0,0,0,2016-08-01 07:00:00,578,69,73,26,99,168,2016-08-01 07:00:00,578,91209,90778
"1465",13880,2016-08-01 08:00:00,578,183,183,0,0,0,2016-08-01 08:00:00,578,42,64,32,96,138,2016-08-01 08:00:00,578,91296,90842
"1466",13881,2016-08-01 09:00:00,578,122,122,0,0,0,2016-08-01 09:00:00,578,54,44,21,65,119,2016-08-01 09:00:00,578,93565,93098
"1467",13882,2016-08-01 10:00:00,578,136,136,0,0,0,2016-08-01 10:00:00,578,75,83,39,122,197,2016-08-01 10:00:00,578,104854,104388
"1468",13883,2016-08-01 11:00:00,578,136,136,0,0,0,2016-08-01 11:00:00,578,123,133,62,195,318,2016-08-01 11:00:00,578,151448,150959
"1469",13884,2016-08-01 12:00:00,578,220,220,0,0,0,2016-08-01 12:00:00,578,296,289,143,432,728,2016-08-01 12:00:00,578,219506,218815
"1470",13885,2016-08-01 13:00:00,578,223,223,0,0,0,2016-08-01 13:00:00,578,573,615,311,926,1499,2016-08-01 13:00:00,578,241253,240483
"1471",13886,2016-08-01 14:00:00,578,407,407,0,0,0,2016-08-01 14:00:00,578,705,716,342,1058,1763,2016-08-01 14:00:00,578,230679,229825
"1472",13887,2016-08-01 15:00:00,578,403,403,0,0,0,2016-08-01 15:00:00,578,843,952,443,1395,2238,2016-08-01 15:00:00,578,218934,218080
"1473",13888,2016-08-01 16:00:00,578,563,563,0,0,0,2016-08-01 16:00:00,578,797,1175,496,1671,2468,2016-08-01 16:00:00,578,193186,192386
"1474",13889,2016-08-01 17:00:00,578,510,510,0,0,0,2016-08-01 17:00:00,578,868,1262,529,1791,2659,2016-08-01 17:00:00,578,184279,183454
"1475",13890,2016-08-01 18:00:00,578,498,498,0,0,0,2016-08-01 18:00:00,578,903,1466,626,2092,2995,2016-08-01 18:00:00,578,181000,180140
"1476",13891,2016-08-01 19:00:00,578,425,425,0,0,0,2016-08-01 19:00:00,578,945,1449,574,2023,2968,2016-08-01 19:00:00,578,173313,172515
"1477",13892,2016-08-01 20:00:00,578,429,429,0,0,0,2016-08-01 20:00:00,578,955,1567,676,2243,3198,2016-08-01 20:00:00,578,161483,160737
"1478",13893,2016-08-01 21:00:00,578,378,378,0,0,0,2016-08-01 21:00:00,578,787,1753,681,2434,3221,2016-08-01 21:00:00,578,135346,134731
"1479",13894,2016-08-01 22:00:00,578,529,529,0,0,0,2016-08-01 22:00:00,578,699,1549,638,2187,2886,2016-08-01 22:00:00,578,113768,113277
"1480",13895,2016-08-01 23:00:00,578,449,449,0,0,0,2016-08-01 23:00:00,578,635,1608,653,2261,2896,2016-08-01 23:00:00,578,101784,101341
"1481",13896,2016-08-02 00:00:00,579,392,392,0,0,0,2016-08-02 00:00:00,579,563,1495,544,2039,2602,2016-08-02 00:00:00,579,99227,98758
"1482",13897,2016-08-02 01:00:00,579,336,336,0,0,0,2016-08-02 01:00:00,579,437,1370,497,1867,2304,2016-08-02 01:00:00,579,99172,98693
"1483",13898,2016-08-02 02:00:00,579,331,331,0,0,0,2016-08-02 02:00:00,579,347,1071,389,1460,1807,2016-08-02 02:00:00,579,93833,93371
"1484",13899,2016-08-02 03:00:00,579,311,311,0,0,0,2016-08-02 03:00:00,579,233,875,329,1204,1437,2016-08-02 03:00:00,579,87502,87079
"1485",13900,2016-08-02 04:00:00,579,313,313,0,0,0,2016-08-02 04:00:00,579,147,493,189,682,829,2016-08-02 04:00:00,579,81237,80839
"1486",13901,2016-08-02 05:00:00,579,280,280,0,0,0,2016-08-02 05:00:00,579,113,348,134,482,595,2016-08-02 05:00:00,579,80095,79696
"1487",13902,2016-08-02 06:00:00,579,193,193,0,0,0,2016-08-02 06:00:00,579,73,181,61,242,315,2016-08-02 06:00:00,579,87400,86975
"1488",13903,2016-08-02 07:00:00,579,279,279,0,0,0,2016-08-02 07:00:00,579,54,111,44,155,209,2016-08-02 07:00:00,579,91576,91121
"1489",13904,2016-08-02 08:00:00,579,213,213,0,0,0,2016-08-02 08:00:00,579,57,54,24,78,135,2016-08-02 08:00:00,579,92771,92285
"1490",13905,2016-08-02 09:00:00,579,181,181,0,0,0,2016-08-02 09:00:00,579,32,66,27,93,125,2016-08-02 09:00:00,579,93853,93352
"1491",13906,2016-08-02 10:00:00,579,155,155,0,0,0,2016-08-02 10:00:00,579,41,96,54,150,191,2016-08-02 10:00:00,579,97928,97439
"1492",13907,2016-08-02 11:00:00,579,234,234,0,0,0,2016-08-02 11:00:00,579,114,191,98,289,403,2016-08-02 11:00:00,579,122849,122366
"1493",13908,2016-08-02 12:00:00,579,308,308,0,0,0,2016-08-02 12:00:00,579,248,404,228,632,880,2016-08-02 12:00:00,579,164706,164068
"1494",13909,2016-08-02 13:00:00,579,362,362,0,0,0,2016-08-02 13:00:00,579,494,733,366,1099,1593,2016-08-02 13:00:00,579,193580,192782
"1495",13910,2016-08-02 14:00:00,579,542,542,0,0,0,2016-08-02 14:00:00,579,721,807,409,1216,1937,2016-08-02 14:00:00,579,199730,198858
"1496",13911,2016-08-02 15:00:00,579,522,522,0,0,0,2016-08-02 15:00:00,579,667,1142,509,1651,2318,2016-08-02 15:00:00,579,197891,197023
"1497",13912,2016-08-02 16:00:00,579,581,581,0,0,0,2016-08-02 16:00:00,579,790,1353,565,1918,2708,2016-08-02 16:00:00,579,179234,178412
"1498",13913,2016-08-02 17:00:00,579,631,631,0,0,0,2016-08-02 17:00:00,579,808,1645,696,2341,3149,2016-08-02 17:00:00,579,181794,180857
"1499",13914,2016-08-02 18:00:00,579,564,564,0,0,0,2016-08-02 18:00:00,579,838,1876,779,2655,3493,2016-08-02 18:00:00,579,184762,183797
"1500",13915,2016-08-02 19:00:00,579,527,527,0,0,0,2016-08-02 19:00:00,579,769,1877,803,2680,3449,2016-08-02 19:00:00,579,180416,179395
"1501",13916,2016-08-02 20:00:00,579,438,438,0,0,0,2016-08-02 20:00:00,579,827,1977,872,2849,3676,2016-08-02 20:00:00,579,170016,169125
"1502",13917,2016-08-02 21:00:00,579,457,457,0,0,0,2016-08-02 21:00:00,579,703,2218,906,3124,3827,2016-08-02 21:00:00,579,145330,144551
"1503",13918,2016-08-02 22:00:00,579,578,578,0,0,0,2016-08-02 22:00:00,579,646,2130,842,2972,3618,2016-08-02 22:00:00,579,126392,125688
"1504",13919,2016-08-02 23:00:00,579,514,514,0,0,0,2016-08-02 23:00:00,579,615,1858,716,2574,3189,2016-08-02 23:00:00,579,121511,120830
"1505",13920,2016-08-03 00:00:00,580,385,385,0,0,0,2016-08-03 00:00:00,580,529,1636,621,2257,2786,2016-08-03 00:00:00,580,116649,116063
"1506",13921,2016-08-03 01:00:00,580,304,304,0,0,0,2016-08-03 01:00:00,580,450,1532,589,2121,2571,2016-08-03 01:00:00,580,116529,115922
"1507",13922,2016-08-03 02:00:00,580,242,242,0,0,0,2016-08-03 02:00:00,580,354,1265,471,1736,2090,2016-08-03 02:00:00,580,113398,112763
"1508",13923,2016-08-03 03:00:00,580,265,265,0,0,0,2016-08-03 03:00:00,580,234,943,335,1278,1512,2016-08-03 03:00:00,580,105794,105234
"1509",13924,2016-08-03 04:00:00,580,278,278,0,0,0,2016-08-03 04:00:00,580,187,549,202,751,938,2016-08-03 04:00:00,580,98178,97710
"1510",13925,2016-08-03 05:00:00,580,242,242,0,0,0,2016-08-03 05:00:00,580,147,400,140,540,687,2016-08-03 05:00:00,580,94178,93709
"1511",13926,2016-08-03 06:00:00,580,180,180,0,0,0,2016-08-03 06:00:00,580,73,222,78,300,373,2016-08-03 06:00:00,580,100819,100325
"1512",13927,2016-08-03 07:00:00,580,231,231,0,0,0,2016-08-03 07:00:00,580,57,93,33,126,183,2016-08-03 07:00:00,580,104431,103838
"1513",13928,2016-08-03 08:00:00,580,207,207,0,0,0,2016-08-03 08:00:00,580,58,61,29,90,148,2016-08-03 08:00:00,580,104820,104226
"1514",13929,2016-08-03 09:00:00,580,138,138,0,0,0,2016-08-03 09:00:00,580,53,44,19,63,116,2016-08-03 09:00:00,580,106858,106306
"1515",13930,2016-08-03 10:00:00,580,156,156,0,0,0,2016-08-03 10:00:00,580,66,98,41,139,205,2016-08-03 10:00:00,580,111121,110568
"1516",13931,2016-08-03 11:00:00,580,166,166,0,0,0,2016-08-03 11:00:00,580,123,187,112,299,422,2016-08-03 11:00:00,580,135989,135372
"1517",13932,2016-08-03 12:00:00,580,273,273,0,0,0,2016-08-03 12:00:00,580,283,452,256,708,991,2016-08-03 12:00:00,580,177012,176332
"1518",13933,2016-08-03 13:00:00,580,359,359,0,0,0,2016-08-03 13:00:00,580,472,698,345,1043,1515,2016-08-03 13:00:00,580,206846,205961
"1519",13934,2016-08-03 14:00:00,580,387,387,0,0,0,2016-08-03 14:00:00,580,649,774,375,1149,1798,2016-08-03 14:00:00,580,218801,217771
"1520",13935,2016-08-03 15:00:00,580,415,415,0,0,0,2016-08-03 15:00:00,580,699,1066,459,1525,2224,2016-08-03 15:00:00,580,216234,215170
"1521",13936,2016-08-03 16:00:00,580,414,414,0,0,0,2016-08-03 16:00:00,580,722,1422,629,2051,2773,2016-08-03 16:00:00,580,198120,197199
"1522",13937,2016-08-03 17:00:00,580,497,497,0,0,0,2016-08-03 17:00:00,580,786,1514,658,2172,2958,2016-08-03 17:00:00,580,194242,193302
"1523",13938,2016-08-03 18:00:00,580,428,428,0,0,0,2016-08-03 18:00:00,580,785,1492,638,2130,2915,2016-08-03 18:00:00,580,194688,193682
"1524",13939,2016-08-03 19:00:00,580,351,351,0,0,0,2016-08-03 19:00:00,580,777,1740,733,2473,3250,2016-08-03 19:00:00,580,186648,185702
"1525",13940,2016-08-03 20:00:00,580,435,435,0,0,0,2016-08-03 20:00:00,580,784,1680,691,2371,3155,2016-08-03 20:00:00,580,174910,174060
"1526",13941,2016-08-03 21:00:00,580,410,410,0,0,0,2016-08-03 21:00:00,580,748,1791,699,2490,3238,2016-08-03 21:00:00,580,149269,148537
"1527",13942,2016-08-03 22:00:00,580,490,490,0,0,0,2016-08-03 22:00:00,580,672,1786,705,2491,3163,2016-08-03 22:00:00,580,126362,125768
"1528",13943,2016-08-03 23:00:00,580,455,455,0,0,0,2016-08-03 23:00:00,580,589,1780,692,2472,3061,2016-08-03 23:00:00,580,115222,114594
"1529",13944,2016-08-04 00:00:00,581,446,446,0,0,0,2016-08-04 00:00:00,581,529,1535,602,2137,2666,2016-08-04 00:00:00,581,112489,111940
"1530",13945,2016-08-04 01:00:00,581,363,363,0,0,0,2016-08-04 01:00:00,581,453,1328,520,1848,2301,2016-08-04 01:00:00,581,115057,114474
"1531",13946,2016-08-04 02:00:00,581,290,290,0,0,0,2016-08-04 02:00:00,581,353,1078,406,1484,1837,2016-08-04 02:00:00,581,111073,110505
"1532",13947,2016-08-04 03:00:00,581,262,262,0,0,0,2016-08-04 03:00:00,581,272,819,339,1158,1430,2016-08-04 03:00:00,581,103308,102802
"1533",13948,2016-08-04 04:00:00,581,332,332,0,0,0,2016-08-04 04:00:00,581,170,530,192,722,892,2016-08-04 04:00:00,581,97656,97183
"1534",13949,2016-08-04 05:00:00,581,214,214,0,0,0,2016-08-04 05:00:00,581,115,311,121,432,547,2016-08-04 05:00:00,581,96162,95697
"1535",13950,2016-08-04 06:00:00,581,222,222,0,0,0,2016-08-04 06:00:00,581,69,182,65,247,316,2016-08-04 06:00:00,581,102127,101618
"1536",13951,2016-08-04 07:00:00,581,218,218,0,0,0,2016-08-04 07:00:00,581,67,98,36,134,201,2016-08-04 07:00:00,581,105091,104550
"1537",13952,2016-08-04 08:00:00,581,204,204,0,0,0,2016-08-04 08:00:00,581,56,55,20,75,131,2016-08-04 08:00:00,581,105400,104830
"1538",13953,2016-08-04 09:00:00,581,168,168,0,0,0,2016-08-04 09:00:00,581,55,41,17,58,113,2016-08-04 09:00:00,581,107508,106975
"1539",13954,2016-08-04 10:00:00,581,196,196,0,0,0,2016-08-04 10:00:00,581,61,68,31,99,160,2016-08-04 10:00:00,581,116833,116262
"1540",13955,2016-08-04 11:00:00,581,258,258,0,0,0,2016-08-04 11:00:00,581,120,157,83,240,360,2016-08-04 11:00:00,581,160848,160268
"1541",13956,2016-08-04 12:00:00,581,312,312,0,0,0,2016-08-04 12:00:00,581,252,375,188,563,815,2016-08-04 12:00:00,581,233050,232331
"1542",13957,2016-08-04 13:00:00,581,397,397,0,0,0,2016-08-04 13:00:00,581,456,674,338,1012,1468,2016-08-04 13:00:00,581,267174,266252
"1543",13958,2016-08-04 14:00:00,581,402,402,0,0,0,2016-08-04 14:00:00,581,591,782,374,1156,1747,2016-08-04 14:00:00,581,266405,265413
"1544",13959,2016-08-04 15:00:00,581,434,434,0,0,0,2016-08-04 15:00:00,581,733,950,437,1387,2120,2016-08-04 15:00:00,581,258339,257250
"1545",13960,2016-08-04 16:00:00,581,392,392,0,0,0,2016-08-04 16:00:00,581,786,1172,520,1692,2478,2016-08-04 16:00:00,581,234035,233046
"1546",13961,2016-08-04 17:00:00,581,401,401,0,0,0,2016-08-04 17:00:00,581,715,1395,612,2007,2722,2016-08-04 17:00:00,581,222269,221327
"1547",13962,2016-08-04 18:00:00,581,349,349,0,0,0,2016-08-04 18:00:00,581,831,1508,640,2148,2979,2016-08-04 18:00:00,581,217951,217022
"1548",13963,2016-08-04 19:00:00,581,330,330,0,0,0,2016-08-04 19:00:00,581,829,1613,652,2265,3094,2016-08-04 19:00:00,581,206400,205512
"1549",13964,2016-08-04 20:00:00,581,348,348,0,0,0,2016-08-04 20:00:00,581,802,1720,769,2489,3291,2016-08-04 20:00:00,581,191537,190656
"1550",13965,2016-08-04 21:00:00,581,405,405,0,0,0,2016-08-04 21:00:00,581,712,1752,740,2492,3204,2016-08-04 21:00:00,581,159432,158740
"1551",13966,2016-08-04 22:00:00,581,379,379,0,0,0,2016-08-04 22:00:00,581,590,1470,596,2066,2656,2016-08-04 22:00:00,581,129239,128653
"1552",13967,2016-08-04 23:00:00,581,388,388,0,0,0,2016-08-04 23:00:00,581,543,1447,586,2033,2576,2016-08-04 23:00:00,581,114892,114342
"1553",13968,2016-08-05 00:00:00,582,353,353,0,0,0,2016-08-05 00:00:00,582,502,1403,553,1956,2458,2016-08-05 00:00:00,582,109693,109172
"1554",13969,2016-08-05 01:00:00,582,350,350,0,0,0,2016-08-05 01:00:00,582,438,1385,507,1892,2330,2016-08-05 01:00:00,582,110161,109639
"1555",13970,2016-08-05 02:00:00,582,295,295,0,0,0,2016-08-05 02:00:00,582,293,1048,401,1449,1742,2016-08-05 02:00:00,582,104098,103604
"1556",13971,2016-08-05 03:00:00,582,321,321,0,0,0,2016-08-05 03:00:00,582,267,722,268,990,1257,2016-08-05 03:00:00,582,95404,94931
"1557",13972,2016-08-05 04:00:00,582,285,285,0,0,0,2016-08-05 04:00:00,582,182,482,182,664,846,2016-08-05 04:00:00,582,87393,86987
"1558",13973,2016-08-05 05:00:00,582,243,243,0,0,0,2016-08-05 05:00:00,582,108,287,122,409,517,2016-08-05 05:00:00,582,83563,83182
"1559",13974,2016-08-05 06:00:00,582,248,248,0,0,0,2016-08-05 06:00:00,582,76,151,56,207,283,2016-08-05 06:00:00,582,90087,89650
"1560",13975,2016-08-05 07:00:00,582,180,180,0,0,0,2016-08-05 07:00:00,582,103,94,41,135,238,2016-08-05 07:00:00,582,92686,92160
"1561",13976,2016-08-05 08:00:00,582,206,206,0,0,0,2016-08-05 08:00:00,582,101,42,16,58,159,2016-08-05 08:00:00,582,92002,91516
"1562",13977,2016-08-05 09:00:00,582,189,189,0,0,0,2016-08-05 09:00:00,582,63,40,16,56,119,2016-08-05 09:00:00,582,94414,93949
"1563",13978,2016-08-05 10:00:00,582,151,151,0,0,0,2016-08-05 10:00:00,582,59,79,41,120,179,2016-08-05 10:00:00,582,102871,102433
"1564",13979,2016-08-05 11:00:00,582,183,183,0,0,0,2016-08-05 11:00:00,582,74,148,75,223,297,2016-08-05 11:00:00,582,142148,141600
"1565",13980,2016-08-05 12:00:00,582,247,247,0,0,0,2016-08-05 12:00:00,582,240,307,155,462,702,2016-08-05 12:00:00,582,200560,199919
"1566",13981,2016-08-05 13:00:00,582,348,348,0,0,0,2016-08-05 13:00:00,582,456,562,289,851,1307,2016-08-05 13:00:00,582,225540,224769
"1567",13982,2016-08-05 14:00:00,582,415,415,0,0,0,2016-08-05 14:00:00,582,531,794,387,1181,1712,2016-08-05 14:00:00,582,222664,221771
"1568",13983,2016-08-05 15:00:00,582,486,486,0,0,0,2016-08-05 15:00:00,582,612,923,413,1336,1948,2016-08-05 15:00:00,582,214945,214020
"1569",13984,2016-08-05 16:00:00,582,484,484,0,0,0,2016-08-05 16:00:00,582,646,1076,491,1567,2213,2016-08-05 16:00:00,582,192340,191486
"1570",13985,2016-08-05 17:00:00,582,509,509,0,0,0,2016-08-05 17:00:00,582,717,1195,520,1715,2432,2016-08-05 17:00:00,582,182558,181791
"1571",13986,2016-08-05 18:00:00,582,492,492,0,0,0,2016-08-05 18:00:00,582,662,1460,657,2117,2779,2016-08-05 18:00:00,582,179554,178710
"1572",13987,2016-08-05 19:00:00,582,403,403,0,0,0,2016-08-05 19:00:00,582,776,1431,630,2061,2837,2016-08-05 19:00:00,582,170623,169837
"1573",13988,2016-08-05 20:00:00,582,428,428,0,0,0,2016-08-05 20:00:00,582,733,1463,652,2115,2848,2016-08-05 20:00:00,582,155838,155115
"1574",13989,2016-08-05 21:00:00,582,436,436,0,0,0,2016-08-05 21:00:00,582,639,1530,681,2211,2850,2016-08-05 21:00:00,582,129647,129052
"1575",13990,2016-08-05 22:00:00,582,433,433,0,0,0,2016-08-05 22:00:00,582,568,1453,613,2066,2634,2016-08-05 22:00:00,582,106468,106002
"1576",13991,2016-08-05 23:00:00,582,361,361,0,0,0,2016-08-05 23:00:00,582,502,1391,555,1946,2448,2016-08-05 23:00:00,582,93012,92542
"1577",13992,2016-08-06 00:00:00,583,345,345,0,0,0,2016-08-06 00:00:00,583,443,1195,471,1666,2109,2016-08-06 00:00:00,583,85231,84776
"1578",13993,2016-08-06 01:00:00,583,349,349,0,0,0,2016-08-06 01:00:00,583,354,1025,392,1417,1771,2016-08-06 01:00:00,583,83462,83036
"1579",13994,2016-08-06 02:00:00,583,283,283,0,0,0,2016-08-06 02:00:00,583,291,1017,414,1431,1722,2016-08-06 02:00:00,583,80762,80338
"1580",13995,2016-08-06 03:00:00,583,267,267,0,0,0,2016-08-06 03:00:00,583,243,791,326,1117,1360,2016-08-06 03:00:00,583,76774,76391
"1581",13996,2016-08-06 04:00:00,583,233,233,0,0,0,2016-08-06 04:00:00,583,156,549,232,781,937,2016-08-06 04:00:00,583,71621,71235
"1582",13997,2016-08-06 05:00:00,583,196,196,0,0,0,2016-08-06 05:00:00,583,99,316,131,447,546,2016-08-06 05:00:00,583,67746,67409
"1583",13998,2016-08-06 06:00:00,583,188,188,0,0,0,2016-08-06 06:00:00,583,76,219,88,307,383,2016-08-06 06:00:00,583,64815,64486
"1584",13999,2016-08-06 07:00:00,583,204,204,0,0,0,2016-08-06 07:00:00,583,47,93,48,141,188,2016-08-06 07:00:00,583,63343,63026
"1585",14000,2016-08-06 08:00:00,583,169,169,0,0,0,2016-08-06 08:00:00,583,36,54,20,74,110,2016-08-06 08:00:00,583,62250,61910
"1586",14001,2016-08-06 09:00:00,583,139,139,0,0,0,2016-08-06 09:00:00,583,41,35,16,51,92,2016-08-06 09:00:00,583,62465,62149
"1587",14002,2016-08-06 10:00:00,583,121,121,0,0,0,2016-08-06 10:00:00,583,48,62,31,93,141,2016-08-06 10:00:00,583,66698,66359
"1588",14003,2016-08-06 11:00:00,583,168,168,0,0,0,2016-08-06 11:00:00,583,73,133,65,198,271,2016-08-06 11:00:00,583,78020,77665
"1589",14004,2016-08-06 12:00:00,583,200,200,0,0,0,2016-08-06 12:00:00,583,138,265,136,401,539,2016-08-06 12:00:00,583,90374,89987
"1590",14005,2016-08-06 13:00:00,583,313,313,0,0,0,2016-08-06 13:00:00,583,292,569,265,834,1126,2016-08-06 13:00:00,583,101147,100705
"1591",14006,2016-08-06 14:00:00,583,365,365,0,0,0,2016-08-06 14:00:00,583,368,847,397,1244,1612,2016-08-06 14:00:00,583,109684,109176
"1592",14007,2016-08-06 15:00:00,583,302,302,0,0,0,2016-08-06 15:00:00,583,436,923,419,1342,1778,2016-08-06 15:00:00,583,113933,113334
"1593",14008,2016-08-06 16:00:00,583,446,446,0,0,0,2016-08-06 16:00:00,583,453,1128,495,1623,2076,2016-08-06 16:00:00,583,111479,110910
"1594",14009,2016-08-06 17:00:00,583,377,377,0,0,0,2016-08-06 17:00:00,583,462,1290,591,1881,2343,2016-08-06 17:00:00,583,107570,106987
"1595",14010,2016-08-06 18:00:00,583,403,403,0,0,0,2016-08-06 18:00:00,583,510,1354,533,1887,2397,2016-08-06 18:00:00,583,102549,102024
"1596",14011,2016-08-06 19:00:00,583,342,342,0,0,0,2016-08-06 19:00:00,583,489,1282,560,1842,2331,2016-08-06 19:00:00,583,99143,98637
"1597",14012,2016-08-06 20:00:00,583,304,304,0,0,0,2016-08-06 20:00:00,583,530,1333,541,1874,2404,2016-08-06 20:00:00,583,93648,93154
"1598",14013,2016-08-06 21:00:00,583,307,307,0,0,0,2016-08-06 21:00:00,583,450,1344,576,1920,2370,2016-08-06 21:00:00,583,86224,85747
"1599",14014,2016-08-06 22:00:00,583,309,309,0,0,0,2016-08-06 22:00:00,583,412,1312,520,1832,2244,2016-08-06 22:00:00,583,79590,79166
"1600",14015,2016-08-06 23:00:00,583,309,309,0,0,0,2016-08-06 23:00:00,583,406,1237,463,1700,2106,2016-08-06 23:00:00,583,75911,75488
"1601",14016,2016-08-07 00:00:00,584,243,243,0,0,0,2016-08-07 00:00:00,584,330,1081,418,1499,1829,2016-08-07 00:00:00,584,73657,73294
"1602",14017,2016-08-07 01:00:00,584,245,245,0,0,0,2016-08-07 01:00:00,584,347,1034,403,1437,1784,2016-08-07 01:00:00,584,73798,73411
"1603",14018,2016-08-07 02:00:00,584,254,254,0,0,0,2016-08-07 02:00:00,584,252,878,339,1217,1469,2016-08-07 02:00:00,584,73355,72962
"1604",14019,2016-08-07 03:00:00,584,210,210,0,0,0,2016-08-07 03:00:00,584,203,601,239,840,1043,2016-08-07 03:00:00,584,73678,73336
"1605",14020,2016-08-07 04:00:00,584,179,179,0,0,0,2016-08-07 04:00:00,584,124,422,161,583,707,2016-08-07 04:00:00,584,72096,71745
"1606",14021,2016-08-07 05:00:00,584,176,176,0,0,0,2016-08-07 05:00:00,584,92,251,94,345,437,2016-08-07 05:00:00,584,66806,66483
"1607",14022,2016-08-07 06:00:00,584,160,160,0,0,0,2016-08-07 06:00:00,584,64,176,76,252,316,2016-08-07 06:00:00,584,64217,63913
"1608",14023,2016-08-07 07:00:00,584,172,172,0,0,0,2016-08-07 07:00:00,584,48,97,35,132,180,2016-08-07 07:00:00,584,62629,62294
"1609",14024,2016-08-07 08:00:00,584,155,155,0,0,0,2016-08-07 08:00:00,584,44,54,22,76,120,2016-08-07 08:00:00,584,61690,61384
"1610",14025,2016-08-07 09:00:00,584,163,163,0,0,0,2016-08-07 09:00:00,584,43,46,18,64,107,2016-08-07 09:00:00,584,61739,61410
"1611",14026,2016-08-07 10:00:00,584,131,131,0,0,0,2016-08-07 10:00:00,584,50,50,18,68,118,2016-08-07 10:00:00,584,65088,64806
"1612",14027,2016-08-07 11:00:00,584,174,174,0,0,0,2016-08-07 11:00:00,584,68,96,44,140,208,2016-08-07 11:00:00,584,73083,72742
"1613",14028,2016-08-07 12:00:00,584,226,226,0,0,0,2016-08-07 12:00:00,584,123,193,109,302,425,2016-08-07 12:00:00,584,81901,81526
"1614",14029,2016-08-07 13:00:00,584,245,245,0,0,0,2016-08-07 13:00:00,584,204,398,191,589,793,2016-08-07 13:00:00,584,90808,90409
"1615",14030,2016-08-07 14:00:00,584,365,365,0,0,0,2016-08-07 14:00:00,584,262,638,316,954,1216,2016-08-07 14:00:00,584,98559,98086
"1616",14031,2016-08-07 15:00:00,584,290,290,0,0,0,2016-08-07 15:00:00,584,331,681,344,1025,1356,2016-08-07 15:00:00,584,102867,102368
"1617",14032,2016-08-07 16:00:00,584,330,330,0,0,0,2016-08-07 16:00:00,584,369,914,398,1312,1681,2016-08-07 16:00:00,584,103480,102939
"1618",14033,2016-08-07 17:00:00,584,321,321,0,0,0,2016-08-07 17:00:00,584,391,1047,453,1500,1891,2016-08-07 17:00:00,584,103097,102572
"1619",14034,2016-08-07 18:00:00,584,387,387,0,0,0,2016-08-07 18:00:00,584,459,1123,474,1597,2056,2016-08-07 18:00:00,584,102496,101990
"1620",14035,2016-08-07 19:00:00,584,307,307,0,0,0,2016-08-07 19:00:00,584,460,1187,486,1673,2133,2016-08-07 19:00:00,584,100416,99912
"1621",14036,2016-08-07 20:00:00,584,267,267,0,0,0,2016-08-07 20:00:00,584,378,1201,473,1674,2052,2016-08-07 20:00:00,584,97212,96706
"1622",14037,2016-08-07 21:00:00,584,238,238,0,0,0,2016-08-07 21:00:00,584,363,1196,486,1682,2045,2016-08-07 21:00:00,584,90513,90023
"1623",14038,2016-08-07 22:00:00,584,298,298,0,0,0,2016-08-07 22:00:00,584,363,1138,468,1606,1969,2016-08-07 22:00:00,584,86166,85715
"1624",14039,2016-08-07 23:00:00,584,327,327,0,0,0,2016-08-07 23:00:00,584,327,1209,442,1651,1978,2016-08-07 23:00:00,584,88231,87796
"1625",14040,2016-08-08 00:00:00,585,324,324,0,0,0,2016-08-08 00:00:00,585,311,1075,414,1489,1800,2016-08-08 00:00:00,585,96954,96587
"1626",14041,2016-08-08 01:00:00,585,312,312,0,0,0,2016-08-08 01:00:00,585,268,952,372,1324,1592,2016-08-08 01:00:00,585,105580,105109
"1627",14042,2016-08-08 02:00:00,585,279,279,0,0,0,2016-08-08 02:00:00,585,214,721,302,1023,1237,2016-08-08 02:00:00,585,98950,98518
"1628",14043,2016-08-08 03:00:00,585,249,249,0,0,0,2016-08-08 03:00:00,585,178,484,187,671,849,2016-08-08 03:00:00,585,93672,93223
"1629",14044,2016-08-08 04:00:00,585,297,297,0,0,0,2016-08-08 04:00:00,585,105,325,130,455,560,2016-08-08 04:00:00,585,91861,91465
"1630",14045,2016-08-08 05:00:00,585,270,270,0,0,0,2016-08-08 05:00:00,585,105,211,89,300,405,2016-08-08 05:00:00,585,90767,90360
"1631",14046,2016-08-08 06:00:00,585,220,220,0,0,0,2016-08-08 06:00:00,585,54,83,33,116,170,2016-08-08 06:00:00,585,98690,98268
"1632",14047,2016-08-08 07:00:00,585,218,218,0,0,0,2016-08-08 07:00:00,585,58,57,18,75,133,2016-08-08 07:00:00,585,100229,99735
"1633",14048,2016-08-08 08:00:00,585,202,202,0,0,0,2016-08-08 08:00:00,585,56,52,17,69,125,2016-08-08 08:00:00,585,100072,99508
"1634",14049,2016-08-08 09:00:00,585,232,232,0,0,0,2016-08-08 09:00:00,585,38,37,12,49,87,2016-08-08 09:00:00,585,104466,103992
"1635",14050,2016-08-08 10:00:00,585,217,217,0,0,0,2016-08-08 10:00:00,585,79,81,38,119,198,2016-08-08 10:00:00,585,127408,126933
"1636",14051,2016-08-08 11:00:00,585,222,222,0,0,0,2016-08-08 11:00:00,585,129,157,80,237,366,2016-08-08 11:00:00,585,210620,210063
"1637",14052,2016-08-08 12:00:00,585,284,284,0,0,0,2016-08-08 12:00:00,585,281,318,192,510,791,2016-08-08 12:00:00,585,322856,322174
"1638",14053,2016-08-08 13:00:00,585,340,340,0,0,0,2016-08-08 13:00:00,585,452,627,346,973,1425,2016-08-08 13:00:00,585,337573,336659
"1639",14054,2016-08-08 14:00:00,585,506,506,0,0,0,2016-08-08 14:00:00,585,539,748,364,1112,1651,2016-08-08 14:00:00,585,306117,305169
"1640",14055,2016-08-08 15:00:00,585,485,485,0,0,0,2016-08-08 15:00:00,585,648,937,435,1372,2020,2016-08-08 15:00:00,585,282132,281212
"1641",14056,2016-08-08 16:00:00,585,475,475,0,0,0,2016-08-08 16:00:00,585,711,1017,522,1539,2250,2016-08-08 16:00:00,585,239512,238631
"1642",14057,2016-08-08 17:00:00,585,502,502,0,0,0,2016-08-08 17:00:00,585,723,1111,534,1645,2368,2016-08-08 17:00:00,585,222049,221190
"1643",14058,2016-08-08 18:00:00,585,533,533,0,0,0,2016-08-08 18:00:00,585,817,1122,508,1630,2447,2016-08-08 18:00:00,585,221274,220338
"1644",14059,2016-08-08 19:00:00,585,422,422,0,0,0,2016-08-08 19:00:00,585,896,1440,662,2102,2998,2016-08-08 19:00:00,585,212839,211936
"1645",14060,2016-08-08 20:00:00,585,427,427,0,0,0,2016-08-08 20:00:00,585,765,1371,606,1977,2742,2016-08-08 20:00:00,585,195149,194327
"1646",14061,2016-08-08 21:00:00,585,401,401,0,0,0,2016-08-08 21:00:00,585,731,1417,607,2024,2755,2016-08-08 21:00:00,585,161148,160458
"1647",14062,2016-08-08 22:00:00,585,470,470,0,0,0,2016-08-08 22:00:00,585,613,1472,609,2081,2694,2016-08-08 22:00:00,585,133208,132636
"1648",14063,2016-08-08 23:00:00,585,486,486,0,0,0,2016-08-08 23:00:00,585,540,1220,452,1672,2212,2016-08-08 23:00:00,585,119264,118735
"1649",14064,2016-08-09 00:00:00,586,370,370,0,0,0,2016-08-09 00:00:00,586,531,1172,414,1586,2117,2016-08-09 00:00:00,586,112801,112320
"1650",14065,2016-08-09 01:00:00,586,312,312,0,0,0,2016-08-09 01:00:00,586,400,1127,412,1539,1939,2016-08-09 01:00:00,586,112218,111711
"1651",14066,2016-08-09 02:00:00,586,282,282,0,0,0,2016-08-09 02:00:00,586,300,849,300,1149,1449,2016-08-09 02:00:00,586,105601,105092
"1652",14067,2016-08-09 03:00:00,586,334,334,0,0,0,2016-08-09 03:00:00,586,223,589,224,813,1036,2016-08-09 03:00:00,586,94711,94281
"1653",14068,2016-08-09 04:00:00,586,250,250,0,0,0,2016-08-09 04:00:00,586,148,447,159,606,754,2016-08-09 04:00:00,586,87165,86767
"1654",14069,2016-08-09 05:00:00,586,248,248,0,0,0,2016-08-09 05:00:00,586,115,234,83,317,432,2016-08-09 05:00:00,586,83685,83288
"1655",14070,2016-08-09 06:00:00,586,233,233,0,0,0,2016-08-09 06:00:00,586,74,154,56,210,284,2016-08-09 06:00:00,586,89650,89182
"1656",14071,2016-08-09 07:00:00,586,224,224,0,0,0,2016-08-09 07:00:00,586,50,69,24,93,143,2016-08-09 07:00:00,586,93256,92784
"1657",14072,2016-08-09 08:00:00,586,194,194,0,0,0,2016-08-09 08:00:00,586,50,70,24,94,144,2016-08-09 08:00:00,586,93811,93298
"1658",14073,2016-08-09 09:00:00,586,198,198,0,0,0,2016-08-09 09:00:00,586,46,43,18,61,107,2016-08-09 09:00:00,586,95968,95489
"1659",14074,2016-08-09 10:00:00,586,216,216,0,0,0,2016-08-09 10:00:00,586,59,76,40,116,175,2016-08-09 10:00:00,586,103925,103479
"1660",14075,2016-08-09 11:00:00,586,234,234,0,0,0,2016-08-09 11:00:00,586,114,167,96,263,377,2016-08-09 11:00:00,586,139416,138899
"1661",14076,2016-08-09 12:00:00,586,314,314,0,0,0,2016-08-09 12:00:00,586,280,319,188,507,787,2016-08-09 12:00:00,586,193961,193285
"1662",14077,2016-08-09 13:00:00,586,424,424,0,0,0,2016-08-09 13:00:00,586,410,611,326,937,1347,2016-08-09 13:00:00,586,222670,221865
"1663",14078,2016-08-09 14:00:00,586,468,468,0,0,0,2016-08-09 14:00:00,586,516,716,386,1102,1618,2016-08-09 14:00:00,586,224983,224067
"1664",14079,2016-08-09 15:00:00,586,482,482,0,0,0,2016-08-09 15:00:00,586,624,823,419,1242,1866,2016-08-09 15:00:00,586,219630,218683
"1665",14080,2016-08-09 16:00:00,586,532,532,0,0,0,2016-08-09 16:00:00,586,666,1061,471,1532,2198,2016-08-09 16:00:00,586,199146,198300
"1666",14081,2016-08-09 17:00:00,586,534,534,0,0,0,2016-08-09 17:00:00,586,717,1079,516,1595,2312,2016-08-09 17:00:00,586,193068,192211
"1667",14082,2016-08-09 18:00:00,586,551,551,0,0,0,2016-08-09 18:00:00,586,786,1191,527,1718,2504,2016-08-09 18:00:00,586,194537,193623
"1668",14083,2016-08-09 19:00:00,586,487,487,0,0,0,2016-08-09 19:00:00,586,766,1264,575,1839,2605,2016-08-09 19:00:00,586,187500,186570
"1669",14084,2016-08-09 20:00:00,586,484,484,0,0,0,2016-08-09 20:00:00,586,769,1380,578,1958,2727,2016-08-09 20:00:00,586,173674,172866
"1670",14085,2016-08-09 21:00:00,586,493,493,0,0,0,2016-08-09 21:00:00,586,670,1469,620,2089,2759,2016-08-09 21:00:00,586,146368,145669
"1671",14086,2016-08-09 22:00:00,586,490,490,0,0,0,2016-08-09 22:00:00,586,552,1311,564,1875,2427,2016-08-09 22:00:00,586,123303,122746
"1672",14087,2016-08-09 23:00:00,586,495,495,0,0,0,2016-08-09 23:00:00,586,500,1143,463,1606,2106,2016-08-09 23:00:00,586,111064,110529
"1673",14088,2016-08-10 00:00:00,587,415,415,0,0,0,2016-08-10 00:00:00,587,429,1163,452,1615,2044,2016-08-10 00:00:00,587,107526,106969
"1674",14089,2016-08-10 01:00:00,587,343,343,0,0,0,2016-08-10 01:00:00,587,399,985,375,1360,1759,2016-08-10 01:00:00,587,105338,104773
"1675",14090,2016-08-10 02:00:00,587,291,291,0,0,0,2016-08-10 02:00:00,587,295,793,351,1144,1439,2016-08-10 02:00:00,587,101309,100794
"1676",14091,2016-08-10 03:00:00,587,283,283,0,0,0,2016-08-10 03:00:00,587,230,537,197,734,964,2016-08-10 03:00:00,587,94620,94179
"1677",14092,2016-08-10 04:00:00,587,271,271,0,0,0,2016-08-10 04:00:00,587,146,407,173,580,726,2016-08-10 04:00:00,587,89541,89121
"1678",14093,2016-08-10 05:00:00,587,230,230,0,0,0,2016-08-10 05:00:00,587,103,260,103,363,466,2016-08-10 05:00:00,587,87933,87485
"1679",14094,2016-08-10 06:00:00,587,199,199,0,0,0,2016-08-10 06:00:00,587,84,142,53,195,279,2016-08-10 06:00:00,587,94433,93949
"1680",14095,2016-08-10 07:00:00,587,202,202,0,0,0,2016-08-10 07:00:00,587,47,74,27,101,148,2016-08-10 07:00:00,587,100382,99876
"1681",14096,2016-08-10 08:00:00,587,190,190,0,0,0,2016-08-10 08:00:00,587,56,39,19,58,114,2016-08-10 08:00:00,587,101611,101027
"1682",14097,2016-08-10 09:00:00,587,193,193,0,0,0,2016-08-10 09:00:00,587,52,33,13,46,98,2016-08-10 09:00:00,587,102695,102122
"1683",14098,2016-08-10 10:00:00,587,174,174,0,0,0,2016-08-10 10:00:00,587,72,73,41,114,186,2016-08-10 10:00:00,587,107898,107410
"1684",14099,2016-08-10 11:00:00,587,250,250,0,0,0,2016-08-10 11:00:00,587,126,127,67,194,320,2016-08-10 11:00:00,587,133125,132541
"1685",14100,2016-08-10 12:00:00,587,355,355,0,0,0,2016-08-10 12:00:00,587,238,273,147,420,658,2016-08-10 12:00:00,587,176969,176241
"1686",14101,2016-08-10 13:00:00,587,411,411,0,0,0,2016-08-10 13:00:00,587,461,531,272,803,1264,2016-08-10 13:00:00,587,208080,207247
"1687",14102,2016-08-10 14:00:00,587,552,552,0,0,0,2016-08-10 14:00:00,587,559,654,343,997,1556,2016-08-10 14:00:00,587,217980,216995
"1688",14103,2016-08-10 15:00:00,587,546,546,0,0,0,2016-08-10 15:00:00,587,687,805,415,1220,1907,2016-08-10 15:00:00,587,215491,214479
"1689",14104,2016-08-10 16:00:00,587,520,520,0,0,0,2016-08-10 16:00:00,587,707,829,395,1224,1931,2016-08-10 16:00:00,587,198806,197856
"1690",14105,2016-08-10 17:00:00,587,556,556,0,0,0,2016-08-10 17:00:00,587,749,973,434,1407,2156,2016-08-10 17:00:00,587,196493,195587
"1691",14106,2016-08-10 18:00:00,587,615,615,0,0,0,2016-08-10 18:00:00,587,799,1075,469,1544,2343,2016-08-10 18:00:00,587,197218,196251
"1692",14107,2016-08-10 19:00:00,587,546,546,0,0,0,2016-08-10 19:00:00,587,810,1252,553,1805,2615,2016-08-10 19:00:00,587,188954,188030
"1693",14108,2016-08-10 20:00:00,587,545,545,0,0,0,2016-08-10 20:00:00,587,789,1292,540,1832,2621,2016-08-10 20:00:00,587,174526,173644
"1694",14109,2016-08-10 21:00:00,587,490,490,0,0,0,2016-08-10 21:00:00,587,691,1317,579,1896,2587,2016-08-10 21:00:00,587,147788,147079
"1695",14110,2016-08-10 22:00:00,587,475,475,0,0,0,2016-08-10 22:00:00,587,672,1259,540,1799,2471,2016-08-10 22:00:00,587,126796,126219
"1696",14111,2016-08-10 23:00:00,587,441,441,0,0,0,2016-08-10 23:00:00,587,572,1276,558,1834,2406,2016-08-10 23:00:00,587,113872,113311
"1697",14112,2016-08-11 00:00:00,588,469,469,0,0,0,2016-08-11 00:00:00,588,500,1266,518,1784,2284,2016-08-11 00:00:00,588,111832,111319
"1698",14113,2016-08-11 01:00:00,588,386,386,0,0,0,2016-08-11 01:00:00,588,385,1149,445,1594,1979,2016-08-11 01:00:00,588,115255,114725
"1699",14114,2016-08-11 02:00:00,588,291,291,0,0,0,2016-08-11 02:00:00,588,358,1003,311,1314,1672,2016-08-11 02:00:00,588,108176,107647
"1700",14115,2016-08-11 03:00:00,588,273,273,0,0,0,2016-08-11 03:00:00,588,249,804,233,1037,1286,2016-08-11 03:00:00,588,101146,100684
"1701",14116,2016-08-11 04:00:00,588,263,263,0,0,0,2016-08-11 04:00:00,588,160,639,246,885,1045,2016-08-11 04:00:00,588,96076,95605
"1702",14117,2016-08-11 05:00:00,588,234,234,0,0,0,2016-08-11 05:00:00,588,119,385,152,537,656,2016-08-11 05:00:00,588,94691,94260
"1703",14118,2016-08-11 06:00:00,588,203,203,0,0,0,2016-08-11 06:00:00,588,78,176,59,235,313,2016-08-11 06:00:00,588,101553,101059
"1704",14119,2016-08-11 07:00:00,588,194,194,0,0,0,2016-08-11 07:00:00,588,59,98,36,134,193,2016-08-11 07:00:00,588,106033,105510
"1705",14120,2016-08-11 08:00:00,588,183,183,0,0,0,2016-08-11 08:00:00,588,57,59,27,86,143,2016-08-11 08:00:00,588,105185,104654
"1706",14121,2016-08-11 09:00:00,588,161,161,0,0,0,2016-08-11 09:00:00,588,44,64,20,84,128,2016-08-11 09:00:00,588,106958,106434
"1707",14122,2016-08-11 10:00:00,588,177,177,0,0,0,2016-08-11 10:00:00,588,67,81,41,122,189,2016-08-11 10:00:00,588,118233,117716
"1708",14123,2016-08-11 11:00:00,588,228,228,0,0,0,2016-08-11 11:00:00,588,119,170,96,266,385,2016-08-11 11:00:00,588,165924,165311
"1709",14124,2016-08-11 12:00:00,588,272,272,0,0,0,2016-08-11 12:00:00,588,291,420,220,640,931,2016-08-11 12:00:00,588,243620,242832
"1710",14125,2016-08-11 13:00:00,588,319,319,0,0,0,2016-08-11 13:00:00,588,493,614,336,950,1443,2016-08-11 13:00:00,588,280682,279739
"1711",14126,2016-08-11 14:00:00,588,462,462,0,0,0,2016-08-11 14:00:00,588,569,757,364,1121,1690,2016-08-11 14:00:00,588,276904,275896
"1712",14127,2016-08-11 15:00:00,588,483,483,0,0,0,2016-08-11 15:00:00,588,736,923,399,1322,2058,2016-08-11 15:00:00,588,265327,264317
"1713",14128,2016-08-11 16:00:00,588,473,473,0,0,0,2016-08-11 16:00:00,588,727,1203,517,1720,2447,2016-08-11 16:00:00,588,237492,236481
"1714",14129,2016-08-11 17:00:00,588,478,478,0,0,0,2016-08-11 17:00:00,588,750,1304,576,1880,2630,2016-08-11 17:00:00,588,225444,224548
"1715",14130,2016-08-11 18:00:00,588,524,524,0,0,0,2016-08-11 18:00:00,588,840,1386,589,1975,2815,2016-08-11 18:00:00,588,221606,220775
"1716",14131,2016-08-11 19:00:00,588,442,442,0,0,0,2016-08-11 19:00:00,588,827,1409,612,2021,2848,2016-08-11 19:00:00,588,211678,210763
"1717",14132,2016-08-11 20:00:00,588,426,426,0,0,0,2016-08-11 20:00:00,588,789,1547,675,2222,3011,2016-08-11 20:00:00,588,193853,193026
"1718",14133,2016-08-11 21:00:00,588,440,440,0,0,0,2016-08-11 21:00:00,588,702,1617,694,2311,3013,2016-08-11 21:00:00,588,161591,160885
"1719",14134,2016-08-11 22:00:00,588,414,414,0,0,0,2016-08-11 22:00:00,588,570,1673,694,2367,2937,2016-08-11 22:00:00,588,132356,131771
"1720",14135,2016-08-11 23:00:00,588,399,399,0,0,0,2016-08-11 23:00:00,588,538,1550,665,2215,2753,2016-08-11 23:00:00,588,116171,115657
"1721",14136,2016-08-12 00:00:00,589,363,363,0,0,0,2016-08-12 00:00:00,589,502,1409,569,1978,2480,2016-08-12 00:00:00,589,109973,109493
"1722",14137,2016-08-12 01:00:00,589,362,362,0,0,0,2016-08-12 01:00:00,589,416,1258,520,1778,2194,2016-08-12 01:00:00,589,108777,108257
"1723",14138,2016-08-12 02:00:00,589,317,317,0,0,0,2016-08-12 02:00:00,589,317,1085,441,1526,1843,2016-08-12 02:00:00,589,99626,99140
"1724",14139,2016-08-12 03:00:00,589,287,287,0,0,0,2016-08-12 03:00:00,589,202,821,328,1149,1351,2016-08-12 03:00:00,589,92008,91578
"1725",14140,2016-08-12 04:00:00,589,203,203,0,0,0,2016-08-12 04:00:00,589,154,547,237,784,938,2016-08-12 04:00:00,589,84690,84304
"1726",14141,2016-08-12 05:00:00,589,186,186,0,0,0,2016-08-12 05:00:00,589,98,249,115,364,462,2016-08-12 05:00:00,589,81231,80821
"1727",14142,2016-08-12 06:00:00,589,211,211,0,0,0,2016-08-12 06:00:00,589,86,156,64,220,306,2016-08-12 06:00:00,589,87061,86615
"1728",14143,2016-08-12 07:00:00,589,197,197,0,0,0,2016-08-12 07:00:00,589,38,78,35,113,151,2016-08-12 07:00:00,589,90314,89852
"1729",14144,2016-08-12 08:00:00,589,182,182,0,0,0,2016-08-12 08:00:00,589,55,64,32,96,151,2016-08-12 08:00:00,589,89864,89363
"1730",14145,2016-08-12 09:00:00,589,168,168,0,0,0,2016-08-12 09:00:00,589,57,41,20,61,118,2016-08-12 09:00:00,589,92213,91729
"1731",14146,2016-08-12 10:00:00,589,129,129,0,0,0,2016-08-12 10:00:00,589,70,70,42,112,182,2016-08-12 10:00:00,589,101125,100668
"1732",14147,2016-08-12 11:00:00,589,149,149,0,0,0,2016-08-12 11:00:00,589,129,187,104,291,420,2016-08-12 11:00:00,589,142388,141896
"1733",14148,2016-08-12 12:00:00,589,232,232,0,0,0,2016-08-12 12:00:00,589,272,327,189,516,788,2016-08-12 12:00:00,589,202904,202296
"1734",14149,2016-08-12 13:00:00,589,265,265,0,0,0,2016-08-12 13:00:00,589,455,582,312,894,1349,2016-08-12 13:00:00,589,229492,228715
"1735",14150,2016-08-12 14:00:00,589,318,318,0,0,0,2016-08-12 14:00:00,589,511,723,371,1094,1605,2016-08-12 14:00:00,589,227118,226229
"1736",14151,2016-08-12 15:00:00,589,351,351,0,0,0,2016-08-12 15:00:00,589,660,917,465,1382,2042,2016-08-12 15:00:00,589,220739,219907
"1737",14152,2016-08-12 16:00:00,589,439,439,0,0,0,2016-08-12 16:00:00,589,697,1050,506,1556,2253,2016-08-12 16:00:00,589,197300,196474
"1738",14153,2016-08-12 17:00:00,589,456,456,0,0,0,2016-08-12 17:00:00,589,719,1265,570,1835,2554,2016-08-12 17:00:00,589,189516,188714
"1739",14154,2016-08-12 18:00:00,589,411,411,0,0,0,2016-08-12 18:00:00,589,799,1228,565,1793,2592,2016-08-12 18:00:00,589,185024,184172
"1740",14155,2016-08-12 19:00:00,589,407,407,0,0,0,2016-08-12 19:00:00,589,768,1410,592,2002,2770,2016-08-12 19:00:00,589,175177,174367
"1741",14156,2016-08-12 20:00:00,589,426,426,0,0,0,2016-08-12 20:00:00,589,749,1510,648,2158,2907,2016-08-12 20:00:00,589,158939,158250
"1742",14157,2016-08-12 21:00:00,589,337,337,0,0,0,2016-08-12 21:00:00,589,623,1489,679,2168,2791,2016-08-12 21:00:00,589,133646,133033
"1743",14158,2016-08-12 22:00:00,589,392,392,0,0,0,2016-08-12 22:00:00,589,588,1445,605,2050,2638,2016-08-12 22:00:00,589,109775,109273
"1744",14159,2016-08-12 23:00:00,589,354,354,0,0,0,2016-08-12 23:00:00,589,493,1346,565,1911,2404,2016-08-12 23:00:00,589,95902,95457
"1745",14160,2016-08-13 00:00:00,590,361,361,0,0,0,2016-08-13 00:00:00,590,446,1283,508,1791,2237,2016-08-13 00:00:00,590,89236,88774
"1746",14161,2016-08-13 01:00:00,590,245,245,0,0,0,2016-08-13 01:00:00,590,341,1219,474,1693,2034,2016-08-13 01:00:00,590,84310,83875
"1747",14162,2016-08-13 02:00:00,590,230,230,0,0,0,2016-08-13 02:00:00,590,307,943,379,1322,1629,2016-08-13 02:00:00,590,81564,81159
"1748",14163,2016-08-13 03:00:00,590,246,246,0,0,0,2016-08-13 03:00:00,590,209,786,335,1121,1330,2016-08-13 03:00:00,590,77252,76862
"1749",14164,2016-08-13 04:00:00,590,243,243,0,0,0,2016-08-13 04:00:00,590,170,555,201,756,926,2016-08-13 04:00:00,590,72312,71959
"1750",14165,2016-08-13 05:00:00,590,199,199,0,0,0,2016-08-13 05:00:00,590,122,317,137,454,576,2016-08-13 05:00:00,590,66733,66434
"1751",14166,2016-08-13 06:00:00,590,198,198,0,0,0,2016-08-13 06:00:00,590,83,196,76,272,355,2016-08-13 06:00:00,590,64579,64240
"1752",14167,2016-08-13 07:00:00,590,189,189,0,0,0,2016-08-13 07:00:00,590,86,86,38,124,210,2016-08-13 07:00:00,590,63701,63375
"1753",14168,2016-08-13 08:00:00,590,178,178,0,0,0,2016-08-13 08:00:00,590,60,69,34,103,163,2016-08-13 08:00:00,590,62035,61700
"1754",14169,2016-08-13 09:00:00,590,149,149,0,0,0,2016-08-13 09:00:00,590,63,60,31,91,154,2016-08-13 09:00:00,590,62973,62611
"1755",14170,2016-08-13 10:00:00,590,102,102,0,0,0,2016-08-13 10:00:00,590,82,65,34,99,181,2016-08-13 10:00:00,590,67608,67268
"1756",14171,2016-08-13 11:00:00,590,150,150,0,0,0,2016-08-13 11:00:00,590,120,124,64,188,308,2016-08-13 11:00:00,590,79823,79477
"1757",14172,2016-08-13 12:00:00,590,185,185,0,0,0,2016-08-13 12:00:00,590,247,305,153,458,705,2016-08-13 12:00:00,590,92468,92062
"1758",14173,2016-08-13 13:00:00,590,201,201,0,0,0,2016-08-13 13:00:00,590,403,520,285,805,1208,2016-08-13 13:00:00,590,104289,103820
"1759",14174,2016-08-13 14:00:00,590,278,278,0,0,0,2016-08-13 14:00:00,590,540,796,376,1172,1712,2016-08-13 14:00:00,590,113314,112775
"1760",14175,2016-08-13 15:00:00,590,208,208,0,0,0,2016-08-13 15:00:00,590,680,869,385,1254,1934,2016-08-13 15:00:00,590,114398,113847
"1761",14176,2016-08-13 16:00:00,590,310,310,0,0,0,2016-08-13 16:00:00,590,552,999,472,1471,2023,2016-08-13 16:00:00,590,112282,111689
"1762",14177,2016-08-13 17:00:00,590,222,222,0,0,0,2016-08-13 17:00:00,590,582,1138,474,1612,2194,2016-08-13 17:00:00,590,109580,109031
"1763",14178,2016-08-13 18:00:00,590,302,302,0,0,0,2016-08-13 18:00:00,590,572,1212,512,1724,2296,2016-08-13 18:00:00,590,106246,105723
"1764",14179,2016-08-13 19:00:00,590,283,283,0,0,0,2016-08-13 19:00:00,590,579,1231,528,1759,2338,2016-08-13 19:00:00,590,102113,101605
"1765",14180,2016-08-13 20:00:00,590,270,270,0,0,0,2016-08-13 20:00:00,590,518,1318,545,1863,2381,2016-08-13 20:00:00,590,95835,95309
"1766",14181,2016-08-13 21:00:00,590,200,200,0,0,0,2016-08-13 21:00:00,590,444,1192,453,1645,2089,2016-08-13 21:00:00,590,89368,88926
"1767",14182,2016-08-13 22:00:00,590,259,259,0,0,0,2016-08-13 22:00:00,590,426,1156,441,1597,2023,2016-08-13 22:00:00,590,81988,81544
"1768",14183,2016-08-13 23:00:00,590,284,284,0,0,0,2016-08-13 23:00:00,590,398,1199,492,1691,2089,2016-08-13 23:00:00,590,77116,76734
"1769",14184,2016-08-14 00:00:00,591,274,274,0,0,0,2016-08-14 00:00:00,591,330,1114,447,1561,1891,2016-08-14 00:00:00,591,76698,76312
"1770",14185,2016-08-14 01:00:00,591,281,281,0,0,0,2016-08-14 01:00:00,591,299,960,388,1348,1647,2016-08-14 01:00:00,591,85230,84863
"1771",14186,2016-08-14 02:00:00,591,317,317,0,0,0,2016-08-14 02:00:00,591,246,794,285,1079,1325,2016-08-14 02:00:00,591,72803,72415
"1772",14187,2016-08-14 03:00:00,591,276,276,0,0,0,2016-08-14 03:00:00,591,212,575,212,787,999,2016-08-14 03:00:00,591,77238,76886
"1773",14188,2016-08-14 04:00:00,591,195,195,0,0,0,2016-08-14 04:00:00,591,101,371,153,524,625,2016-08-14 04:00:00,591,72355,72018
"1774",14189,2016-08-14 05:00:00,591,203,203,0,0,0,2016-08-14 05:00:00,591,90,258,95,353,443,2016-08-14 05:00:00,591,67647,67341
"1775",14190,2016-08-14 06:00:00,591,176,176,0,0,0,2016-08-14 06:00:00,591,72,171,63,234,306,2016-08-14 06:00:00,591,64148,63845
"1776",14191,2016-08-14 07:00:00,591,178,178,0,0,0,2016-08-14 07:00:00,591,48,72,30,102,150,2016-08-14 07:00:00,591,62932,62607
"1777",14192,2016-08-14 08:00:00,591,169,169,0,0,0,2016-08-14 08:00:00,591,33,49,17,66,99,2016-08-14 08:00:00,591,62130,61843
"1778",14193,2016-08-14 09:00:00,591,160,160,0,0,0,2016-08-14 09:00:00,591,38,26,6,32,70,2016-08-14 09:00:00,591,62330,62005
"1779",14194,2016-08-14 10:00:00,591,152,152,0,0,0,2016-08-14 10:00:00,591,51,44,23,67,118,2016-08-14 10:00:00,591,65193,64900
"1780",14195,2016-08-14 11:00:00,591,187,187,0,0,0,2016-08-14 11:00:00,591,88,82,47,129,217,2016-08-14 11:00:00,591,72951,72620
"1781",14196,2016-08-14 12:00:00,591,218,218,0,0,0,2016-08-14 12:00:00,591,108,216,100,316,424,2016-08-14 12:00:00,591,82277,81874
"1782",14197,2016-08-14 13:00:00,591,330,330,0,0,0,2016-08-14 13:00:00,591,166,405,214,619,785,2016-08-14 13:00:00,591,93296,92881
"1783",14198,2016-08-14 14:00:00,591,358,358,0,0,0,2016-08-14 14:00:00,591,265,686,325,1011,1276,2016-08-14 14:00:00,591,99787,99320
"1784",14199,2016-08-14 15:00:00,591,245,245,0,0,0,2016-08-14 15:00:00,591,358,825,380,1205,1563,2016-08-14 15:00:00,591,104552,104020
"1785",14200,2016-08-14 16:00:00,591,342,342,0,0,0,2016-08-14 16:00:00,591,420,957,448,1405,1825,2016-08-14 16:00:00,591,105891,105372
"1786",14201,2016-08-14 17:00:00,591,352,352,0,0,0,2016-08-14 17:00:00,591,448,1058,451,1509,1957,2016-08-14 17:00:00,591,106141,105594
"1787",14202,2016-08-14 18:00:00,591,342,342,0,0,0,2016-08-14 18:00:00,591,487,1050,430,1480,1967,2016-08-14 18:00:00,591,107499,106888
"1788",14203,2016-08-14 19:00:00,591,272,272,0,0,0,2016-08-14 19:00:00,591,491,1095,421,1516,2007,2016-08-14 19:00:00,591,104892,104326
"1789",14204,2016-08-14 20:00:00,591,246,246,0,0,0,2016-08-14 20:00:00,591,432,1122,471,1593,2025,2016-08-14 20:00:00,591,99875,99352
"1790",14205,2016-08-14 21:00:00,591,261,261,0,0,0,2016-08-14 21:00:00,591,479,1134,472,1606,2085,2016-08-14 21:00:00,591,94331,93824
"1791",14206,2016-08-14 22:00:00,591,319,319,0,0,0,2016-08-14 22:00:00,591,373,1125,407,1532,1905,2016-08-14 22:00:00,591,90849,90403
"1792",14207,2016-08-14 23:00:00,591,319,319,0,0,0,2016-08-14 23:00:00,591,352,1049,425,1474,1826,2016-08-14 23:00:00,591,90219,89769
"1793",14208,2016-08-15 00:00:00,592,362,362,0,0,0,2016-08-15 00:00:00,592,342,1023,425,1448,1790,2016-08-15 00:00:00,592,103807,103348
"1794",14209,2016-08-15 01:00:00,592,290,290,0,0,0,2016-08-15 01:00:00,592,279,816,318,1134,1413,2016-08-15 01:00:00,592,107420,106951
"1795",14210,2016-08-15 02:00:00,592,258,258,0,0,0,2016-08-15 02:00:00,592,224,633,251,884,1108,2016-08-15 02:00:00,592,98924,98484
"1796",14211,2016-08-15 03:00:00,592,212,212,0,0,0,2016-08-15 03:00:00,592,160,457,192,649,809,2016-08-15 03:00:00,592,90313,89852
"1797",14212,2016-08-15 04:00:00,592,258,258,0,0,0,2016-08-15 04:00:00,592,84,315,115,430,514,2016-08-15 04:00:00,592,81002,80640
"1798",14213,2016-08-15 05:00:00,592,218,218,0,0,0,2016-08-15 05:00:00,592,76,172,57,229,305,2016-08-15 05:00:00,592,79125,78748
"1799",14214,2016-08-15 06:00:00,592,174,174,0,0,0,2016-08-15 06:00:00,592,64,113,46,159,223,2016-08-15 06:00:00,592,86997,86585
"1800",14215,2016-08-15 07:00:00,592,2,2,0,0,0,2016-08-15 07:00:00,592,50,68,28,96,146,2016-08-15 07:00:00,592,89955,89523
"1801",14216,2016-08-15 08:00:00,592,89,89,0,0,0,2016-08-15 08:00:00,592,38,39,18,57,95,2016-08-15 08:00:00,592,89558,89102
"1802",14217,2016-08-15 09:00:00,592,163,163,0,0,0,2016-08-15 09:00:00,592,42,39,17,56,98,2016-08-15 09:00:00,592,91768,91334
"1803",14218,2016-08-15 10:00:00,592,185,185,0,0,0,2016-08-15 10:00:00,592,66,70,30,100,166,2016-08-15 10:00:00,592,115485,115038
"1804",14219,2016-08-15 11:00:00,592,222,222,0,0,0,2016-08-15 11:00:00,592,112,130,77,207,319,2016-08-15 11:00:00,592,213674,213184
"1805",14220,2016-08-15 12:00:00,592,307,307,0,0,0,2016-08-15 12:00:00,592,246,306,172,478,724,2016-08-15 12:00:00,592,315162,314485
"1806",14221,2016-08-15 13:00:00,592,356,356,0,0,0,2016-08-15 13:00:00,592,469,618,359,977,1446,2016-08-15 13:00:00,592,337535,336755
"1807",14222,2016-08-15 14:00:00,592,419,419,0,0,0,2016-08-15 14:00:00,592,559,806,426,1232,1791,2016-08-15 14:00:00,592,307593,306691
"1808",14223,2016-08-15 15:00:00,592,444,444,0,0,0,2016-08-15 15:00:00,592,679,1067,540,1607,2286,2016-08-15 15:00:00,592,284724,283737
"1809",14224,2016-08-15 16:00:00,592,497,497,0,0,0,2016-08-15 16:00:00,592,774,1039,515,1554,2328,2016-08-15 16:00:00,592,253508,252610
"1810",14225,2016-08-15 17:00:00,592,542,542,0,0,0,2016-08-15 17:00:00,592,734,1269,628,1897,2631,2016-08-15 17:00:00,592,228359,227458
"1811",14226,2016-08-15 18:00:00,592,525,525,0,0,0,2016-08-15 18:00:00,592,867,1303,604,1907,2774,2016-08-15 18:00:00,592,222911,221990
"1812",14227,2016-08-15 19:00:00,592,392,392,0,0,0,2016-08-15 19:00:00,592,791,1539,680,2219,3010,2016-08-15 19:00:00,592,210263,209413
"1813",14228,2016-08-15 20:00:00,592,378,378,0,0,0,2016-08-15 20:00:00,592,764,1539,727,2266,3030,2016-08-15 20:00:00,592,190850,190030
"1814",14229,2016-08-15 21:00:00,592,410,410,0,0,0,2016-08-15 21:00:00,592,716,1504,689,2193,2909,2016-08-15 21:00:00,592,151891,151303
"1815",14230,2016-08-15 22:00:00,592,512,512,0,0,0,2016-08-15 22:00:00,592,669,1485,648,2133,2802,2016-08-15 22:00:00,592,129930,129354
"1816",14231,2016-08-15 23:00:00,592,439,439,0,0,0,2016-08-15 23:00:00,592,590,1366,578,1944,2534,2016-08-15 23:00:00,592,115551,115018
"1817",14232,2016-08-16 00:00:00,593,410,410,0,0,0,2016-08-16 00:00:00,593,532,1327,517,1844,2376,2016-08-16 00:00:00,593,111349,110852
"1818",14233,2016-08-16 01:00:00,593,357,357,0,0,0,2016-08-16 01:00:00,593,402,1164,453,1617,2019,2016-08-16 01:00:00,593,110817,110267
"1819",14234,2016-08-16 02:00:00,593,287,287,0,0,0,2016-08-16 02:00:00,593,335,875,344,1219,1554,2016-08-16 02:00:00,593,102848,102361
"1820",14235,2016-08-16 03:00:00,593,307,307,0,0,0,2016-08-16 03:00:00,593,293,650,283,933,1226,2016-08-16 03:00:00,593,98202,97752
"1821",14236,2016-08-16 04:00:00,593,282,282,0,0,0,2016-08-16 04:00:00,593,218,397,173,570,788,2016-08-16 04:00:00,593,92616,92210
"1822",14237,2016-08-16 05:00:00,593,223,223,0,0,0,2016-08-16 05:00:00,593,121,200,85,285,406,2016-08-16 05:00:00,593,90316,89889
"1823",14238,2016-08-16 06:00:00,593,187,187,0,0,0,2016-08-16 06:00:00,593,70,111,42,153,223,2016-08-16 06:00:00,593,94920,94469
"1824",14239,2016-08-16 07:00:00,593,210,210,0,0,0,2016-08-16 07:00:00,593,60,61,28,89,149,2016-08-16 07:00:00,593,96430,95924
"1825",14240,2016-08-16 08:00:00,593,203,203,0,0,0,2016-08-16 08:00:00,593,33,54,24,78,111,2016-08-16 08:00:00,593,96020,95520
"1826",14241,2016-08-16 09:00:00,593,195,195,0,0,0,2016-08-16 09:00:00,593,42,24,9,33,75,2016-08-16 09:00:00,593,97113,96606
"1827",14242,2016-08-16 10:00:00,593,188,188,0,0,0,2016-08-16 10:00:00,593,47,61,35,96,143,2016-08-16 10:00:00,593,104191,103723
"1828",14243,2016-08-16 11:00:00,593,234,234,0,0,0,2016-08-16 11:00:00,593,121,106,68,174,295,2016-08-16 11:00:00,593,141266,140734
"1829",14244,2016-08-16 12:00:00,593,309,309,0,0,0,2016-08-16 12:00:00,593,276,295,170,465,741,2016-08-16 12:00:00,593,198443,197770
"1830",14245,2016-08-16 13:00:00,593,408,408,0,0,0,2016-08-16 13:00:00,593,472,527,271,798,1270,2016-08-16 13:00:00,593,228918,228137
"1831",14246,2016-08-16 14:00:00,593,387,387,0,0,0,2016-08-16 14:00:00,593,589,670,351,1021,1610,2016-08-16 14:00:00,593,233022,232062
"1832",14247,2016-08-16 15:00:00,593,465,465,0,0,0,2016-08-16 15:00:00,593,675,880,468,1348,2023,2016-08-16 15:00:00,593,225235,224319
"1833",14248,2016-08-16 16:00:00,593,519,519,0,0,0,2016-08-16 16:00:00,593,741,1017,490,1507,2248,2016-08-16 16:00:00,593,202730,201877
"1834",14249,2016-08-16 17:00:00,593,563,563,0,0,0,2016-08-16 17:00:00,593,751,1112,509,1621,2372,2016-08-16 17:00:00,593,199171,198326
"1835",14250,2016-08-16 18:00:00,593,528,528,0,0,0,2016-08-16 18:00:00,593,837,1145,516,1661,2498,2016-08-16 18:00:00,593,198494,197536
"1836",14251,2016-08-16 19:00:00,593,512,512,0,0,0,2016-08-16 19:00:00,593,832,1216,538,1754,2586,2016-08-16 19:00:00,593,190351,189492
"1837",14252,2016-08-16 20:00:00,593,433,433,0,0,0,2016-08-16 20:00:00,593,781,1398,584,1982,2763,2016-08-16 20:00:00,593,175439,174686
"1838",14253,2016-08-16 21:00:00,593,512,512,0,0,0,2016-08-16 21:00:00,593,719,1347,568,1915,2634,2016-08-16 21:00:00,593,148326,147595
"1839",14254,2016-08-16 22:00:00,593,464,464,0,0,0,2016-08-16 22:00:00,593,647,1342,585,1927,2574,2016-08-16 22:00:00,593,122934,122336
"1840",14255,2016-08-16 23:00:00,593,446,446,0,0,0,2016-08-16 23:00:00,593,543,1347,587,1934,2477,2016-08-16 23:00:00,593,111698,111129
"1841",14256,2016-08-17 00:00:00,594,416,416,0,0,0,2016-08-17 00:00:00,594,485,1328,554,1882,2367,2016-08-17 00:00:00,594,105723,105227
"1842",14257,2016-08-17 01:00:00,594,331,331,0,0,0,2016-08-17 01:00:00,594,398,1132,441,1573,1971,2016-08-17 01:00:00,594,105277,104760
"1843",14258,2016-08-17 02:00:00,594,265,265,0,0,0,2016-08-17 02:00:00,594,314,917,369,1286,1600,2016-08-17 02:00:00,594,98709,98208
"1844",14259,2016-08-17 03:00:00,594,252,252,0,0,0,2016-08-17 03:00:00,594,253,649,244,893,1146,2016-08-17 03:00:00,594,92310,91864
"1845",14260,2016-08-17 04:00:00,594,258,258,0,0,0,2016-08-17 04:00:00,594,158,393,144,537,695,2016-08-17 04:00:00,594,87553,87174
"1846",14261,2016-08-17 05:00:00,594,216,216,0,0,0,2016-08-17 05:00:00,594,121,222,73,295,416,2016-08-17 05:00:00,594,86232,85821
"1847",14262,2016-08-17 06:00:00,594,173,173,0,0,0,2016-08-17 06:00:00,594,74,92,34,126,200,2016-08-17 06:00:00,594,92433,91971
"1848",14263,2016-08-17 07:00:00,594,243,243,0,0,0,2016-08-17 07:00:00,594,73,44,12,56,129,2016-08-17 07:00:00,594,94611,94117
"1849",14264,2016-08-17 08:00:00,594,224,224,0,0,0,2016-08-17 08:00:00,594,42,47,15,62,104,2016-08-17 08:00:00,594,95262,94700
"1850",14265,2016-08-17 09:00:00,594,189,189,0,0,0,2016-08-17 09:00:00,594,38,32,16,48,86,2016-08-17 09:00:00,594,96169,95663
"1851",14266,2016-08-17 10:00:00,594,195,195,0,0,0,2016-08-17 10:00:00,594,63,58,27,85,148,2016-08-17 10:00:00,594,101574,101075
"1852",14267,2016-08-17 11:00:00,594,277,277,0,0,0,2016-08-17 11:00:00,594,115,134,75,209,324,2016-08-17 11:00:00,594,127148,126589
"1853",14268,2016-08-17 12:00:00,594,342,342,0,0,0,2016-08-17 12:00:00,594,224,267,152,419,643,2016-08-17 12:00:00,594,168110,167438
"1854",14269,2016-08-17 13:00:00,594,401,401,0,0,0,2016-08-17 13:00:00,594,408,514,283,797,1205,2016-08-17 13:00:00,594,199928,199094
"1855",14270,2016-08-17 14:00:00,594,521,521,0,0,0,2016-08-17 14:00:00,594,579,617,303,920,1499,2016-08-17 14:00:00,594,210139,209195
"1856",14271,2016-08-17 15:00:00,594,501,501,0,0,0,2016-08-17 15:00:00,594,648,746,368,1114,1762,2016-08-17 15:00:00,594,207356,206436
"1857",14272,2016-08-17 16:00:00,594,479,479,0,0,0,2016-08-17 16:00:00,594,743,1724,661,2385,3128,2016-08-17 16:00:00,594,192062,191263
"1858",14273,2016-08-17 17:00:00,594,527,527,0,0,0,2016-08-17 17:00:00,594,751,3246,928,4174,4925,2016-08-17 17:00:00,594,195025,194091
"1859",14274,2016-08-17 18:00:00,594,546,546,0,0,0,2016-08-17 18:00:00,594,748,2602,748,3350,4098,2016-08-17 18:00:00,594,191924,191058
"1860",14275,2016-08-17 19:00:00,594,449,449,0,0,0,2016-08-17 19:00:00,594,780,1716,589,2305,3085,2016-08-17 19:00:00,594,182042,181163
"1861",14276,2016-08-17 20:00:00,594,434,434,0,0,0,2016-08-17 20:00:00,594,783,1332,596,1928,2711,2016-08-17 20:00:00,594,167207,166449
"1862",14277,2016-08-17 21:00:00,594,435,435,0,0,0,2016-08-17 21:00:00,594,696,1213,514,1727,2423,2016-08-17 21:00:00,594,146834,146193
"1863",14278,2016-08-17 22:00:00,594,439,439,0,0,0,2016-08-17 22:00:00,594,652,1376,559,1935,2587,2016-08-17 22:00:00,594,118951,118416
"1864",14279,2016-08-17 23:00:00,594,431,431,0,0,0,2016-08-17 23:00:00,594,537,1375,558,1933,2470,2016-08-17 23:00:00,594,108683,108220
"1865",14280,2016-08-18 00:00:00,595,457,457,0,0,0,2016-08-18 00:00:00,595,497,1279,526,1805,2302,2016-08-18 00:00:00,595,109902,109423
"1866",14281,2016-08-18 01:00:00,595,288,288,0,0,0,2016-08-18 01:00:00,595,450,1230,497,1727,2177,2016-08-18 01:00:00,595,109200,108679
"1867",14282,2016-08-18 02:00:00,595,282,282,0,0,0,2016-08-18 02:00:00,595,331,871,334,1205,1536,2016-08-18 02:00:00,595,104154,103649
"1868",14283,2016-08-18 03:00:00,595,261,261,0,0,0,2016-08-18 03:00:00,595,230,674,243,917,1147,2016-08-18 03:00:00,595,94564,94103
"1869",14284,2016-08-18 04:00:00,595,254,254,0,0,0,2016-08-18 04:00:00,595,168,468,159,627,795,2016-08-18 04:00:00,595,86325,85900
"1870",14285,2016-08-18 05:00:00,595,221,221,0,0,0,2016-08-18 05:00:00,595,122,197,73,270,392,2016-08-18 05:00:00,595,83397,83036
"1871",14286,2016-08-18 06:00:00,595,122,122,0,0,0,2016-08-18 06:00:00,595,80,113,41,154,234,2016-08-18 06:00:00,595,90285,89810
"1872",14287,2016-08-18 07:00:00,595,168,168,0,0,0,2016-08-18 07:00:00,595,46,71,21,92,138,2016-08-18 07:00:00,595,94376,93884
"1873",14288,2016-08-18 08:00:00,595,170,170,0,0,0,2016-08-18 08:00:00,595,55,58,20,78,133,2016-08-18 08:00:00,595,93957,93461
"1874",14289,2016-08-18 09:00:00,595,184,184,0,0,0,2016-08-18 09:00:00,595,51,29,8,37,88,2016-08-18 09:00:00,595,95856,95332
"1875",14290,2016-08-18 10:00:00,595,194,194,0,0,0,2016-08-18 10:00:00,595,60,64,27,91,151,2016-08-18 10:00:00,595,105435,104969
"1876",14291,2016-08-18 11:00:00,595,208,208,0,0,0,2016-08-18 11:00:00,595,104,140,69,209,313,2016-08-18 11:00:00,595,149810,149266
"1877",14292,2016-08-18 12:00:00,595,277,277,0,0,0,2016-08-18 12:00:00,595,275,286,130,416,691,2016-08-18 12:00:00,595,223310,222653
"1878",14293,2016-08-18 13:00:00,595,295,295,0,0,0,2016-08-18 13:00:00,595,431,502,247,749,1180,2016-08-18 13:00:00,595,259922,259057
"1879",14294,2016-08-18 14:00:00,595,394,394,0,0,0,2016-08-18 14:00:00,595,541,646,278,924,1465,2016-08-18 14:00:00,595,259118,258161
"1880",14295,2016-08-18 15:00:00,595,422,422,0,0,0,2016-08-18 15:00:00,595,638,802,371,1173,1811,2016-08-18 15:00:00,595,258827,257919
"1881",14296,2016-08-18 16:00:00,595,411,411,0,0,0,2016-08-18 16:00:00,595,700,980,420,1400,2100,2016-08-18 16:00:00,595,225535,224623
"1882",14297,2016-08-18 17:00:00,595,476,476,0,0,0,2016-08-18 17:00:00,595,745,1098,486,1584,2329,2016-08-18 17:00:00,595,218322,217474
"1883",14298,2016-08-18 18:00:00,595,467,467,0,0,0,2016-08-18 18:00:00,595,807,1104,487,1591,2398,2016-08-18 18:00:00,595,215002,214162
"1884",14299,2016-08-18 19:00:00,595,391,391,0,0,0,2016-08-18 19:00:00,595,790,1161,457,1618,2408,2016-08-18 19:00:00,595,202972,202122
"1885",14300,2016-08-18 20:00:00,595,408,408,0,0,0,2016-08-18 20:00:00,595,765,1262,547,1809,2574,2016-08-18 20:00:00,595,186567,185814
"1886",14301,2016-08-18 21:00:00,595,370,370,0,0,0,2016-08-18 21:00:00,595,669,1202,535,1737,2406,2016-08-18 21:00:00,595,161138,160499
"1887",14302,2016-08-18 22:00:00,595,382,382,0,0,0,2016-08-18 22:00:00,595,615,1201,521,1722,2337,2016-08-18 22:00:00,595,125918,125379
"1888",14303,2016-08-18 23:00:00,595,346,346,0,0,0,2016-08-18 23:00:00,595,600,1260,501,1761,2361,2016-08-18 23:00:00,595,110521,110037
"1889",14304,2016-08-19 00:00:00,596,333,333,0,0,0,2016-08-19 00:00:00,596,484,1196,462,1658,2142,2016-08-19 00:00:00,596,105109,104652
"1890",14305,2016-08-19 01:00:00,596,381,381,0,0,0,2016-08-19 01:00:00,596,373,1077,402,1479,1852,2016-08-19 01:00:00,596,105196,104701
"1891",14306,2016-08-19 02:00:00,596,334,334,0,0,0,2016-08-19 02:00:00,596,287,835,303,1138,1425,2016-08-19 02:00:00,596,99369,98910
"1892",14307,2016-08-19 03:00:00,596,267,267,0,0,0,2016-08-19 03:00:00,596,262,600,219,819,1081,2016-08-19 03:00:00,596,90877,90463
"1893",14308,2016-08-19 04:00:00,596,288,288,0,0,0,2016-08-19 04:00:00,596,163,405,144,549,712,2016-08-19 04:00:00,596,82393,82057
"1894",14309,2016-08-19 05:00:00,596,209,209,0,0,0,2016-08-19 05:00:00,596,117,266,95,361,478,2016-08-19 05:00:00,596,78858,78497
"1895",14310,2016-08-19 06:00:00,596,188,188,0,0,0,2016-08-19 06:00:00,596,63,119,45,164,227,2016-08-19 06:00:00,596,85270,84861
"1896",14311,2016-08-19 07:00:00,596,155,155,0,0,0,2016-08-19 07:00:00,596,60,75,31,106,166,2016-08-19 07:00:00,596,86998,86595
"1897",14312,2016-08-19 08:00:00,596,185,185,0,0,0,2016-08-19 08:00:00,596,34,48,18,66,100,2016-08-19 08:00:00,596,86441,86009
"1898",14313,2016-08-19 09:00:00,596,128,128,0,0,0,2016-08-19 09:00:00,596,37,27,11,38,75,2016-08-19 09:00:00,596,89379,88945
"1899",14314,2016-08-19 10:00:00,596,150,150,0,0,0,2016-08-19 10:00:00,596,63,54,25,79,142,2016-08-19 10:00:00,596,99168,98735
"1900",14315,2016-08-19 11:00:00,596,240,240,0,0,0,2016-08-19 11:00:00,596,93,135,73,208,301,2016-08-19 11:00:00,596,138929,138449
"1901",14316,2016-08-19 12:00:00,596,254,254,0,0,0,2016-08-19 12:00:00,596,257,277,154,431,688,2016-08-19 12:00:00,596,199596,198972
"1902",14317,2016-08-19 13:00:00,596,286,286,0,0,0,2016-08-19 13:00:00,596,468,519,263,782,1250,2016-08-19 13:00:00,596,225321,224605
"1903",14318,2016-08-19 14:00:00,596,378,378,0,0,0,2016-08-19 14:00:00,596,503,660,329,989,1492,2016-08-19 14:00:00,596,223869,223010
"1904",14319,2016-08-19 15:00:00,596,364,364,0,0,0,2016-08-19 15:00:00,596,637,780,373,1153,1790,2016-08-19 15:00:00,596,216247,215416
"1905",14320,2016-08-19 16:00:00,596,449,449,0,0,0,2016-08-19 16:00:00,596,662,898,399,1297,1959,2016-08-19 16:00:00,596,194432,193674
"1906",14321,2016-08-19 17:00:00,596,471,471,0,0,0,2016-08-19 17:00:00,596,704,1018,433,1451,2155,2016-08-19 17:00:00,596,185154,184365
"1907",14322,2016-08-19 18:00:00,596,444,444,0,0,0,2016-08-19 18:00:00,596,776,1149,501,1650,2426,2016-08-19 18:00:00,596,182045,181268
"1908",14323,2016-08-19 19:00:00,596,405,405,0,0,0,2016-08-19 19:00:00,596,760,1125,463,1588,2348,2016-08-19 19:00:00,596,172676,171937
"1909",14324,2016-08-19 20:00:00,596,364,364,0,0,0,2016-08-19 20:00:00,596,712,1116,493,1609,2321,2016-08-19 20:00:00,596,155412,154750
"1910",14325,2016-08-19 21:00:00,596,372,372,0,0,0,2016-08-19 21:00:00,596,639,1194,530,1724,2363,2016-08-19 21:00:00,596,128737,128135
"1911",14326,2016-08-19 22:00:00,596,372,372,0,0,0,2016-08-19 22:00:00,596,535,1314,550,1864,2399,2016-08-19 22:00:00,596,105518,105055
"1912",14327,2016-08-19 23:00:00,596,307,307,0,0,0,2016-08-19 23:00:00,596,531,1376,637,2013,2544,2016-08-19 23:00:00,596,92571,92137
"1913",14328,2016-08-20 00:00:00,597,336,336,0,0,0,2016-08-20 00:00:00,597,373,1235,512,1747,2120,2016-08-20 00:00:00,597,84160,83774
"1914",14329,2016-08-20 01:00:00,597,338,338,0,0,0,2016-08-20 01:00:00,597,330,1097,465,1562,1892,2016-08-20 01:00:00,597,80263,79852
"1915",14330,2016-08-20 02:00:00,597,310,310,0,0,0,2016-08-20 02:00:00,597,246,873,362,1235,1481,2016-08-20 02:00:00,597,78552,78177
"1916",14331,2016-08-20 03:00:00,597,258,258,0,0,0,2016-08-20 03:00:00,597,214,674,296,970,1184,2016-08-20 03:00:00,597,74247,73901
"1917",14332,2016-08-20 04:00:00,597,219,219,0,0,0,2016-08-20 04:00:00,597,128,478,186,664,792,2016-08-20 04:00:00,597,69786,69451
"1918",14333,2016-08-20 05:00:00,597,186,186,0,0,0,2016-08-20 05:00:00,597,90,297,101,398,488,2016-08-20 05:00:00,597,65600,65293
"1919",14334,2016-08-20 06:00:00,597,208,208,0,0,0,2016-08-20 06:00:00,597,63,142,40,182,245,2016-08-20 06:00:00,597,62570,62281
"1920",14335,2016-08-20 07:00:00,597,213,213,0,0,0,2016-08-20 07:00:00,597,39,107,48,155,194,2016-08-20 07:00:00,597,60695,60395
"1921",14336,2016-08-20 08:00:00,597,166,166,0,0,0,2016-08-20 08:00:00,597,58,58,21,79,137,2016-08-20 08:00:00,597,59121,58842
"1922",14337,2016-08-20 09:00:00,597,145,145,0,0,0,2016-08-20 09:00:00,597,40,28,8,36,76,2016-08-20 09:00:00,597,59834,59547
"1923",14338,2016-08-20 10:00:00,597,138,138,0,0,0,2016-08-20 10:00:00,597,42,58,27,85,127,2016-08-20 10:00:00,597,63922,63618
"1924",14339,2016-08-20 11:00:00,597,201,201,0,0,0,2016-08-20 11:00:00,597,78,97,50,147,225,2016-08-20 11:00:00,597,75511,75180
"1925",14340,2016-08-20 12:00:00,597,218,218,0,0,0,2016-08-20 12:00:00,597,143,247,122,369,512,2016-08-20 12:00:00,597,86186,85804
"1926",14341,2016-08-20 13:00:00,597,256,256,0,0,0,2016-08-20 13:00:00,597,265,523,242,765,1030,2016-08-20 13:00:00,597,97437,97018
"1927",14342,2016-08-20 14:00:00,597,333,333,0,0,0,2016-08-20 14:00:00,597,353,858,359,1217,1570,2016-08-20 14:00:00,597,106648,106091
"1928",14343,2016-08-20 15:00:00,597,308,308,0,0,0,2016-08-20 15:00:00,597,413,938,413,1351,1764,2016-08-20 15:00:00,597,109807,109259
"1929",14344,2016-08-20 16:00:00,597,314,314,0,0,0,2016-08-20 16:00:00,597,433,1147,503,1650,2083,2016-08-20 16:00:00,597,110322,109795
"1930",14345,2016-08-20 17:00:00,597,359,359,0,0,0,2016-08-20 17:00:00,597,494,1091,496,1587,2081,2016-08-20 17:00:00,597,107424,106923
"1931",14346,2016-08-20 18:00:00,597,426,426,0,0,0,2016-08-20 18:00:00,597,491,1179,483,1662,2153,2016-08-20 18:00:00,597,104682,104178
"1932",14347,2016-08-20 19:00:00,597,323,323,0,0,0,2016-08-20 19:00:00,597,555,1253,518,1771,2326,2016-08-20 19:00:00,597,100985,100434
"1933",14348,2016-08-20 20:00:00,597,294,294,0,0,0,2016-08-20 20:00:00,597,477,1300,535,1835,2312,2016-08-20 20:00:00,597,94057,93587
"1934",14349,2016-08-20 21:00:00,597,299,299,0,0,0,2016-08-20 21:00:00,597,475,1255,521,1776,2251,2016-08-20 21:00:00,597,86989,86521
"1935",14350,2016-08-20 22:00:00,597,304,304,0,0,0,2016-08-20 22:00:00,597,423,1192,465,1657,2080,2016-08-20 22:00:00,597,79550,79145
"1936",14351,2016-08-20 23:00:00,597,284,284,0,0,0,2016-08-20 23:00:00,597,405,1260,471,1731,2136,2016-08-20 23:00:00,597,75019,74622
"1937",14352,2016-08-21 00:00:00,598,299,299,0,0,0,2016-08-21 00:00:00,598,262,1109,455,1564,1826,2016-08-21 00:00:00,598,74984,74592
"1938",14353,2016-08-21 01:00:00,598,338,338,0,0,0,2016-08-21 01:00:00,598,302,1036,402,1438,1740,2016-08-21 01:00:00,598,72723,72345
"1939",14354,2016-08-21 02:00:00,598,293,293,0,0,0,2016-08-21 02:00:00,598,200,775,277,1052,1252,2016-08-21 02:00:00,598,71862,71514
"1940",14355,2016-08-21 03:00:00,598,242,242,0,0,0,2016-08-21 03:00:00,598,173,565,221,786,959,2016-08-21 03:00:00,598,71837,71502
"1941",14356,2016-08-21 04:00:00,598,235,235,0,0,0,2016-08-21 04:00:00,598,130,350,120,470,600,2016-08-21 04:00:00,598,69716,69430
"1942",14357,2016-08-21 05:00:00,598,196,196,0,0,0,2016-08-21 05:00:00,598,78,225,86,311,389,2016-08-21 05:00:00,598,65251,64957
"1943",14358,2016-08-21 06:00:00,598,167,167,0,0,0,2016-08-21 06:00:00,598,69,141,65,206,275,2016-08-21 06:00:00,598,61890,61581
"1944",14359,2016-08-21 07:00:00,598,169,169,0,0,0,2016-08-21 07:00:00,598,83,87,34,121,204,2016-08-21 07:00:00,598,60293,59967
"1945",14360,2016-08-21 08:00:00,598,159,159,0,0,0,2016-08-21 08:00:00,598,36,48,21,69,105,2016-08-21 08:00:00,598,58868,58575
"1946",14361,2016-08-21 09:00:00,598,123,123,0,0,0,2016-08-21 09:00:00,598,30,28,12,40,70,2016-08-21 09:00:00,598,59946,59645
"1947",14362,2016-08-21 10:00:00,598,165,165,0,0,0,2016-08-21 10:00:00,598,37,46,20,66,103,2016-08-21 10:00:00,598,63300,62996
"1948",14363,2016-08-21 11:00:00,598,181,181,0,0,0,2016-08-21 11:00:00,598,59,91,39,130,189,2016-08-21 11:00:00,598,71131,70816
"1949",14364,2016-08-21 12:00:00,598,225,225,0,0,0,2016-08-21 12:00:00,598,114,178,79,257,371,2016-08-21 12:00:00,598,79914,79532
"1950",14365,2016-08-21 13:00:00,598,273,273,0,0,0,2016-08-21 13:00:00,598,233,408,199,607,840,2016-08-21 13:00:00,598,90297,89871
"1951",14366,2016-08-21 14:00:00,598,343,343,0,0,0,2016-08-21 14:00:00,598,273,764,359,1123,1396,2016-08-21 14:00:00,598,97773,97309
"1952",14367,2016-08-21 15:00:00,598,310,310,0,0,0,2016-08-21 15:00:00,598,341,852,387,1239,1580,2016-08-21 15:00:00,598,103464,102940
"1953",14368,2016-08-21 16:00:00,598,341,341,0,0,0,2016-08-21 16:00:00,598,349,995,444,1439,1788,2016-08-21 16:00:00,598,103296,102780
"1954",14369,2016-08-21 17:00:00,598,373,373,0,0,0,2016-08-21 17:00:00,598,439,1073,427,1500,1939,2016-08-21 17:00:00,598,104735,104235
"1955",14370,2016-08-21 18:00:00,598,382,382,0,0,0,2016-08-21 18:00:00,598,440,1090,478,1568,2008,2016-08-21 18:00:00,598,104429,103901
"1956",14371,2016-08-21 19:00:00,598,309,309,0,0,0,2016-08-21 19:00:00,598,449,1214,495,1709,2158,2016-08-21 19:00:00,598,102766,102216
"1957",14372,2016-08-21 20:00:00,598,269,269,0,0,0,2016-08-21 20:00:00,598,433,1111,466,1577,2010,2016-08-21 20:00:00,598,98669,98167
"1958",14373,2016-08-21 21:00:00,598,254,254,0,0,0,2016-08-21 21:00:00,598,410,1155,465,1620,2030,2016-08-21 21:00:00,598,93288,92773
"1959",14374,2016-08-21 22:00:00,598,288,288,0,0,0,2016-08-21 22:00:00,598,388,1141,433,1574,1962,2016-08-21 22:00:00,598,88667,88242
"1960",14375,2016-08-21 23:00:00,598,293,293,0,0,0,2016-08-21 23:00:00,598,337,1132,426,1558,1895,2016-08-21 23:00:00,598,89982,89559
"1961",14376,2016-08-22 00:00:00,599,313,313,0,0,0,2016-08-22 00:00:00,599,294,972,400,1372,1666,2016-08-22 00:00:00,599,99542,99123
"1962",14377,2016-08-22 01:00:00,599,345,345,0,0,0,2016-08-22 01:00:00,599,299,803,304,1107,1406,2016-08-22 01:00:00,599,108166,107699
"1963",14378,2016-08-22 02:00:00,599,300,300,0,0,0,2016-08-22 02:00:00,599,207,593,243,836,1043,2016-08-22 02:00:00,599,99851,99419
"1964",14379,2016-08-22 03:00:00,599,295,295,0,0,0,2016-08-22 03:00:00,599,174,345,137,482,656,2016-08-22 03:00:00,599,92673,92257
"1965",14380,2016-08-22 04:00:00,599,236,236,0,0,0,2016-08-22 04:00:00,599,99,253,108,361,460,2016-08-22 04:00:00,599,88218,87819
"1966",14381,2016-08-22 05:00:00,599,196,196,0,0,0,2016-08-22 05:00:00,599,77,135,56,191,268,2016-08-22 05:00:00,599,87616,87243
"1967",14382,2016-08-22 06:00:00,599,177,177,0,0,0,2016-08-22 06:00:00,599,66,67,30,97,163,2016-08-22 06:00:00,599,96029,95574
"1968",14383,2016-08-22 07:00:00,599,186,186,0,0,0,2016-08-22 07:00:00,599,56,44,17,61,117,2016-08-22 07:00:00,599,98663,98170
"1969",14384,2016-08-22 08:00:00,599,177,177,0,0,0,2016-08-22 08:00:00,599,47,30,14,44,91,2016-08-22 08:00:00,599,99031,98525
"1970",14385,2016-08-22 09:00:00,599,188,188,0,0,0,2016-08-22 09:00:00,599,50,37,18,55,105,2016-08-22 09:00:00,599,104245,103703
"1971",14386,2016-08-22 10:00:00,599,210,210,0,0,0,2016-08-22 10:00:00,599,57,63,28,91,148,2016-08-22 10:00:00,599,126081,125620
"1972",14387,2016-08-22 11:00:00,599,245,245,0,0,0,2016-08-22 11:00:00,599,116,140,84,224,340,2016-08-22 11:00:00,599,211545,210983
"1973",14388,2016-08-22 12:00:00,599,263,263,0,0,0,2016-08-22 12:00:00,599,218,304,179,483,701,2016-08-22 12:00:00,599,327212,326535
"1974",14389,2016-08-22 13:00:00,599,388,388,0,0,0,2016-08-22 13:00:00,599,420,530,285,815,1235,2016-08-22 13:00:00,599,349498,348611
"1975",14390,2016-08-22 14:00:00,599,486,486,0,0,0,2016-08-22 14:00:00,599,577,738,360,1098,1675,2016-08-22 14:00:00,599,319152,318237
"1976",14391,2016-08-22 15:00:00,599,481,481,0,0,0,2016-08-22 15:00:00,599,664,810,398,1208,1872,2016-08-22 15:00:00,599,294459,293450
"1977",14392,2016-08-22 16:00:00,599,479,479,0,0,0,2016-08-22 16:00:00,599,698,1019,513,1532,2230,2016-08-22 16:00:00,599,250618,249721
"1978",14393,2016-08-22 17:00:00,599,527,527,0,0,0,2016-08-22 17:00:00,599,775,1139,550,1689,2464,2016-08-22 17:00:00,599,235613,234738
"1979",14394,2016-08-22 18:00:00,599,518,518,0,0,0,2016-08-22 18:00:00,599,828,1206,543,1749,2577,2016-08-22 18:00:00,599,227936,227075
"1980",14395,2016-08-22 19:00:00,599,516,516,0,0,0,2016-08-22 19:00:00,599,846,1144,562,1706,2552,2016-08-22 19:00:00,599,215107,214194
"1981",14396,2016-08-22 20:00:00,599,403,403,0,0,0,2016-08-22 20:00:00,599,837,1337,653,1990,2827,2016-08-22 20:00:00,599,195916,195129
"1982",14397,2016-08-22 21:00:00,599,457,457,0,0,0,2016-08-22 21:00:00,599,737,1249,537,1786,2523,2016-08-22 21:00:00,599,161577,160906
"1983",14398,2016-08-22 22:00:00,599,510,510,0,0,0,2016-08-22 22:00:00,599,617,1336,603,1939,2556,2016-08-22 22:00:00,599,130447,129848
"1984",14399,2016-08-22 23:00:00,599,413,413,0,0,0,2016-08-22 23:00:00,599,579,1415,598,2013,2592,2016-08-22 23:00:00,599,117327,116824
"1985",14400,2016-08-23 00:00:00,600,409,409,0,0,0,2016-08-23 00:00:00,600,529,1310,516,1826,2355,2016-08-23 00:00:00,600,111642,111167
"1986",14401,2016-08-23 01:00:00,600,402,402,0,0,0,2016-08-23 01:00:00,600,411,1170,480,1650,2061,2016-08-23 01:00:00,600,111737,111188
"1987",14402,2016-08-23 02:00:00,600,336,336,0,0,0,2016-08-23 02:00:00,600,304,803,336,1139,1443,2016-08-23 02:00:00,600,104484,103968
"1988",14403,2016-08-23 03:00:00,600,304,304,0,0,0,2016-08-23 03:00:00,600,211,601,224,825,1036,2016-08-23 03:00:00,600,96510,96053
"1989",14404,2016-08-23 04:00:00,600,282,282,0,0,0,2016-08-23 04:00:00,600,140,515,189,704,844,2016-08-23 04:00:00,600,87434,87064
"1990",14405,2016-08-23 05:00:00,600,224,224,0,0,0,2016-08-23 05:00:00,600,110,319,142,461,571,2016-08-23 05:00:00,600,85480,85056
"1991",14406,2016-08-23 06:00:00,600,188,188,0,0,0,2016-08-23 06:00:00,600,77,117,49,166,243,2016-08-23 06:00:00,600,92545,92076
"1992",14407,2016-08-23 07:00:00,600,165,165,0,0,0,2016-08-23 07:00:00,600,73,70,29,99,172,2016-08-23 07:00:00,600,95553,95072
"1993",14408,2016-08-23 08:00:00,600,173,173,0,0,0,2016-08-23 08:00:00,600,52,39,15,54,106,2016-08-23 08:00:00,600,96344,95813
"1994",14409,2016-08-23 09:00:00,600,202,202,0,0,0,2016-08-23 09:00:00,600,51,39,13,52,103,2016-08-23 09:00:00,600,97592,97086
"1995",14410,2016-08-23 10:00:00,600,171,171,0,0,0,2016-08-23 10:00:00,600,60,70,33,103,163,2016-08-23 10:00:00,600,104139,103635
"1996",14411,2016-08-23 11:00:00,600,226,226,0,0,0,2016-08-23 11:00:00,600,113,125,69,194,307,2016-08-23 11:00:00,600,142300,141794
"1997",14412,2016-08-23 12:00:00,600,337,337,0,0,0,2016-08-23 12:00:00,600,284,343,184,527,811,2016-08-23 12:00:00,600,200106,199447
"1998",14413,2016-08-23 13:00:00,600,383,383,0,0,0,2016-08-23 13:00:00,600,440,649,327,976,1416,2016-08-23 13:00:00,600,233620,232821
"1999",14414,2016-08-23 14:00:00,600,486,486,0,0,0,2016-08-23 14:00:00,600,587,737,366,1103,1690,2016-08-23 14:00:00,600,237788,236815
"2000",14415,2016-08-23 15:00:00,600,482,482,0,0,0,2016-08-23 15:00:00,600,654,881,417,1298,1952,2016-08-23 15:00:00,600,229457,228524
"2001",14416,2016-08-23 16:00:00,600,456,456,0,0,0,2016-08-23 16:00:00,600,724,1087,517,1604,2328,2016-08-23 16:00:00,600,207825,206949
"2002",14417,2016-08-23 17:00:00,600,520,520,0,0,0,2016-08-23 17:00:00,600,791,1173,519,1692,2483,2016-08-23 17:00:00,600,203117,202282
"2003",14418,2016-08-23 18:00:00,600,499,499,0,0,0,2016-08-23 18:00:00,600,783,1137,478,1615,2398,2016-08-23 18:00:00,600,201628,200760
"2004",14419,2016-08-23 19:00:00,600,501,501,0,0,0,2016-08-23 19:00:00,600,738,1323,568,1891,2629,2016-08-23 19:00:00,600,192295,191450
"2005",14420,2016-08-23 20:00:00,600,433,433,0,0,0,2016-08-23 20:00:00,600,704,1382,587,1969,2673,2016-08-23 20:00:00,600,177240,176473
"2006",14421,2016-08-23 21:00:00,600,406,406,0,0,0,2016-08-23 21:00:00,600,726,1485,609,2094,2820,2016-08-23 21:00:00,600,149666,149023
"2007",14422,2016-08-23 22:00:00,600,485,485,0,0,0,2016-08-23 22:00:00,600,654,1598,645,2243,2897,2016-08-23 22:00:00,600,125225,124682
"2008",14423,2016-08-23 23:00:00,600,404,404,0,0,0,2016-08-23 23:00:00,600,575,1547,592,2139,2714,2016-08-23 23:00:00,600,111957,111449
"2009",14424,2016-08-24 00:00:00,601,387,387,0,0,0,2016-08-24 00:00:00,601,465,1570,638,2208,2673,2016-08-24 00:00:00,601,107921,107443
"2010",14425,2016-08-24 01:00:00,601,384,384,0,0,0,2016-08-24 01:00:00,601,360,1317,511,1828,2188,2016-08-24 01:00:00,601,108658,108164
"2011",14426,2016-08-24 02:00:00,601,337,337,0,0,0,2016-08-24 02:00:00,601,289,971,365,1336,1625,2016-08-24 02:00:00,601,102892,102382
"2012",14427,2016-08-24 03:00:00,601,259,259,0,0,0,2016-08-24 03:00:00,601,225,695,288,983,1208,2016-08-24 03:00:00,601,95027,94572
"2013",14428,2016-08-24 04:00:00,601,294,294,0,0,0,2016-08-24 04:00:00,601,153,445,162,607,760,2016-08-24 04:00:00,601,88339,87985
"2014",14429,2016-08-24 05:00:00,601,215,215,0,0,0,2016-08-24 05:00:00,601,104,224,78,302,406,2016-08-24 05:00:00,601,84767,84401
"2015",14430,2016-08-24 06:00:00,601,171,171,0,0,0,2016-08-24 06:00:00,601,59,107,34,141,200,2016-08-24 06:00:00,601,91704,91289
"2016",14431,2016-08-24 07:00:00,601,206,206,0,0,0,2016-08-24 07:00:00,601,53,54,28,82,135,2016-08-24 07:00:00,601,97165,96683
"2017",14432,2016-08-24 08:00:00,601,195,195,0,0,0,2016-08-24 08:00:00,601,39,45,16,61,100,2016-08-24 08:00:00,601,96681,96157
"2018",14433,2016-08-24 09:00:00,601,190,190,0,0,0,2016-08-24 09:00:00,601,63,33,13,46,109,2016-08-24 09:00:00,601,96934,96452
"2019",14434,2016-08-24 10:00:00,601,200,200,0,0,0,2016-08-24 10:00:00,601,67,61,26,87,154,2016-08-24 10:00:00,601,100814,100311
"2020",14435,2016-08-24 11:00:00,601,242,242,0,0,0,2016-08-24 11:00:00,601,107,138,73,211,318,2016-08-24 11:00:00,601,125619,125103
"2021",14436,2016-08-24 12:00:00,601,320,320,0,0,0,2016-08-24 12:00:00,601,221,311,141,452,673,2016-08-24 12:00:00,601,170324,169628
"2022",14437,2016-08-24 13:00:00,601,364,364,0,0,0,2016-08-24 13:00:00,601,412,570,281,851,1263,2016-08-24 13:00:00,601,205156,204276
"2023",14438,2016-08-24 14:00:00,601,474,474,0,0,0,2016-08-24 14:00:00,601,537,737,347,1084,1621,2016-08-24 14:00:00,601,215752,214866
"2024",14439,2016-08-24 15:00:00,601,498,498,0,0,0,2016-08-24 15:00:00,601,649,793,384,1177,1826,2016-08-24 15:00:00,601,215003,214091
"2025",14440,2016-08-24 16:00:00,601,481,481,0,0,0,2016-08-24 16:00:00,601,694,934,424,1358,2052,2016-08-24 16:00:00,601,197313,196397
"2026",14441,2016-08-24 17:00:00,601,541,541,0,0,0,2016-08-24 17:00:00,601,736,1061,446,1507,2243,2016-08-24 17:00:00,601,194652,193803
"2027",14442,2016-08-24 18:00:00,601,537,536,1,1,0,2016-08-24 18:00:00,601,750,1217,508,1725,2475,2016-08-24 18:00:00,601,193070,192220
"2028",14443,2016-08-24 19:00:00,601,483,483,0,0,0,2016-08-24 19:00:00,601,767,1203,496,1699,2466,2016-08-24 19:00:00,601,184513,183649
"2029",14444,2016-08-24 20:00:00,601,453,453,0,0,0,2016-08-24 20:00:00,601,679,1329,578,1907,2586,2016-08-24 20:00:00,601,169661,168881
"2030",14445,2016-08-24 21:00:00,601,435,435,0,0,0,2016-08-24 21:00:00,601,711,1548,674,2222,2933,2016-08-24 21:00:00,601,144613,143990
"2031",14446,2016-08-24 22:00:00,601,472,472,0,0,0,2016-08-24 22:00:00,601,605,1565,640,2205,2810,2016-08-24 22:00:00,601,120893,120311
"2032",14447,2016-08-24 23:00:00,601,386,386,0,0,0,2016-08-24 23:00:00,601,561,1474,579,2053,2614,2016-08-24 23:00:00,601,111228,110705
"2033",14448,2016-08-25 00:00:00,602,406,406,0,0,0,2016-08-25 00:00:00,602,537,1406,506,1912,2449,2016-08-25 00:00:00,602,109979,109481
"2034",14449,2016-08-25 01:00:00,602,393,393,0,0,0,2016-08-25 01:00:00,602,394,1256,489,1745,2139,2016-08-25 01:00:00,602,112329,111821
"2035",14450,2016-08-25 02:00:00,602,352,352,0,0,0,2016-08-25 02:00:00,602,334,863,323,1186,1520,2016-08-25 02:00:00,602,104640,104144
"2036",14451,2016-08-25 03:00:00,602,271,271,0,0,0,2016-08-25 03:00:00,602,193,569,242,811,1004,2016-08-25 03:00:00,602,96078,95626
"2037",14452,2016-08-25 04:00:00,602,275,275,0,0,0,2016-08-25 04:00:00,602,126,345,153,498,624,2016-08-25 04:00:00,602,88564,88179
"2038",14453,2016-08-25 05:00:00,602,204,204,0,0,0,2016-08-25 05:00:00,602,91,225,83,308,399,2016-08-25 05:00:00,602,86008,85617
"2039",14454,2016-08-25 06:00:00,602,199,199,0,0,0,2016-08-25 06:00:00,602,93,106,45,151,244,2016-08-25 06:00:00,602,95271,94860
"2040",14455,2016-08-25 07:00:00,602,195,195,0,0,0,2016-08-25 07:00:00,602,55,58,21,79,134,2016-08-25 07:00:00,602,99366,98852
"2041",14456,2016-08-25 08:00:00,602,169,169,0,0,0,2016-08-25 08:00:00,602,47,35,17,52,99,2016-08-25 08:00:00,602,98457,97953
"2042",14457,2016-08-25 09:00:00,602,136,136,0,0,0,2016-08-25 09:00:00,602,71,45,19,64,135,2016-08-25 09:00:00,602,99693,99198
"2043",14458,2016-08-25 10:00:00,602,157,157,0,0,0,2016-08-25 10:00:00,602,52,81,36,117,169,2016-08-25 10:00:00,602,108883,108411
"2044",14459,2016-08-25 11:00:00,602,201,201,0,0,0,2016-08-25 11:00:00,602,96,138,70,208,304,2016-08-25 11:00:00,602,153761,153237
"2045",14460,2016-08-25 12:00:00,602,309,309,0,0,0,2016-08-25 12:00:00,602,235,302,178,480,715,2016-08-25 12:00:00,602,229880,229200
"2046",14461,2016-08-25 13:00:00,602,362,362,0,0,0,2016-08-25 13:00:00,602,408,532,286,818,1226,2016-08-25 13:00:00,602,268029,267172
"2047",14462,2016-08-25 14:00:00,602,424,424,0,0,0,2016-08-25 14:00:00,602,566,666,343,1009,1575,2016-08-25 14:00:00,602,267472,266560
"2048",14463,2016-08-25 15:00:00,602,429,429,0,0,0,2016-08-25 15:00:00,602,630,769,371,1140,1770,2016-08-25 15:00:00,602,262199,261257
"2049",14464,2016-08-25 16:00:00,602,510,510,0,0,0,2016-08-25 16:00:00,602,698,939,441,1380,2078,2016-08-25 16:00:00,602,234401,233491
"2050",14465,2016-08-25 17:00:00,602,509,509,0,0,0,2016-08-25 17:00:00,602,674,974,461,1435,2109,2016-08-25 17:00:00,602,225264,224423
"2051",14466,2016-08-25 18:00:00,602,472,472,0,0,0,2016-08-25 18:00:00,602,724,1068,481,1549,2273,2016-08-25 18:00:00,602,223159,222276
"2052",14467,2016-08-25 19:00:00,602,439,439,0,0,0,2016-08-25 19:00:00,602,699,1184,540,1724,2423,2016-08-25 19:00:00,602,211055,210171
"2053",14468,2016-08-25 20:00:00,602,496,496,0,0,0,2016-08-25 20:00:00,602,720,1275,558,1833,2553,2016-08-25 20:00:00,602,193131,192346
"2054",14469,2016-08-25 21:00:00,602,406,406,0,0,0,2016-08-25 21:00:00,602,641,1259,531,1790,2431,2016-08-25 21:00:00,602,158255,157620
"2055",14470,2016-08-25 22:00:00,602,380,380,0,0,0,2016-08-25 22:00:00,602,520,1311,569,1880,2400,2016-08-25 22:00:00,602,127471,126978
"2056",14471,2016-08-25 23:00:00,602,396,396,0,0,0,2016-08-25 23:00:00,602,548,1332,556,1888,2436,2016-08-25 23:00:00,602,112890,112391
"2057",14472,2016-08-26 00:00:00,603,343,343,0,0,0,2016-08-26 00:00:00,603,496,1237,491,1728,2224,2016-08-26 00:00:00,603,107956,107531
"2058",14473,2016-08-26 01:00:00,603,419,419,0,0,0,2016-08-26 01:00:00,603,382,1121,427,1548,1930,2016-08-26 01:00:00,603,107613,107112
"2059",14474,2016-08-26 02:00:00,603,344,344,0,0,0,2016-08-26 02:00:00,603,313,854,324,1178,1491,2016-08-26 02:00:00,603,100560,100076
"2060",14475,2016-08-26 03:00:00,603,274,274,0,0,0,2016-08-26 03:00:00,603,217,595,217,812,1029,2016-08-26 03:00:00,603,91533,91120
"2061",14476,2016-08-26 04:00:00,603,287,287,0,0,0,2016-08-26 04:00:00,603,157,345,135,480,637,2016-08-26 04:00:00,603,84036,83637
"2062",14477,2016-08-26 05:00:00,603,176,176,0,0,0,2016-08-26 05:00:00,603,104,204,68,272,376,2016-08-26 05:00:00,603,79735,79373
"2063",14478,2016-08-26 06:00:00,603,166,166,0,0,0,2016-08-26 06:00:00,603,58,104,43,147,205,2016-08-26 06:00:00,603,86710,86318
"2064",14479,2016-08-26 07:00:00,603,149,149,0,0,0,2016-08-26 07:00:00,603,46,49,22,71,117,2016-08-26 07:00:00,603,89466,89004
"2065",14480,2016-08-26 08:00:00,603,148,148,0,0,0,2016-08-26 08:00:00,603,42,44,22,66,108,2016-08-26 08:00:00,603,88194,87730
"2066",14481,2016-08-26 09:00:00,603,132,132,0,0,0,2016-08-26 09:00:00,603,41,33,20,53,94,2016-08-26 09:00:00,603,90682,90186
"2067",14482,2016-08-26 10:00:00,603,126,126,0,0,0,2016-08-26 10:00:00,603,44,79,38,117,161,2016-08-26 10:00:00,603,98697,98266
"2068",14483,2016-08-26 11:00:00,603,194,194,0,0,0,2016-08-26 11:00:00,603,84,140,86,226,310,2016-08-26 11:00:00,603,139468,138959
"2069",14484,2016-08-26 12:00:00,603,277,277,0,0,0,2016-08-26 12:00:00,603,206,309,171,480,686,2016-08-26 12:00:00,603,203209,202617
"2070",14485,2016-08-26 13:00:00,603,307,307,0,0,0,2016-08-26 13:00:00,603,412,561,304,865,1277,2016-08-26 13:00:00,603,232094,231336
"2071",14486,2016-08-26 14:00:00,603,346,346,0,0,0,2016-08-26 14:00:00,603,585,621,304,925,1510,2016-08-26 14:00:00,603,231777,230961
"2072",14487,2016-08-26 15:00:00,603,402,402,0,0,0,2016-08-26 15:00:00,603,597,859,430,1289,1886,2016-08-26 15:00:00,603,224675,223852
"2073",14488,2016-08-26 16:00:00,603,402,402,0,0,0,2016-08-26 16:00:00,603,684,1042,500,1542,2226,2016-08-26 16:00:00,603,200038,199228
"2074",14489,2016-08-26 17:00:00,603,454,454,0,0,0,2016-08-26 17:00:00,603,690,996,448,1444,2134,2016-08-26 17:00:00,603,191636,190873
"2075",14490,2016-08-26 18:00:00,603,467,467,0,0,0,2016-08-26 18:00:00,603,788,1142,516,1658,2446,2016-08-26 18:00:00,603,188688,187881
"2076",14491,2016-08-26 19:00:00,603,404,404,0,0,0,2016-08-26 19:00:00,603,756,1107,507,1614,2370,2016-08-26 19:00:00,603,176701,175978
"2077",14492,2016-08-26 20:00:00,603,394,394,0,0,0,2016-08-26 20:00:00,603,683,1222,548,1770,2453,2016-08-26 20:00:00,603,157571,156893
"2078",14493,2016-08-26 21:00:00,603,400,400,0,0,0,2016-08-26 21:00:00,603,552,1276,579,1855,2407,2016-08-26 21:00:00,603,130511,129934
"2079",14494,2016-08-26 22:00:00,603,350,350,0,0,0,2016-08-26 22:00:00,603,490,1253,522,1775,2265,2016-08-26 22:00:00,603,105813,105376
"2080",14495,2016-08-26 23:00:00,603,347,347,0,0,0,2016-08-26 23:00:00,603,495,1296,524,1820,2315,2016-08-26 23:00:00,603,93848,93414
"2081",14496,2016-08-27 00:00:00,604,323,323,0,0,0,2016-08-27 00:00:00,604,439,1250,482,1732,2171,2016-08-27 00:00:00,604,84286,83898
"2082",14497,2016-08-27 01:00:00,604,336,336,0,0,0,2016-08-27 01:00:00,604,362,1076,434,1510,1872,2016-08-27 01:00:00,604,81486,81093
"2083",14498,2016-08-27 02:00:00,604,303,303,0,0,0,2016-08-27 02:00:00,604,282,951,376,1327,1609,2016-08-27 02:00:00,604,77759,77397
"2084",14499,2016-08-27 03:00:00,604,252,252,0,0,0,2016-08-27 03:00:00,604,226,714,296,1010,1236,2016-08-27 03:00:00,604,74340,74011
"2085",14500,2016-08-27 04:00:00,604,220,220,0,0,0,2016-08-27 04:00:00,604,137,467,197,664,801,2016-08-27 04:00:00,604,69528,69206
"2086",14501,2016-08-27 05:00:00,604,196,196,0,0,0,2016-08-27 05:00:00,604,118,285,114,399,517,2016-08-27 05:00:00,604,64574,64267
"2087",14502,2016-08-27 06:00:00,604,195,195,0,0,0,2016-08-27 06:00:00,604,105,143,58,201,306,2016-08-27 06:00:00,604,62748,62425
"2088",14503,2016-08-27 07:00:00,604,160,160,0,0,0,2016-08-27 07:00:00,604,52,73,22,95,147,2016-08-27 07:00:00,604,60248,59955
"2089",14504,2016-08-27 08:00:00,604,128,128,0,0,0,2016-08-27 08:00:00,604,42,58,18,76,118,2016-08-27 08:00:00,604,59069,58753
"2090",14505,2016-08-27 09:00:00,604,145,145,0,0,0,2016-08-27 09:00:00,604,37,41,23,64,101,2016-08-27 09:00:00,604,60692,60369
"2091",14506,2016-08-27 10:00:00,604,140,140,0,0,0,2016-08-27 10:00:00,604,33,55,24,79,112,2016-08-27 10:00:00,604,64109,63792
"2092",14507,2016-08-27 11:00:00,604,159,159,0,0,0,2016-08-27 11:00:00,604,77,126,62,188,265,2016-08-27 11:00:00,604,74545,74173
"2093",14508,2016-08-27 12:00:00,604,234,234,0,0,0,2016-08-27 12:00:00,604,144,255,130,385,529,2016-08-27 12:00:00,604,86917,86539
"2094",14509,2016-08-27 13:00:00,604,300,300,0,0,0,2016-08-27 13:00:00,604,255,513,254,767,1022,2016-08-27 13:00:00,604,98538,98140
"2095",14510,2016-08-27 14:00:00,604,336,336,0,0,0,2016-08-27 14:00:00,604,391,844,407,1251,1642,2016-08-27 14:00:00,604,107216,106736
"2096",14511,2016-08-27 15:00:00,604,250,250,0,0,0,2016-08-27 15:00:00,604,447,1045,498,1543,1990,2016-08-27 15:00:00,604,110638,110114
"2097",14512,2016-08-27 16:00:00,604,327,327,0,0,0,2016-08-27 16:00:00,604,478,1179,550,1729,2207,2016-08-27 16:00:00,604,109423,108898
"2098",14513,2016-08-27 17:00:00,604,349,349,0,0,0,2016-08-27 17:00:00,604,529,1158,525,1683,2212,2016-08-27 17:00:00,604,106541,105995
"2099",14514,2016-08-27 18:00:00,604,399,399,0,0,0,2016-08-27 18:00:00,604,551,1262,579,1841,2392,2016-08-27 18:00:00,604,103950,103402
"2100",14515,2016-08-27 19:00:00,604,310,310,0,0,0,2016-08-27 19:00:00,604,483,1301,572,1873,2356,2016-08-27 19:00:00,604,99379,98898
"2101",14516,2016-08-27 20:00:00,604,275,275,0,0,0,2016-08-27 20:00:00,604,468,1367,596,1963,2431,2016-08-27 20:00:00,604,93486,93022
"2102",14517,2016-08-27 21:00:00,604,257,257,0,0,0,2016-08-27 21:00:00,604,444,1261,539,1800,2244,2016-08-27 21:00:00,604,86157,85754
"2103",14518,2016-08-27 22:00:00,604,288,288,0,0,0,2016-08-27 22:00:00,604,479,1189,505,1694,2173,2016-08-27 22:00:00,604,78827,78454
"2104",14519,2016-08-27 23:00:00,604,295,295,0,0,0,2016-08-27 23:00:00,604,346,1150,435,1585,1931,2016-08-27 23:00:00,604,74986,74627
"2105",14520,2016-08-28 00:00:00,605,339,339,0,0,0,2016-08-28 00:00:00,605,343,1056,429,1485,1828,2016-08-28 00:00:00,605,74088,73763
"2106",14521,2016-08-28 01:00:00,605,290,290,0,0,0,2016-08-28 01:00:00,605,291,1005,414,1419,1710,2016-08-28 01:00:00,605,73504,73110
"2107",14522,2016-08-28 02:00:00,605,311,311,0,0,0,2016-08-28 02:00:00,605,223,692,253,945,1168,2016-08-28 02:00:00,605,73263,72870
"2108",14523,2016-08-28 03:00:00,605,255,255,0,0,0,2016-08-28 03:00:00,605,177,593,218,811,988,2016-08-28 03:00:00,605,72810,72465
"2109",14524,2016-08-28 04:00:00,605,200,200,0,0,0,2016-08-28 04:00:00,605,131,406,164,570,701,2016-08-28 04:00:00,605,70201,69908
"2110",14525,2016-08-28 05:00:00,605,222,222,0,0,0,2016-08-28 05:00:00,605,98,219,103,322,420,2016-08-28 05:00:00,605,65598,65285
"2111",14526,2016-08-28 06:00:00,605,174,174,0,0,0,2016-08-28 06:00:00,605,57,132,48,180,237,2016-08-28 06:00:00,605,62430,62082
"2112",14527,2016-08-28 07:00:00,605,140,140,0,0,0,2016-08-28 07:00:00,605,57,74,31,105,162,2016-08-28 07:00:00,605,60730,60405
"2113",14528,2016-08-28 08:00:00,605,185,185,0,0,0,2016-08-28 08:00:00,605,40,37,17,54,94,2016-08-28 08:00:00,605,59551,59247
"2114",14529,2016-08-28 09:00:00,605,152,152,0,0,0,2016-08-28 09:00:00,605,32,26,14,40,72,2016-08-28 09:00:00,605,59776,59466
"2115",14530,2016-08-28 10:00:00,605,134,134,0,0,0,2016-08-28 10:00:00,605,43,40,17,57,100,2016-08-28 10:00:00,605,63394,63098
"2116",14531,2016-08-28 11:00:00,605,173,173,0,0,0,2016-08-28 11:00:00,605,63,138,64,202,265,2016-08-28 11:00:00,605,73309,72983
"2117",14532,2016-08-28 12:00:00,605,218,218,0,0,0,2016-08-28 12:00:00,605,121,205,77,282,403,2016-08-28 12:00:00,605,79578,79215
"2118",14533,2016-08-28 13:00:00,605,288,288,0,0,0,2016-08-28 13:00:00,605,196,449,199,648,844,2016-08-28 13:00:00,605,90017,89614
"2119",14534,2016-08-28 14:00:00,605,320,320,0,0,0,2016-08-28 14:00:00,605,270,757,352,1109,1379,2016-08-28 14:00:00,605,99984,99537
"2120",14535,2016-08-28 15:00:00,605,324,324,0,0,0,2016-08-28 15:00:00,605,351,833,377,1210,1561,2016-08-28 15:00:00,605,103858,103365
"2121",14536,2016-08-28 16:00:00,605,323,323,0,0,0,2016-08-28 16:00:00,605,406,1042,473,1515,1921,2016-08-28 16:00:00,605,105573,105049
"2122",14537,2016-08-28 17:00:00,605,341,341,0,0,0,2016-08-28 17:00:00,605,384,1093,484,1577,1961,2016-08-28 17:00:00,605,105184,104667
"2123",14538,2016-08-28 18:00:00,605,404,404,0,0,0,2016-08-28 18:00:00,605,463,1149,467,1616,2079,2016-08-28 18:00:00,605,105744,105247
"2124",14539,2016-08-28 19:00:00,605,360,360,0,0,0,2016-08-28 19:00:00,605,442,1282,544,1826,2268,2016-08-28 19:00:00,605,103310,102773
"2125",14540,2016-08-28 20:00:00,605,292,292,0,0,0,2016-08-28 20:00:00,605,476,1211,517,1728,2204,2016-08-28 20:00:00,605,99187,98678
"2126",14541,2016-08-28 21:00:00,605,247,247,0,0,0,2016-08-28 21:00:00,605,416,1223,501,1724,2140,2016-08-28 21:00:00,605,93282,92798
"2127",14542,2016-08-28 22:00:00,605,335,335,0,0,0,2016-08-28 22:00:00,605,395,1212,489,1701,2096,2016-08-28 22:00:00,605,89437,89018
"2128",14543,2016-08-28 23:00:00,605,357,357,0,0,0,2016-08-28 23:00:00,605,385,1134,438,1572,1957,2016-08-28 23:00:00,605,90512,90088
"2129",14544,2016-08-29 00:00:00,606,352,352,0,0,0,2016-08-29 00:00:00,606,345,1049,424,1473,1818,2016-08-29 00:00:00,606,100985,100530
"2130",14545,2016-08-29 01:00:00,606,347,347,0,0,0,2016-08-29 01:00:00,606,296,849,364,1213,1509,2016-08-29 01:00:00,606,109467,109004
"2131",14546,2016-08-29 02:00:00,606,300,300,0,0,0,2016-08-29 02:00:00,606,205,563,255,818,1023,2016-08-29 02:00:00,606,99689,99264
"2132",14547,2016-08-29 03:00:00,606,219,219,0,0,0,2016-08-29 03:00:00,606,148,373,156,529,677,2016-08-29 03:00:00,606,93178,92810
"2133",14548,2016-08-29 04:00:00,606,203,203,0,0,0,2016-08-29 04:00:00,606,83,231,101,332,415,2016-08-29 04:00:00,606,88743,88357
"2134",14549,2016-08-29 05:00:00,606,214,214,0,0,0,2016-08-29 05:00:00,606,78,143,55,198,276,2016-08-29 05:00:00,606,87873,87527
"2135",14550,2016-08-29 06:00:00,606,186,186,0,0,0,2016-08-29 06:00:00,606,59,78,27,105,164,2016-08-29 06:00:00,606,96943,96539
"2136",14551,2016-08-29 07:00:00,606,220,220,0,0,0,2016-08-29 07:00:00,606,38,67,26,93,131,2016-08-29 07:00:00,606,98793,98307
"2137",14552,2016-08-29 08:00:00,606,219,219,0,0,0,2016-08-29 08:00:00,606,47,31,13,44,91,2016-08-29 08:00:00,606,96608,96092
"2138",14553,2016-08-29 09:00:00,606,158,158,0,0,0,2016-08-29 09:00:00,606,34,28,11,39,73,2016-08-29 09:00:00,606,102170,101679
"2139",14554,2016-08-29 10:00:00,606,227,227,0,0,0,2016-08-29 10:00:00,606,60,61,29,90,150,2016-08-29 10:00:00,606,123726,123212
"2140",14555,2016-08-29 11:00:00,606,212,212,0,0,0,2016-08-29 11:00:00,606,89,145,73,218,307,2016-08-29 11:00:00,606,209667,209142
"2141",14556,2016-08-29 12:00:00,606,267,267,0,0,0,2016-08-29 12:00:00,606,269,285,148,433,702,2016-08-29 12:00:00,606,330841,330195
"2142",14557,2016-08-29 13:00:00,606,329,329,0,0,0,2016-08-29 13:00:00,606,395,585,320,905,1300,2016-08-29 13:00:00,606,354068,353214
"2143",14558,2016-08-29 14:00:00,606,440,440,0,0,0,2016-08-29 14:00:00,606,530,769,406,1175,1705,2016-08-29 14:00:00,606,322289,321374
"2144",14559,2016-08-29 15:00:00,606,462,462,0,0,0,2016-08-29 15:00:00,606,652,859,440,1299,1951,2016-08-29 15:00:00,606,297837,296884
"2145",14560,2016-08-29 16:00:00,606,457,457,0,0,0,2016-08-29 16:00:00,606,727,1093,504,1597,2324,2016-08-29 16:00:00,606,255524,254622
"2146",14561,2016-08-29 17:00:00,606,511,511,0,0,0,2016-08-29 17:00:00,606,765,1100,518,1618,2383,2016-08-29 17:00:00,606,240361,239475
"2147",14562,2016-08-29 18:00:00,606,532,532,0,0,0,2016-08-29 18:00:00,606,796,1269,587,1856,2652,2016-08-29 18:00:00,606,234528,233606
"2148",14563,2016-08-29 19:00:00,606,468,468,0,0,0,2016-08-29 19:00:00,606,806,1223,594,1817,2623,2016-08-29 19:00:00,606,217726,216887
"2149",14564,2016-08-29 20:00:00,606,462,462,0,0,0,2016-08-29 20:00:00,606,798,1401,612,2013,2811,2016-08-29 20:00:00,606,195691,194870
"2150",14565,2016-08-29 21:00:00,606,479,479,0,0,0,2016-08-29 21:00:00,606,747,1473,651,2124,2871,2016-08-29 21:00:00,606,160736,160139
"2151",14566,2016-08-29 22:00:00,606,436,436,0,0,0,2016-08-29 22:00:00,606,683,1633,689,2322,3005,2016-08-29 22:00:00,606,130521,129985
"2152",14567,2016-08-29 23:00:00,606,450,450,0,0,0,2016-08-29 23:00:00,606,574,1554,609,2163,2737,2016-08-29 23:00:00,606,117115,116660
"2153",14568,2016-08-30 00:00:00,607,431,431,0,0,0,2016-08-30 00:00:00,607,521,1483,616,2099,2620,2016-08-30 00:00:00,607,112473,112002
"2154",14569,2016-08-30 01:00:00,607,414,414,0,0,0,2016-08-30 01:00:00,607,412,1162,476,1638,2050,2016-08-30 01:00:00,607,112944,112396
"2155",14570,2016-08-30 02:00:00,607,350,350,0,0,0,2016-08-30 02:00:00,607,340,869,377,1246,1586,2016-08-30 02:00:00,607,103633,103146
"2156",14571,2016-08-30 03:00:00,607,300,300,0,0,0,2016-08-30 03:00:00,607,265,530,205,735,1000,2016-08-30 03:00:00,607,94436,93962
"2157",14572,2016-08-30 04:00:00,607,296,296,0,0,0,2016-08-30 04:00:00,607,184,295,109,404,588,2016-08-30 04:00:00,607,87128,86701
"2158",14573,2016-08-30 05:00:00,607,254,254,0,0,0,2016-08-30 05:00:00,607,95,195,62,257,352,2016-08-30 05:00:00,607,84694,84302
"2159",14574,2016-08-30 06:00:00,607,195,195,0,0,0,2016-08-30 06:00:00,607,54,109,36,145,199,2016-08-30 06:00:00,607,91988,91493
"2160",14575,2016-08-30 07:00:00,607,202,202,0,0,0,2016-08-30 07:00:00,607,34,45,13,58,92,2016-08-30 07:00:00,607,96475,95958
"2161",14576,2016-08-30 08:00:00,607,211,211,0,0,0,2016-08-30 08:00:00,607,48,32,11,43,91,2016-08-30 08:00:00,607,96351,95868
"2162",14577,2016-08-30 09:00:00,607,149,149,0,0,0,2016-08-30 09:00:00,607,43,36,14,50,93,2016-08-30 09:00:00,607,98585,98033
"2163",14578,2016-08-30 10:00:00,607,196,196,0,0,0,2016-08-30 10:00:00,607,56,53,30,83,139,2016-08-30 10:00:00,607,105188,104669
"2164",14579,2016-08-30 11:00:00,607,217,217,0,0,0,2016-08-30 11:00:00,607,108,145,74,219,327,2016-08-30 11:00:00,607,141561,141026
"2165",14580,2016-08-30 12:00:00,607,319,319,0,0,0,2016-08-30 12:00:00,607,240,319,160,479,719,2016-08-30 12:00:00,607,200023,199356
"2166",14581,2016-08-30 13:00:00,607,390,390,0,0,0,2016-08-30 13:00:00,607,455,538,286,824,1279,2016-08-30 13:00:00,607,236306,235466
"2167",14582,2016-08-30 14:00:00,607,432,432,0,0,0,2016-08-30 14:00:00,607,533,739,363,1102,1635,2016-08-30 14:00:00,607,241403,240452
"2168",14583,2016-08-30 15:00:00,607,453,453,0,0,0,2016-08-30 15:00:00,607,492,617,276,893,1385,2016-08-30 15:00:00,607,235755,234786
"2169",14584,2016-08-30 16:00:00,607,421,421,0,0,0,2016-08-30 16:00:00,607,483,528,234,762,1245,2016-08-30 16:00:00,607,211268,210394
"2170",14585,2016-08-30 17:00:00,607,477,477,0,0,0,2016-08-30 17:00:00,607,709,1032,464,1496,2205,2016-08-30 17:00:00,607,205255,204389
"2171",14586,2016-08-30 18:00:00,607,437,437,0,0,0,2016-08-30 18:00:00,607,774,1024,433,1457,2231,2016-08-30 18:00:00,607,204406,203501
"2172",14587,2016-08-30 19:00:00,607,440,440,0,0,0,2016-08-30 19:00:00,607,801,1185,545,1730,2531,2016-08-30 19:00:00,607,191251,190369
"2173",14588,2016-08-30 20:00:00,607,347,347,0,0,0,2016-08-30 20:00:00,607,798,1218,499,1717,2515,2016-08-30 20:00:00,607,173306,172521
"2174",14589,2016-08-30 21:00:00,607,431,431,0,0,0,2016-08-30 21:00:00,607,705,1378,567,1945,2650,2016-08-30 21:00:00,607,145334,144766
"2175",14590,2016-08-30 22:00:00,607,411,411,0,0,0,2016-08-30 22:00:00,607,643,1301,545,1846,2489,2016-08-30 22:00:00,607,120844,120299
"2176",14591,2016-08-30 23:00:00,607,404,404,0,0,0,2016-08-30 23:00:00,607,509,1287,507,1794,2303,2016-08-30 23:00:00,607,109282,108791
"2177",14592,2016-08-31 00:00:00,608,365,365,0,0,0,2016-08-31 00:00:00,608,470,1364,543,1907,2377,2016-08-31 00:00:00,608,103134,102641
"2178",14593,2016-08-31 01:00:00,608,369,369,0,0,0,2016-08-31 01:00:00,608,377,1081,407,1488,1865,2016-08-31 01:00:00,608,102475,102015
"2179",14594,2016-08-31 02:00:00,608,281,281,0,0,0,2016-08-31 02:00:00,608,278,757,303,1060,1338,2016-08-31 02:00:00,608,96862,96382
"2180",14595,2016-08-31 03:00:00,608,256,256,0,0,0,2016-08-31 03:00:00,608,218,461,184,645,863,2016-08-31 03:00:00,608,89774,89356
"2181",14596,2016-08-31 04:00:00,608,252,252,0,0,0,2016-08-31 04:00:00,608,151,291,120,411,562,2016-08-31 04:00:00,608,83592,83230
"2182",14597,2016-08-31 05:00:00,608,212,212,0,0,0,2016-08-31 05:00:00,608,114,149,46,195,309,2016-08-31 05:00:00,608,81931,81571
"2183",14598,2016-08-31 06:00:00,608,195,195,0,0,0,2016-08-31 06:00:00,608,85,94,38,132,217,2016-08-31 06:00:00,608,88618,88185
"2184",14599,2016-08-31 07:00:00,608,198,198,0,0,0,2016-08-31 07:00:00,608,74,75,26,101,175,2016-08-31 07:00:00,608,92111,91636
"2185",14600,2016-08-31 08:00:00,608,203,203,0,0,0,2016-08-31 08:00:00,608,49,46,17,63,112,2016-08-31 08:00:00,608,93103,92600
"2186",14601,2016-08-31 09:00:00,608,163,163,0,0,0,2016-08-31 09:00:00,608,45,23,14,37,82,2016-08-31 09:00:00,608,94682,94196
"2187",14602,2016-08-31 10:00:00,608,201,201,0,0,0,2016-08-31 10:00:00,608,56,40,17,57,113,2016-08-31 10:00:00,608,100076,99616
"2188",14603,2016-08-31 11:00:00,608,269,269,0,0,0,2016-08-31 11:00:00,608,100,99,53,152,252,2016-08-31 11:00:00,608,123882,123403
"2189",14604,2016-08-31 12:00:00,608,316,316,0,0,0,2016-08-31 12:00:00,608,250,227,125,352,602,2016-08-31 12:00:00,608,166861,166250
"2190",14605,2016-08-31 13:00:00,608,380,380,0,0,0,2016-08-31 13:00:00,608,432,446,231,677,1109,2016-08-31 13:00:00,608,203152,202316
"2191",14606,2016-08-31 14:00:00,608,406,406,0,0,0,2016-08-31 14:00:00,608,551,592,301,893,1444,2016-08-31 14:00:00,608,216030,215122
"2192",14607,2016-08-31 15:00:00,608,444,444,0,0,0,2016-08-31 15:00:00,608,662,627,312,939,1601,2016-08-31 15:00:00,608,213955,213052
"2193",14608,2016-08-31 16:00:00,608,474,474,0,0,0,2016-08-31 16:00:00,608,597,804,381,1185,1782,2016-08-31 16:00:00,608,196502,195676
"2194",14609,2016-08-31 17:00:00,608,505,505,0,0,0,2016-08-31 17:00:00,608,655,879,397,1276,1931,2016-08-31 17:00:00,608,192941,192105
"2195",14610,2016-08-31 18:00:00,608,484,484,0,0,0,2016-08-31 18:00:00,608,742,961,403,1364,2106,2016-08-31 18:00:00,608,194852,193969
"2196",14611,2016-08-31 19:00:00,608,451,451,0,0,0,2016-08-31 19:00:00,608,670,1117,473,1590,2260,2016-08-31 19:00:00,608,185616,184776
"2197",14612,2016-08-31 20:00:00,608,434,434,0,0,0,2016-08-31 20:00:00,608,673,1315,496,1811,2484,2016-08-31 20:00:00,608,169660,168889
"2198",14613,2016-08-31 21:00:00,608,417,417,0,0,0,2016-08-31 21:00:00,608,691,1369,566,1935,2626,2016-08-31 21:00:00,608,143097,142466
"2199",14614,2016-08-31 22:00:00,608,429,429,0,0,0,2016-08-31 22:00:00,608,602,1228,468,1696,2298,2016-08-31 22:00:00,608,120040,119460
"2200",14615,2016-08-31 23:00:00,608,406,406,0,0,0,2016-08-31 23:00:00,608,569,1184,508,1692,2261,2016-08-31 23:00:00,608,110136,109609
"2201",14616,2016-09-01 00:00:00,609,461,461,0,0,0,2016-09-01 00:00:00,609,500,1102,417,1519,2019,2016-09-01 00:00:00,609,109382,108888
"2202",14617,2016-09-01 01:00:00,609,421,421,0,0,0,2016-09-01 01:00:00,609,382,825,313,1138,1520,2016-09-01 01:00:00,609,112709,112237
"2203",14618,2016-09-01 02:00:00,609,388,388,0,0,0,2016-09-01 02:00:00,609,318,597,227,824,1142,2016-09-01 02:00:00,609,105190,104718
"2204",14619,2016-09-01 03:00:00,609,307,307,0,0,0,2016-09-01 03:00:00,609,211,407,173,580,791,2016-09-01 03:00:00,609,96907,96454
"2205",14620,2016-09-01 04:00:00,609,244,244,0,0,0,2016-09-01 04:00:00,609,134,343,115,458,592,2016-09-01 04:00:00,609,90340,89957
"2206",14621,2016-09-01 05:00:00,609,247,247,0,0,0,2016-09-01 05:00:00,609,102,169,75,244,346,2016-09-01 05:00:00,609,88039,87682
"2207",14622,2016-09-01 06:00:00,609,179,179,0,0,0,2016-09-01 06:00:00,609,70,65,29,94,164,2016-09-01 06:00:00,609,94590,94172
"2208",14623,2016-09-01 07:00:00,609,182,182,0,0,0,2016-09-01 07:00:00,609,63,55,25,80,143,2016-09-01 07:00:00,609,98661,98199
"2209",14624,2016-09-01 08:00:00,609,167,167,0,0,0,2016-09-01 08:00:00,609,44,30,8,38,82,2016-09-01 08:00:00,609,98617,98133
"2210",14625,2016-09-01 09:00:00,609,176,176,0,0,0,2016-09-01 09:00:00,609,62,34,22,56,118,2016-09-01 09:00:00,609,99894,99440
"2211",14626,2016-09-01 10:00:00,609,161,161,0,0,0,2016-09-01 10:00:00,609,68,59,40,99,167,2016-09-01 10:00:00,609,109821,109370
"2212",14627,2016-09-01 11:00:00,609,231,231,0,0,0,2016-09-01 11:00:00,609,113,136,87,223,336,2016-09-01 11:00:00,609,156142,155615
"2213",14628,2016-09-01 12:00:00,609,313,313,0,0,0,2016-09-01 12:00:00,609,251,264,157,421,672,2016-09-01 12:00:00,609,233195,232576
"2214",14629,2016-09-01 13:00:00,609,427,427,0,0,0,2016-09-01 13:00:00,609,466,528,280,808,1274,2016-09-01 13:00:00,609,277065,276194
"2215",14630,2016-09-01 14:00:00,609,521,521,0,0,0,2016-09-01 14:00:00,609,450,557,294,851,1301,2016-09-01 14:00:00,609,276688,275777
"2216",14631,2016-09-01 15:00:00,609,502,502,0,0,0,2016-09-01 15:00:00,609,571,702,356,1058,1629,2016-09-01 15:00:00,609,267706,266729
"2217",14632,2016-09-01 16:00:00,609,482,482,0,0,0,2016-09-01 16:00:00,609,636,763,377,1140,1776,2016-09-01 16:00:00,609,238094,237217
"2218",14633,2016-09-01 17:00:00,609,567,567,0,0,0,2016-09-01 17:00:00,609,647,879,392,1271,1918,2016-09-01 17:00:00,609,229795,229000
"2219",14634,2016-09-01 18:00:00,609,551,551,0,0,0,2016-09-01 18:00:00,609,713,872,415,1287,2000,2016-09-01 18:00:00,609,226597,225732
"2220",14635,2016-09-01 19:00:00,609,460,460,0,0,0,2016-09-01 19:00:00,609,715,964,444,1408,2123,2016-09-01 19:00:00,609,211248,210468
"2221",14636,2016-09-01 20:00:00,609,510,510,0,0,0,2016-09-01 20:00:00,609,654,1250,549,1799,2453,2016-09-01 20:00:00,609,191912,191180
"2222",14637,2016-09-01 21:00:00,609,481,481,0,0,0,2016-09-01 21:00:00,609,706,1290,526,1816,2522,2016-09-01 21:00:00,609,157633,157018
"2223",14638,2016-09-01 22:00:00,609,432,432,0,0,0,2016-09-01 22:00:00,609,572,1431,633,2064,2636,2016-09-01 22:00:00,609,127836,127358
"2224",14639,2016-09-01 23:00:00,609,414,414,0,0,0,2016-09-01 23:00:00,609,524,1286,497,1783,2307,2016-09-01 23:00:00,609,113118,112635
"2225",14640,2016-09-02 00:00:00,610,346,346,0,0,0,2016-09-02 00:00:00,610,465,1103,433,1536,2001,2016-09-02 00:00:00,610,108324,107840
"2226",14641,2016-09-02 01:00:00,610,332,332,0,0,0,2016-09-02 01:00:00,610,365,953,363,1316,1681,2016-09-02 01:00:00,610,108172,107690
"2227",14642,2016-09-02 02:00:00,610,345,345,0,0,0,2016-09-02 02:00:00,610,277,649,253,902,1179,2016-09-02 02:00:00,610,99723,99286
"2228",14643,2016-09-02 03:00:00,610,287,287,0,0,0,2016-09-02 03:00:00,610,191,489,193,682,873,2016-09-02 03:00:00,610,91272,90849
"2229",14644,2016-09-02 04:00:00,610,258,258,0,0,0,2016-09-02 04:00:00,610,160,365,146,511,671,2016-09-02 04:00:00,610,81919,81545
"2230",14645,2016-09-02 05:00:00,610,192,192,0,0,0,2016-09-02 05:00:00,610,115,200,94,294,409,2016-09-02 05:00:00,610,79284,78935
"2231",14646,2016-09-02 06:00:00,610,170,170,0,0,0,2016-09-02 06:00:00,610,70,116,44,160,230,2016-09-02 06:00:00,610,85810,85447
"2232",14647,2016-09-02 07:00:00,610,148,148,0,0,0,2016-09-02 07:00:00,610,49,73,30,103,152,2016-09-02 07:00:00,610,89153,88742
"2233",14648,2016-09-02 08:00:00,610,188,188,0,0,0,2016-09-02 08:00:00,610,38,44,18,62,100,2016-09-02 08:00:00,610,88336,87845
"2234",14649,2016-09-02 09:00:00,610,145,145,0,0,0,2016-09-02 09:00:00,610,63,43,18,61,124,2016-09-02 09:00:00,610,90526,90092
"2235",14650,2016-09-02 10:00:00,610,203,203,0,0,0,2016-09-02 10:00:00,610,63,81,37,118,181,2016-09-02 10:00:00,610,99248,98812
"2236",14651,2016-09-02 11:00:00,610,212,212,0,0,0,2016-09-02 11:00:00,610,109,164,98,262,371,2016-09-02 11:00:00,610,139197,138726
"2237",14652,2016-09-02 12:00:00,610,304,304,0,0,0,2016-09-02 12:00:00,610,239,414,229,643,882,2016-09-02 12:00:00,610,199117,198536
"2238",14653,2016-09-02 13:00:00,610,377,377,0,0,0,2016-09-02 13:00:00,610,419,695,345,1040,1459,2016-09-02 13:00:00,610,228218,227521
"2239",14654,2016-09-02 14:00:00,610,428,428,0,0,0,2016-09-02 14:00:00,610,551,744,394,1138,1689,2016-09-02 14:00:00,610,230030,229256
"2240",14655,2016-09-02 15:00:00,610,490,490,0,0,0,2016-09-02 15:00:00,610,646,949,442,1391,2037,2016-09-02 15:00:00,610,231767,230930
"2241",14656,2016-09-02 16:00:00,610,471,471,0,0,0,2016-09-02 16:00:00,610,610,946,478,1424,2034,2016-09-02 16:00:00,610,196876,196110
"2242",14657,2016-09-02 17:00:00,610,501,501,0,0,0,2016-09-02 17:00:00,610,593,1036,491,1527,2120,2016-09-02 17:00:00,610,186953,186207
"2243",14658,2016-09-02 18:00:00,610,446,446,0,0,0,2016-09-02 18:00:00,610,694,1022,501,1523,2217,2016-09-02 18:00:00,610,181807,181061
"2244",14659,2016-09-02 19:00:00,610,451,451,0,0,0,2016-09-02 19:00:00,610,626,1188,528,1716,2342,2016-09-02 19:00:00,610,166789,166050
"2245",14660,2016-09-02 20:00:00,610,439,439,0,0,0,2016-09-02 20:00:00,610,647,1393,682,2075,2722,2016-09-02 20:00:00,610,147512,146903
"2246",14661,2016-09-02 21:00:00,610,428,428,0,0,0,2016-09-02 21:00:00,610,632,1470,663,2133,2765,2016-09-02 21:00:00,610,122782,122249
"2247",14662,2016-09-02 22:00:00,610,384,384,0,0,0,2016-09-02 22:00:00,610,488,1275,580,1855,2343,2016-09-02 22:00:00,610,100637,100145
"2248",14663,2016-09-02 23:00:00,610,352,352,0,0,0,2016-09-02 23:00:00,610,430,1281,506,1787,2217,2016-09-02 23:00:00,610,89275,88854
"2249",14664,2016-09-03 00:00:00,611,325,325,0,0,0,2016-09-03 00:00:00,611,392,1204,492,1696,2088,2016-09-03 00:00:00,611,83243,82868
"2250",14665,2016-09-03 01:00:00,611,331,331,0,0,0,2016-09-03 01:00:00,611,301,985,406,1391,1692,2016-09-03 01:00:00,611,79417,79040
"2251",14666,2016-09-03 02:00:00,611,290,290,0,0,0,2016-09-03 02:00:00,611,256,808,359,1167,1423,2016-09-03 02:00:00,611,76097,75745
"2252",14667,2016-09-03 03:00:00,611,242,242,0,0,0,2016-09-03 03:00:00,611,202,605,244,849,1051,2016-09-03 03:00:00,611,73650,73302
"2253",14668,2016-09-03 04:00:00,611,200,200,0,0,0,2016-09-03 04:00:00,611,155,387,145,532,687,2016-09-03 04:00:00,611,67969,67662
"2254",14669,2016-09-03 05:00:00,611,162,162,0,0,0,2016-09-03 05:00:00,611,111,252,115,367,478,2016-09-03 05:00:00,611,63714,63419
"2255",14670,2016-09-03 06:00:00,611,182,182,0,0,0,2016-09-03 06:00:00,611,70,132,49,181,251,2016-09-03 06:00:00,611,61124,60815
"2256",14671,2016-09-03 07:00:00,611,162,162,0,0,0,2016-09-03 07:00:00,611,53,85,31,116,169,2016-09-03 07:00:00,611,59602,59322
"2257",14672,2016-09-03 08:00:00,611,143,143,0,0,0,2016-09-03 08:00:00,611,36,50,18,68,104,2016-09-03 08:00:00,611,58618,58326
"2258",14673,2016-09-03 09:00:00,611,148,148,0,0,0,2016-09-03 09:00:00,611,35,34,16,50,85,2016-09-03 09:00:00,611,59631,59360
"2259",14674,2016-09-03 10:00:00,611,156,156,0,0,0,2016-09-03 10:00:00,611,51,51,24,75,126,2016-09-03 10:00:00,611,63659,63376
"2260",14675,2016-09-03 11:00:00,611,186,186,0,0,0,2016-09-03 11:00:00,611,96,131,65,196,292,2016-09-03 11:00:00,611,73299,72950
"2261",14676,2016-09-03 12:00:00,611,262,262,0,0,0,2016-09-03 12:00:00,611,137,314,162,476,613,2016-09-03 12:00:00,611,85659,85285
"2262",14677,2016-09-03 13:00:00,611,308,308,0,0,0,2016-09-03 13:00:00,611,291,658,323,981,1272,2016-09-03 13:00:00,611,96224,95793
"2263",14678,2016-09-03 14:00:00,611,338,338,0,0,0,2016-09-03 14:00:00,611,337,921,494,1415,1752,2016-09-03 14:00:00,611,103588,103084
"2264",14679,2016-09-03 15:00:00,611,322,322,0,0,0,2016-09-03 15:00:00,611,364,1116,535,1651,2015,2016-09-03 15:00:00,611,106939,106412
"2265",14680,2016-09-03 16:00:00,611,318,318,0,0,0,2016-09-03 16:00:00,611,424,1200,537,1737,2161,2016-09-03 16:00:00,611,104798,104283
"2266",14681,2016-09-03 17:00:00,611,308,308,0,0,0,2016-09-03 17:00:00,611,448,1269,566,1835,2283,2016-09-03 17:00:00,611,101577,101058
"2267",14682,2016-09-03 18:00:00,611,305,305,0,0,0,2016-09-03 18:00:00,611,489,1247,547,1794,2283,2016-09-03 18:00:00,611,98252,97740
"2268",14683,2016-09-03 19:00:00,611,247,247,0,0,0,2016-09-03 19:00:00,611,518,1297,566,1863,2381,2016-09-03 19:00:00,611,93666,93175
"2269",14684,2016-09-03 20:00:00,611,231,231,0,0,0,2016-09-03 20:00:00,611,432,1204,532,1736,2168,2016-09-03 20:00:00,611,87688,87219
"2270",14685,2016-09-03 21:00:00,611,202,202,0,0,0,2016-09-03 21:00:00,611,417,1203,524,1727,2144,2016-09-03 21:00:00,611,81044,80622
"2271",14686,2016-09-03 22:00:00,611,241,241,0,0,0,2016-09-03 22:00:00,611,318,1177,485,1662,1980,2016-09-03 22:00:00,611,74223,73811
"2272",14687,2016-09-03 23:00:00,611,261,261,0,0,0,2016-09-03 23:00:00,611,337,1138,470,1608,1945,2016-09-03 23:00:00,611,70871,70532
"2273",14688,2016-09-04 00:00:00,612,259,259,0,0,0,2016-09-04 00:00:00,612,319,978,423,1401,1720,2016-09-04 00:00:00,612,69673,69326
"2274",14689,2016-09-04 01:00:00,612,330,330,0,0,0,2016-09-04 01:00:00,612,260,1021,459,1480,1740,2016-09-04 01:00:00,612,70415,70060
"2275",14690,2016-09-04 02:00:00,612,282,282,0,0,0,2016-09-04 02:00:00,612,222,716,294,1010,1232,2016-09-04 02:00:00,612,69910,69530
"2276",14691,2016-09-04 03:00:00,612,204,204,0,0,0,2016-09-04 03:00:00,612,164,598,237,835,999,2016-09-04 03:00:00,612,69996,69694
"2277",14692,2016-09-04 04:00:00,612,226,226,0,0,0,2016-09-04 04:00:00,612,95,410,163,573,668,2016-09-04 04:00:00,612,69012,68676
"2278",14693,2016-09-04 05:00:00,612,186,186,0,0,0,2016-09-04 05:00:00,612,79,208,76,284,363,2016-09-04 05:00:00,612,64395,64102
"2279",14694,2016-09-04 06:00:00,612,161,161,0,0,0,2016-09-04 06:00:00,612,63,131,49,180,243,2016-09-04 06:00:00,612,61461,61180
"2280",14695,2016-09-04 07:00:00,612,163,163,0,0,0,2016-09-04 07:00:00,612,46,92,38,130,176,2016-09-04 07:00:00,612,60226,59930
"2281",14696,2016-09-04 08:00:00,612,153,153,0,0,0,2016-09-04 08:00:00,612,27,37,21,58,85,2016-09-04 08:00:00,612,59899,59636
"2282",14697,2016-09-04 09:00:00,612,142,142,0,0,0,2016-09-04 09:00:00,612,45,36,21,57,102,2016-09-04 09:00:00,612,60235,59937
"2283",14698,2016-09-04 10:00:00,612,168,168,0,0,0,2016-09-04 10:00:00,612,41,52,24,76,117,2016-09-04 10:00:00,612,63482,63200
"2284",14699,2016-09-04 11:00:00,612,185,185,0,0,0,2016-09-04 11:00:00,612,64,86,37,123,187,2016-09-04 11:00:00,612,70897,70568
"2285",14700,2016-09-04 12:00:00,612,206,206,0,0,0,2016-09-04 12:00:00,612,98,201,89,290,388,2016-09-04 12:00:00,612,79174,78818
"2286",14701,2016-09-04 13:00:00,612,290,290,0,0,0,2016-09-04 13:00:00,612,181,505,229,734,915,2016-09-04 13:00:00,612,88523,88162
"2287",14702,2016-09-04 14:00:00,612,292,292,0,0,0,2016-09-04 14:00:00,612,263,730,348,1078,1341,2016-09-04 14:00:00,612,96573,96150
"2288",14703,2016-09-04 15:00:00,612,344,344,0,0,0,2016-09-04 15:00:00,612,279,903,394,1297,1576,2016-09-04 15:00:00,612,100270,99767
"2289",14704,2016-09-04 16:00:00,612,345,345,0,0,0,2016-09-04 16:00:00,612,353,1033,454,1487,1840,2016-09-04 16:00:00,612,101317,100847
"2290",14705,2016-09-04 17:00:00,612,366,366,0,0,0,2016-09-04 17:00:00,612,337,1091,483,1574,1911,2016-09-04 17:00:00,612,100960,100418
"2291",14706,2016-09-04 18:00:00,612,389,389,0,0,0,2016-09-04 18:00:00,612,392,1149,512,1661,2053,2016-09-04 18:00:00,612,99271,98767
"2292",14707,2016-09-04 19:00:00,612,315,315,0,0,0,2016-09-04 19:00:00,612,348,1167,457,1624,1972,2016-09-04 19:00:00,612,95683,95214
"2293",14708,2016-09-04 20:00:00,612,289,289,0,0,0,2016-09-04 20:00:00,612,369,1041,448,1489,1858,2016-09-04 20:00:00,612,89344,88894
"2294",14709,2016-09-04 21:00:00,612,305,305,0,0,0,2016-09-04 21:00:00,612,381,1225,485,1710,2091,2016-09-04 21:00:00,612,83309,82916
"2295",14710,2016-09-04 22:00:00,612,308,308,0,0,0,2016-09-04 22:00:00,612,305,1054,408,1462,1767,2016-09-04 22:00:00,612,78046,77658
"2296",14711,2016-09-04 23:00:00,612,284,284,0,0,0,2016-09-04 23:00:00,612,275,1007,407,1414,1689,2016-09-04 23:00:00,612,78057,77701
"2297",14712,2016-09-05 00:00:00,613,319,319,0,0,0,2016-09-05 00:00:00,613,283,941,339,1280,1563,2016-09-05 00:00:00,613,88571,88196
"2298",14713,2016-09-05 01:00:00,613,331,331,0,0,0,2016-09-05 01:00:00,613,237,882,350,1232,1469,2016-09-05 01:00:00,613,97619,97206
"2299",14714,2016-09-05 02:00:00,613,242,242,0,0,0,2016-09-05 02:00:00,613,202,734,288,1022,1224,2016-09-05 02:00:00,613,91254,90827
"2300",14715,2016-09-05 03:00:00,613,253,253,0,0,0,2016-09-05 03:00:00,613,151,496,191,687,838,2016-09-05 03:00:00,613,86304,85935
"2301",14716,2016-09-05 04:00:00,613,259,259,0,0,0,2016-09-05 04:00:00,613,118,333,123,456,574,2016-09-05 04:00:00,613,83818,83415
"2302",14717,2016-09-05 05:00:00,613,251,251,0,0,0,2016-09-05 05:00:00,613,84,214,101,315,399,2016-09-05 05:00:00,613,82756,82411
"2303",14718,2016-09-05 06:00:00,613,226,226,0,0,0,2016-09-05 06:00:00,613,76,139,52,191,267,2016-09-05 06:00:00,613,92033,91623
"2304",14719,2016-09-05 07:00:00,613,233,233,0,0,0,2016-09-05 07:00:00,613,53,72,30,102,155,2016-09-05 07:00:00,613,95473,95010
"2305",14720,2016-09-05 08:00:00,613,200,200,0,0,0,2016-09-05 08:00:00,613,37,49,16,65,102,2016-09-05 08:00:00,613,93533,93022
"2306",14721,2016-09-05 09:00:00,613,184,184,0,0,0,2016-09-05 09:00:00,613,44,35,11,46,90,2016-09-05 09:00:00,613,91561,91097
"2307",14722,2016-09-05 10:00:00,613,181,181,0,0,0,2016-09-05 10:00:00,613,41,45,21,66,107,2016-09-05 10:00:00,613,90031,89601
"2308",14723,2016-09-05 11:00:00,613,186,186,0,0,0,2016-09-05 11:00:00,613,80,84,44,128,208,2016-09-05 11:00:00,613,100199,99737
"2309",14724,2016-09-05 12:00:00,613,307,307,0,0,0,2016-09-05 12:00:00,613,121,196,105,301,422,2016-09-05 12:00:00,613,116587,116056
"2310",14725,2016-09-05 13:00:00,613,327,327,0,0,0,2016-09-05 13:00:00,613,246,496,242,738,984,2016-09-05 13:00:00,613,131531,130918
"2311",14726,2016-09-05 14:00:00,613,422,422,0,0,0,2016-09-05 14:00:00,613,309,787,338,1125,1434,2016-09-05 14:00:00,613,137764,137152
"2312",14727,2016-09-05 15:00:00,613,419,419,0,0,0,2016-09-05 15:00:00,613,417,909,413,1322,1739,2016-09-05 15:00:00,613,133485,132844
"2313",14728,2016-09-05 16:00:00,613,451,451,0,0,0,2016-09-05 16:00:00,613,453,1059,465,1524,1977,2016-09-05 16:00:00,613,125863,125304
"2314",14729,2016-09-05 17:00:00,613,490,490,0,0,0,2016-09-05 17:00:00,613,530,1132,481,1613,2143,2016-09-05 17:00:00,613,121993,121414
"2315",14730,2016-09-05 18:00:00,613,492,492,0,0,0,2016-09-05 18:00:00,613,517,1155,492,1647,2164,2016-09-05 18:00:00,613,120038,119483
"2316",14731,2016-09-05 19:00:00,613,403,403,0,0,0,2016-09-05 19:00:00,613,480,1280,508,1788,2268,2016-09-05 19:00:00,613,115401,114800
"2317",14732,2016-09-05 20:00:00,613,404,404,0,0,0,2016-09-05 20:00:00,613,462,1284,537,1821,2283,2016-09-05 20:00:00,613,108964,108424
"2318",14733,2016-09-05 21:00:00,613,411,411,0,0,0,2016-09-05 21:00:00,613,481,1206,508,1714,2195,2016-09-05 21:00:00,613,99392,98877
"2319",14734,2016-09-05 22:00:00,613,383,383,0,0,0,2016-09-05 22:00:00,613,417,1193,460,1653,2070,2016-09-05 22:00:00,613,92785,92362
"2320",14735,2016-09-05 23:00:00,613,399,399,0,0,0,2016-09-05 23:00:00,613,375,1108,450,1558,1933,2016-09-05 23:00:00,613,91169,90731
"2321",14736,2016-09-06 00:00:00,614,342,342,0,0,0,2016-09-06 00:00:00,614,333,868,338,1206,1539,2016-09-06 00:00:00,614,96894,96427
"2322",14737,2016-09-06 01:00:00,614,386,386,0,0,0,2016-09-06 01:00:00,614,308,823,330,1153,1461,2016-09-06 01:00:00,614,100255,99791
"2323",14738,2016-09-06 02:00:00,614,296,296,0,0,0,2016-09-06 02:00:00,614,216,593,227,820,1036,2016-09-06 02:00:00,614,95067,94652
"2324",14739,2016-09-06 03:00:00,614,263,263,0,0,0,2016-09-06 03:00:00,614,171,423,181,604,775,2016-09-06 03:00:00,614,90300,89914
"2325",14740,2016-09-06 04:00:00,614,213,213,0,0,0,2016-09-06 04:00:00,614,122,270,121,391,513,2016-09-06 04:00:00,614,85162,84811
"2326",14741,2016-09-06 05:00:00,614,193,193,0,0,0,2016-09-06 05:00:00,614,85,148,67,215,300,2016-09-06 05:00:00,614,82687,82308
"2327",14742,2016-09-06 06:00:00,614,178,178,0,0,0,2016-09-06 06:00:00,614,46,69,35,104,150,2016-09-06 06:00:00,614,90651,90229
"2328",14743,2016-09-06 07:00:00,614,174,174,0,0,0,2016-09-06 07:00:00,614,46,42,15,57,103,2016-09-06 07:00:00,614,94905,94436
"2329",14744,2016-09-06 08:00:00,614,173,173,0,0,0,2016-09-06 08:00:00,614,17,28,11,39,56,2016-09-06 08:00:00,614,96827,96308
"2330",14745,2016-09-06 09:00:00,614,165,165,0,0,0,2016-09-06 09:00:00,614,28,25,17,42,70,2016-09-06 09:00:00,614,101503,100999
"2331",14746,2016-09-06 10:00:00,614,229,229,0,0,0,2016-09-06 10:00:00,614,41,36,23,59,100,2016-09-06 10:00:00,614,125711,125190
"2332",14747,2016-09-06 11:00:00,614,214,214,0,0,0,2016-09-06 11:00:00,614,85,89,54,143,228,2016-09-06 11:00:00,614,222061,221553
"2333",14748,2016-09-06 12:00:00,614,294,294,0,0,0,2016-09-06 12:00:00,614,151,166,99,265,416,2016-09-06 12:00:00,614,351110,350422
"2334",14749,2016-09-06 13:00:00,614,389,389,0,0,0,2016-09-06 13:00:00,614,386,463,245,708,1094,2016-09-06 13:00:00,614,370943,370069
"2335",14750,2016-09-06 14:00:00,614,509,509,0,0,0,2016-09-06 14:00:00,614,493,628,360,988,1481,2016-09-06 14:00:00,614,332010,331065
"2336",14751,2016-09-06 15:00:00,614,513,513,0,0,0,2016-09-06 15:00:00,614,575,710,366,1076,1651,2016-09-06 15:00:00,614,301204,300279
"2337",14752,2016-09-06 16:00:00,614,450,450,0,0,0,2016-09-06 16:00:00,614,670,878,439,1317,1987,2016-09-06 16:00:00,614,248927,248065
"2338",14753,2016-09-06 17:00:00,614,516,516,0,0,0,2016-09-06 17:00:00,614,684,913,455,1368,2052,2016-09-06 17:00:00,614,235569,234712
"2339",14754,2016-09-06 18:00:00,614,511,510,1,0,1,2016-09-06 18:00:00,614,765,1362,686,2048,2813,2016-09-06 18:00:00,614,227921,227038
"2340",14755,2016-09-06 19:00:00,614,486,486,0,0,0,2016-09-06 19:00:00,614,798,1257,605,1862,2660,2016-09-06 19:00:00,614,210674,209821
"2341",14756,2016-09-06 20:00:00,614,475,475,0,0,0,2016-09-06 20:00:00,614,805,1274,606,1880,2685,2016-09-06 20:00:00,614,188118,187364
"2342",14757,2016-09-06 21:00:00,614,452,452,0,0,0,2016-09-06 21:00:00,614,741,1386,636,2022,2763,2016-09-06 21:00:00,614,154422,153816
"2343",14758,2016-09-06 22:00:00,614,311,311,0,0,0,2016-09-06 22:00:00,614,636,1396,614,2010,2646,2016-09-06 22:00:00,614,72573,72435
"2344",14759,2016-09-06 23:00:00,614,154,154,0,0,0,2016-09-06 23:00:00,614,583,1431,640,2071,2654,2016-09-06 23:00:00,614,45503,45469
"2345",14760,2016-09-07 00:00:00,615,409,407,2,2,0,2016-09-07 00:00:00,615,436,1108,458,1566,2002,2016-09-07 00:00:00,615,106628,106193
"2346",14761,2016-09-07 01:00:00,615,363,363,0,0,0,2016-09-07 01:00:00,615,370,936,391,1327,1697,2016-09-07 01:00:00,615,105633,105169
"2347",14762,2016-09-07 02:00:00,615,307,307,0,0,0,2016-09-07 02:00:00,615,255,597,240,837,1092,2016-09-07 02:00:00,615,100250,99802
"2348",14763,2016-09-07 03:00:00,615,271,271,0,0,0,2016-09-07 03:00:00,615,239,371,161,532,771,2016-09-07 03:00:00,615,92478,92077
"2349",14764,2016-09-07 04:00:00,615,241,239,2,2,0,2016-09-07 04:00:00,615,145,280,117,397,542,2016-09-07 04:00:00,615,85506,85102
"2350",14765,2016-09-07 05:00:00,615,237,226,11,6,5,2016-09-07 05:00:00,615,61,131,62,193,254,2016-09-07 05:00:00,615,82031,81645
"2351",14766,2016-09-07 06:00:00,615,192,184,8,4,4,2016-09-07 06:00:00,615,58,72,29,101,159,2016-09-07 06:00:00,615,89426,89044
"2352",14767,2016-09-07 07:00:00,615,212,191,21,6,15,2016-09-07 07:00:00,615,48,61,26,87,135,2016-09-07 07:00:00,615,93336,92867
"2353",14768,2016-09-07 08:00:00,615,216,199,17,6,11,2016-09-07 08:00:00,615,40,36,18,54,94,2016-09-07 08:00:00,615,94480,94012
"2354",14769,2016-09-07 09:00:00,615,190,181,9,2,7,2016-09-07 09:00:00,615,35,28,16,44,79,2016-09-07 09:00:00,615,95805,95322
"2355",14770,2016-09-07 10:00:00,615,218,201,17,7,10,2016-09-07 10:00:00,615,55,61,32,93,148,2016-09-07 10:00:00,615,101630,101170
"2356",14771,2016-09-07 11:00:00,615,280,258,22,11,11,2016-09-07 11:00:00,615,100,137,81,218,318,2016-09-07 11:00:00,615,136136,135672
"2357",14772,2016-09-07 12:00:00,615,366,346,20,9,11,2016-09-07 12:00:00,615,258,299,169,468,726,2016-09-07 12:00:00,615,206829,206190
"2358",14773,2016-09-07 13:00:00,615,430,384,46,27,19,2016-09-07 13:00:00,615,386,563,334,897,1283,2016-09-07 13:00:00,615,221690,220917
"2359",14774,2016-09-07 14:00:00,615,545,457,88,48,40,2016-09-07 14:00:00,615,490,592,315,907,1397,2016-09-07 14:00:00,615,232065,231135
"2360",14775,2016-09-07 15:00:00,615,624,482,142,60,82,2016-09-07 15:00:00,615,550,821,415,1236,1786,2016-09-07 15:00:00,615,224627,223717
"2361",14776,2016-09-07 16:00:00,615,616,484,132,57,75,2016-09-07 16:00:00,615,653,798,446,1244,1897,2016-09-07 16:00:00,615,208209,207372
"2362",14777,2016-09-07 17:00:00,615,662,517,145,67,78,2016-09-07 17:00:00,615,697,927,447,1374,2071,2016-09-07 17:00:00,615,201376,200528
"2363",14778,2016-09-07 18:00:00,615,703,535,168,54,114,2016-09-07 18:00:00,615,724,952,483,1435,2159,2016-09-07 18:00:00,615,197473,196639
"2364",14779,2016-09-07 19:00:00,615,645,451,194,78,116,2016-09-07 19:00:00,615,708,1199,559,1758,2466,2016-09-07 19:00:00,615,187507,186680
"2365",14780,2016-09-07 20:00:00,615,638,454,184,79,105,2016-09-07 20:00:00,615,756,1292,578,1870,2626,2016-09-07 20:00:00,615,171215,170470
"2366",14781,2016-09-07 21:00:00,615,722,490,232,77,155,2016-09-07 21:00:00,615,722,1446,658,2104,2826,2016-09-07 21:00:00,615,145108,144516
"2367",14782,2016-09-07 22:00:00,615,715,484,231,79,152,2016-09-07 22:00:00,615,579,1343,596,1939,2518,2016-09-07 22:00:00,615,120063,119522
"2368",14783,2016-09-07 23:00:00,615,711,462,249,86,163,2016-09-07 23:00:00,615,559,1386,624,2010,2569,2016-09-07 23:00:00,615,108887,108433
"2369",14784,2016-09-08 00:00:00,616,686,434,252,102,150,2016-09-08 00:00:00,616,448,1229,528,1757,2205,2016-09-08 00:00:00,616,105925,105415
"2370",14785,2016-09-08 01:00:00,616,668,434,234,86,148,2016-09-08 01:00:00,616,364,898,399,1297,1661,2016-09-08 01:00:00,616,107841,107361
"2371",14786,2016-09-08 02:00:00,616,547,365,182,66,116,2016-09-08 02:00:00,616,281,740,318,1058,1339,2016-09-08 02:00:00,616,99723,99243
"2372",14787,2016-09-08 03:00:00,616,466,301,165,67,98,2016-09-08 03:00:00,616,226,491,208,699,925,2016-09-08 03:00:00,616,91204,90805
"2373",14788,2016-09-08 04:00:00,616,381,259,122,46,76,2016-09-08 04:00:00,616,165,284,137,421,586,2016-09-08 04:00:00,616,85167,84774
"2374",14789,2016-09-08 05:00:00,616,262,189,73,27,46,2016-09-08 05:00:00,616,102,153,78,231,333,2016-09-08 05:00:00,616,82806,82426
"2375",14790,2016-09-08 06:00:00,616,210,155,55,31,24,2016-09-08 06:00:00,616,76,86,37,123,199,2016-09-08 06:00:00,616,91675,91271
"2376",14791,2016-09-08 07:00:00,616,190,149,41,21,20,2016-09-08 07:00:00,616,55,52,22,74,129,2016-09-08 07:00:00,616,94708,94261
"2377",14792,2016-09-08 08:00:00,616,204,162,42,15,27,2016-09-08 08:00:00,616,36,25,11,36,72,2016-09-08 08:00:00,616,95267,94785
"2378",14793,2016-09-08 09:00:00,616,193,158,35,19,16,2016-09-08 09:00:00,616,41,22,10,32,73,2016-09-08 09:00:00,616,96041,95587
"2379",14794,2016-09-08 10:00:00,616,202,166,36,13,23,2016-09-08 10:00:00,616,51,35,21,56,107,2016-09-08 10:00:00,616,98476,98013
"2380",14795,2016-09-08 11:00:00,616,251,198,53,25,28,2016-09-08 11:00:00,616,120,140,83,223,343,2016-09-08 11:00:00,616,121870,121409
"2381",14796,2016-09-08 12:00:00,616,373,296,77,40,37,2016-09-08 12:00:00,616,237,303,182,485,722,2016-09-08 12:00:00,616,167929,167320
"2382",14797,2016-09-08 13:00:00,616,450,334,116,56,60,2016-09-08 13:00:00,616,418,527,294,821,1239,2016-09-08 13:00:00,616,204837,204057
"2383",14798,2016-09-08 14:00:00,616,573,435,138,55,83,2016-09-08 14:00:00,616,564,565,308,873,1437,2016-09-08 14:00:00,616,216151,215273
"2384",14799,2016-09-08 15:00:00,616,589,421,168,82,86,2016-09-08 15:00:00,616,578,670,326,996,1574,2016-09-08 15:00:00,616,222871,221970
"2385",14800,2016-09-08 16:00:00,616,603,440,163,58,105,2016-09-08 16:00:00,616,612,848,425,1273,1885,2016-09-08 16:00:00,616,199849,199029
"2386",14801,2016-09-08 17:00:00,616,700,504,196,74,122,2016-09-08 17:00:00,616,676,984,462,1446,2122,2016-09-08 17:00:00,616,193185,192425
"2387",14802,2016-09-08 18:00:00,616,725,462,263,118,145,2016-09-08 18:00:00,616,716,923,460,1383,2099,2016-09-08 18:00:00,616,192921,192046
"2388",14803,2016-09-08 19:00:00,616,701,425,276,118,158,2016-09-08 19:00:00,616,766,1043,494,1537,2303,2016-09-08 19:00:00,616,182298,181511
"2389",14804,2016-09-08 20:00:00,616,799,451,348,120,228,2016-09-08 20:00:00,616,468,780,342,1122,1590,2016-09-08 20:00:00,616,166279,165555
"2390",14805,2016-09-08 21:00:00,616,876,459,417,163,254,2016-09-08 21:00:00,616,240,471,226,697,937,2016-09-08 21:00:00,616,139618,139039
"2391",14806,2016-09-08 22:00:00,616,905,446,459,140,319,2016-09-08 22:00:00,616,169,352,158,510,679,2016-09-08 22:00:00,616,116671,116172
"2392",14807,2016-09-08 23:00:00,616,852,422,430,144,286,2016-09-08 23:00:00,616,488,1159,483,1642,2130,2016-09-08 23:00:00,616,107230,106735
"2393",14808,2016-09-09 00:00:00,617,787,362,425,145,280,2016-09-09 00:00:00,617,430,1073,426,1499,1929,2016-09-09 00:00:00,617,103941,103475
"2394",14809,2016-09-09 01:00:00,617,799,341,458,163,295,2016-09-09 01:00:00,617,398,815,371,1186,1584,2016-09-09 01:00:00,617,104131,103661
"2395",14810,2016-09-09 02:00:00,617,666,333,333,108,225,2016-09-09 02:00:00,617,278,638,264,902,1180,2016-09-09 02:00:00,617,98976,98526
"2396",14811,2016-09-09 03:00:00,617,538,295,243,86,157,2016-09-09 03:00:00,617,232,462,213,675,907,2016-09-09 03:00:00,617,87778,87383
"2397",14812,2016-09-09 04:00:00,617,529,271,258,80,178,2016-09-09 04:00:00,617,186,298,123,421,607,2016-09-09 04:00:00,617,80803,80420
"2398",14813,2016-09-09 05:00:00,617,342,187,155,54,101,2016-09-09 05:00:00,617,101,166,80,246,347,2016-09-09 05:00:00,617,77575,77261
"2399",14814,2016-09-09 06:00:00,617,265,166,99,33,66,2016-09-09 06:00:00,617,60,85,38,123,183,2016-09-09 06:00:00,617,85231,84829
"2400",14815,2016-09-09 07:00:00,617,232,132,100,33,67,2016-09-09 07:00:00,617,61,58,27,85,146,2016-09-09 07:00:00,617,87979,87580
"2401",14816,2016-09-09 08:00:00,617,261,193,68,30,38,2016-09-09 08:00:00,617,51,32,13,45,96,2016-09-09 08:00:00,617,86875,86450
"2402",14817,2016-09-09 09:00:00,617,216,155,61,28,33,2016-09-09 09:00:00,617,38,38,21,59,97,2016-09-09 09:00:00,617,89315,88903
"2403",14818,2016-09-09 10:00:00,617,239,167,72,26,46,2016-09-09 10:00:00,617,60,77,44,121,181,2016-09-09 10:00:00,617,99749,99332
"2404",14819,2016-09-09 11:00:00,617,265,178,87,30,57,2016-09-09 11:00:00,617,105,124,66,190,295,2016-09-09 11:00:00,617,147205,146766
"2405",14820,2016-09-09 12:00:00,617,323,240,83,32,51,2016-09-09 12:00:00,617,241,319,169,488,729,2016-09-09 12:00:00,617,228795,228241
"2406",14821,2016-09-09 13:00:00,617,517,337,180,75,105,2016-09-09 13:00:00,617,406,540,290,830,1236,2016-09-09 13:00:00,617,269074,268265
"2407",14822,2016-09-09 14:00:00,617,609,382,227,92,135,2016-09-09 14:00:00,617,497,577,279,856,1353,2016-09-09 14:00:00,617,265353,264526
"2408",14823,2016-09-09 15:00:00,617,633,387,246,84,162,2016-09-09 15:00:00,617,335,453,221,674,1009,2016-09-09 15:00:00,617,253931,253115
"2409",14824,2016-09-09 16:00:00,617,623,370,253,101,152,2016-09-09 16:00:00,617,592,797,401,1198,1790,2016-09-09 16:00:00,617,225341,224546
"2410",14825,2016-09-09 17:00:00,617,683,435,248,89,159,2016-09-09 17:00:00,617,603,915,449,1364,1967,2016-09-09 17:00:00,617,215647,214858
"2411",14826,2016-09-09 18:00:00,617,748,453,295,110,185,2016-09-09 18:00:00,617,710,973,472,1445,2155,2016-09-09 18:00:00,617,209764,209002
"2412",14827,2016-09-09 19:00:00,617,741,409,332,116,216,2016-09-09 19:00:00,617,695,1075,488,1563,2258,2016-09-09 19:00:00,617,190311,189613
"2413",14828,2016-09-09 20:00:00,617,814,414,400,151,249,2016-09-09 20:00:00,617,628,1290,562,1852,2480,2016-09-09 20:00:00,617,168640,167969
"2414",14829,2016-09-09 21:00:00,617,813,397,416,145,271,2016-09-09 21:00:00,617,557,1393,566,1959,2516,2016-09-09 21:00:00,617,136052,135486
"2415",14830,2016-09-09 22:00:00,617,751,342,409,132,277,2016-09-09 22:00:00,617,492,1324,542,1866,2358,2016-09-09 22:00:00,617,109083,108633
"2416",14831,2016-09-09 23:00:00,617,792,360,432,132,300,2016-09-09 23:00:00,617,447,1273,519,1792,2239,2016-09-09 23:00:00,617,92122,91744
"2417",14832,2016-09-10 00:00:00,618,670,325,345,113,232,2016-09-10 00:00:00,618,415,1354,507,1861,2276,2016-09-10 00:00:00,618,83762,83371
"2418",14833,2016-09-10 01:00:00,618,793,329,464,137,327,2016-09-10 01:00:00,618,327,1205,434,1639,1966,2016-09-10 01:00:00,618,79746,79359
"2419",14834,2016-09-10 02:00:00,618,598,260,338,105,233,2016-09-10 02:00:00,618,276,991,348,1339,1615,2016-09-10 02:00:00,618,77043,76690
"2420",14835,2016-09-10 03:00:00,618,549,240,309,90,219,2016-09-10 03:00:00,618,243,767,250,1017,1260,2016-09-10 03:00:00,618,74389,74064
"2421",14836,2016-09-10 04:00:00,618,520,207,313,91,222,2016-09-10 04:00:00,618,170,498,191,689,859,2016-09-10 04:00:00,618,69369,69049
"2422",14837,2016-09-10 05:00:00,618,396,165,231,79,152,2016-09-10 05:00:00,618,118,249,100,349,467,2016-09-10 05:00:00,618,63402,63116
"2423",14838,2016-09-10 06:00:00,618,344,163,181,47,134,2016-09-10 06:00:00,618,75,133,49,182,257,2016-09-10 06:00:00,618,61083,60801
"2424",14839,2016-09-10 07:00:00,618,259,151,108,42,66,2016-09-10 07:00:00,618,52,77,33,110,162,2016-09-10 07:00:00,618,59635,59357
"2425",14840,2016-09-10 08:00:00,618,254,158,96,36,60,2016-09-10 08:00:00,618,43,45,14,59,102,2016-09-10 08:00:00,618,58028,57761
"2426",14841,2016-09-10 09:00:00,618,212,139,73,23,50,2016-09-10 09:00:00,618,42,34,16,50,92,2016-09-10 09:00:00,618,59513,59236
"2427",14842,2016-09-10 10:00:00,618,207,130,77,36,41,2016-09-10 10:00:00,618,49,28,11,39,88,2016-09-10 10:00:00,618,63561,63259
"2428",14843,2016-09-10 11:00:00,618,271,170,101,51,50,2016-09-10 11:00:00,618,76,128,66,194,270,2016-09-10 11:00:00,618,73967,73674
"2429",14844,2016-09-10 12:00:00,618,398,244,154,52,102,2016-09-10 12:00:00,618,187,262,118,380,567,2016-09-10 12:00:00,618,86519,86201
"2430",14845,2016-09-10 13:00:00,618,517,252,265,94,171,2016-09-10 13:00:00,618,282,620,317,937,1219,2016-09-10 13:00:00,618,98255,97841
"2431",14846,2016-09-10 14:00:00,618,683,384,299,108,191,2016-09-10 14:00:00,618,341,852,400,1252,1593,2016-09-10 14:00:00,618,106934,106494
"2432",14847,2016-09-10 15:00:00,618,709,325,384,147,237,2016-09-10 15:00:00,618,431,937,423,1360,1791,2016-09-10 15:00:00,618,108335,107862
"2433",14848,2016-09-10 16:00:00,618,810,362,448,172,276,2016-09-10 16:00:00,618,429,1164,486,1650,2079,2016-09-10 16:00:00,618,106402,105897
"2434",14849,2016-09-10 17:00:00,618,789,366,423,152,271,2016-09-10 17:00:00,618,495,1292,556,1848,2343,2016-09-10 17:00:00,618,103923,103442
"2435",14850,2016-09-10 18:00:00,618,911,422,489,168,321,2016-09-10 18:00:00,618,486,1283,555,1838,2324,2016-09-10 18:00:00,618,101491,100994
"2436",14851,2016-09-10 19:00:00,618,769,331,438,131,307,2016-09-10 19:00:00,618,454,1238,538,1776,2230,2016-09-10 19:00:00,618,96105,95634
"2437",14852,2016-09-10 20:00:00,618,792,295,497,171,326,2016-09-10 20:00:00,618,506,1227,503,1730,2236,2016-09-10 20:00:00,618,90663,90216
"2438",14853,2016-09-10 21:00:00,618,752,275,477,149,328,2016-09-10 21:00:00,618,425,1270,518,1788,2213,2016-09-10 21:00:00,618,84137,83699
"2439",14854,2016-09-10 22:00:00,618,789,326,463,154,309,2016-09-10 22:00:00,618,442,1273,527,1800,2242,2016-09-10 22:00:00,618,77467,77099
"2440",14855,2016-09-10 23:00:00,618,645,288,357,112,245,2016-09-10 23:00:00,618,355,1187,497,1684,2039,2016-09-10 23:00:00,618,73637,73280
"2441",14856,2016-09-11 00:00:00,619,856,337,519,171,348,2016-09-11 00:00:00,619,359,1026,397,1423,1782,2016-09-11 00:00:00,619,72177,71845
"2442",14857,2016-09-11 01:00:00,619,773,355,418,106,312,2016-09-11 01:00:00,619,273,980,372,1352,1625,2016-09-11 01:00:00,619,71401,71015
"2443",14858,2016-09-11 02:00:00,619,592,270,322,93,229,2016-09-11 02:00:00,619,234,720,284,1004,1238,2016-09-11 02:00:00,619,70617,70263
"2444",14859,2016-09-11 03:00:00,619,596,240,356,112,244,2016-09-11 03:00:00,619,185,512,206,718,903,2016-09-11 03:00:00,619,67226,66906
"2445",14860,2016-09-11 04:00:00,619,493,225,268,72,196,2016-09-11 04:00:00,619,147,392,159,551,698,2016-09-11 04:00:00,619,62545,62261
"2446",14861,2016-09-11 05:00:00,619,411,185,226,86,140,2016-09-11 05:00:00,619,87,180,67,247,334,2016-09-11 05:00:00,619,58207,57951
"2447",14862,2016-09-11 06:00:00,619,328,146,182,73,109,2016-09-11 06:00:00,619,67,119,55,174,241,2016-09-11 06:00:00,619,56268,56011
"2448",14863,2016-09-11 07:00:00,619,245,152,93,28,65,2016-09-11 07:00:00,619,31,83,24,107,138,2016-09-11 07:00:00,619,55576,55343
"2449",14864,2016-09-11 08:00:00,619,205,121,84,32,52,2016-09-11 08:00:00,619,38,37,12,49,87,2016-09-11 08:00:00,619,54973,54719
"2450",14865,2016-09-11 09:00:00,619,181,115,66,22,44,2016-09-11 09:00:00,619,46,33,17,50,96,2016-09-11 09:00:00,619,55016,54766
"2451",14866,2016-09-11 10:00:00,619,213,141,72,21,51,2016-09-11 10:00:00,619,40,34,20,54,94,2016-09-11 10:00:00,619,58050,57789
"2452",14867,2016-09-11 11:00:00,619,239,148,91,31,60,2016-09-11 11:00:00,619,75,68,36,104,179,2016-09-11 11:00:00,619,65205,64920
"2453",14868,2016-09-11 12:00:00,619,339,202,137,49,88,2016-09-11 12:00:00,619,100,215,113,328,428,2016-09-11 12:00:00,619,77561,77248
"2454",14869,2016-09-11 13:00:00,619,511,259,252,90,162,2016-09-11 13:00:00,619,199,480,231,711,910,2016-09-11 13:00:00,619,84936,84591
"2455",14870,2016-09-11 14:00:00,619,586,295,291,101,190,2016-09-11 14:00:00,619,265,786,339,1125,1390,2016-09-11 14:00:00,619,94274,93886
"2456",14871,2016-09-11 15:00:00,619,648,340,308,126,182,2016-09-11 15:00:00,619,293,931,387,1318,1611,2016-09-11 15:00:00,619,97524,97080
"2457",14872,2016-09-11 16:00:00,619,765,349,416,161,255,2016-09-11 16:00:00,619,353,1014,411,1425,1778,2016-09-11 16:00:00,619,98970,98489
"2458",14873,2016-09-11 17:00:00,619,778,380,398,153,245,2016-09-11 17:00:00,619,383,1060,442,1502,1885,2016-09-11 17:00:00,619,98287,97838
"2459",14874,2016-09-11 18:00:00,619,851,345,506,174,332,2016-09-11 18:00:00,619,405,1205,505,1710,2115,2016-09-11 18:00:00,619,98971,98473
"2460",14875,2016-09-11 19:00:00,619,852,307,545,191,354,2016-09-11 19:00:00,619,456,1152,504,1656,2112,2016-09-11 19:00:00,619,96498,96046
"2461",14876,2016-09-11 20:00:00,619,770,279,491,159,332,2016-09-11 20:00:00,619,394,1323,530,1853,2247,2016-09-11 20:00:00,619,91573,91137
"2462",14877,2016-09-11 21:00:00,619,780,311,469,169,300,2016-09-11 21:00:00,619,396,1299,512,1811,2207,2016-09-11 21:00:00,619,87688,87287
"2463",14878,2016-09-11 22:00:00,619,781,330,451,168,283,2016-09-11 22:00:00,619,369,1213,507,1720,2089,2016-09-11 22:00:00,619,85030,84631
"2464",14879,2016-09-11 23:00:00,619,651,291,360,136,224,2016-09-11 23:00:00,619,322,1131,478,1609,1931,2016-09-11 23:00:00,619,83094,82690
"2465",14880,2016-09-12 00:00:00,620,927,351,576,204,372,2016-09-12 00:00:00,620,304,964,402,1366,1670,2016-09-12 00:00:00,620,90967,90532
"2466",14881,2016-09-12 01:00:00,620,866,345,521,182,339,2016-09-12 01:00:00,620,234,742,316,1058,1292,2016-09-12 01:00:00,620,96443,96026
"2467",14882,2016-09-12 02:00:00,620,690,258,432,146,286,2016-09-12 02:00:00,620,218,468,220,688,906,2016-09-12 02:00:00,620,90251,89836
"2468",14883,2016-09-12 03:00:00,620,546,230,316,114,202,2016-09-12 03:00:00,620,140,341,160,501,641,2016-09-12 03:00:00,620,82122,81753
"2469",14884,2016-09-12 04:00:00,620,505,213,292,110,182,2016-09-12 04:00:00,620,107,223,81,304,411,2016-09-12 04:00:00,620,78269,77968
"2470",14885,2016-09-12 05:00:00,620,343,165,178,65,113,2016-09-12 05:00:00,620,79,110,55,165,244,2016-09-12 05:00:00,620,76462,76120
"2471",14886,2016-09-12 06:00:00,620,281,152,129,48,81,2016-09-12 06:00:00,620,42,60,25,85,127,2016-09-12 06:00:00,620,82899,82541
"2472",14887,2016-09-12 07:00:00,620,199,123,76,28,48,2016-09-12 07:00:00,620,41,37,19,56,97,2016-09-12 07:00:00,620,85024,84647
"2473",14888,2016-09-12 08:00:00,620,222,144,78,30,48,2016-09-12 08:00:00,620,29,32,16,48,77,2016-09-12 08:00:00,620,85455,85051
"2474",14889,2016-09-12 09:00:00,620,236,154,82,39,43,2016-09-12 09:00:00,620,27,22,11,33,60,2016-09-12 09:00:00,620,89831,89423
"2475",14890,2016-09-12 10:00:00,620,246,171,75,37,38,2016-09-12 10:00:00,620,50,48,30,78,128,2016-09-12 10:00:00,620,105781,105370
"2476",14891,2016-09-12 11:00:00,620,311,230,81,38,43,2016-09-12 11:00:00,620,80,138,84,222,302,2016-09-12 11:00:00,620,172554,172134
"2477",14892,2016-09-12 12:00:00,620,375,260,115,40,75,2016-09-12 12:00:00,620,249,307,188,495,744,2016-09-12 12:00:00,620,274953,274343
"2478",14893,2016-09-12 13:00:00,620,526,352,174,80,94,2016-09-12 13:00:00,620,464,536,325,861,1325,2016-09-12 13:00:00,620,315644,314810
"2479",14894,2016-09-12 14:00:00,620,646,434,212,81,131,2016-09-12 14:00:00,620,585,644,377,1021,1606,2016-09-12 14:00:00,620,304689,303785
"2480",14895,2016-09-12 15:00:00,620,667,411,256,111,145,2016-09-12 15:00:00,620,584,830,436,1266,1850,2016-09-12 15:00:00,620,288627,287711
"2481",14896,2016-09-12 16:00:00,620,698,404,294,114,180,2016-09-12 16:00:00,620,684,966,453,1419,2103,2016-09-12 16:00:00,620,253817,252965
"2482",14897,2016-09-12 17:00:00,620,745,480,265,104,161,2016-09-12 17:00:00,620,688,951,481,1432,2120,2016-09-12 17:00:00,620,243954,243118
"2483",14898,2016-09-12 18:00:00,620,821,489,332,137,195,2016-09-12 18:00:00,620,782,1008,512,1520,2302,2016-09-12 18:00:00,620,236514,235685
"2484",14899,2016-09-12 19:00:00,620,794,418,376,148,228,2016-09-12 19:00:00,620,781,1215,563,1778,2559,2016-09-12 19:00:00,620,221074,220253
"2485",14900,2016-09-12 20:00:00,620,803,427,376,131,245,2016-09-12 20:00:00,620,739,1314,605,1919,2658,2016-09-12 20:00:00,620,199262,198530
"2486",14901,2016-09-12 21:00:00,620,798,382,416,154,262,2016-09-12 21:00:00,620,659,1430,674,2104,2763,2016-09-12 21:00:00,620,162618,162026
"2487",14902,2016-09-12 22:00:00,620,871,414,457,158,299,2016-09-12 22:00:00,620,572,1539,705,2244,2816,2016-09-12 22:00:00,620,130520,130017
"2488",14903,2016-09-12 23:00:00,620,896,394,502,156,346,2016-09-12 23:00:00,620,555,1291,557,1848,2403,2016-09-12 23:00:00,620,116280,115835
"2489",14904,2016-09-13 00:00:00,621,787,333,454,143,311,2016-09-13 00:00:00,621,511,1141,478,1619,2130,2016-09-13 00:00:00,621,112531,112039
"2490",14905,2016-09-13 01:00:00,621,887,380,507,175,332,2016-09-13 01:00:00,621,361,1015,432,1447,1808,2016-09-13 01:00:00,621,110722,110213
"2491",14906,2016-09-13 02:00:00,621,621,315,306,111,195,2016-09-13 02:00:00,621,294,776,334,1110,1404,2016-09-13 02:00:00,621,102050,101577
"2492",14907,2016-09-13 03:00:00,621,519,259,260,78,182,2016-09-13 03:00:00,621,219,511,209,720,939,2016-09-13 03:00:00,621,92302,91881
"2493",14908,2016-09-13 04:00:00,621,522,270,252,85,167,2016-09-13 04:00:00,621,157,311,126,437,594,2016-09-13 04:00:00,621,81079,80704
"2494",14909,2016-09-13 05:00:00,621,415,208,207,77,130,2016-09-13 05:00:00,621,80,139,70,209,289,2016-09-13 05:00:00,621,77300,76971
"2495",14910,2016-09-13 06:00:00,621,329,179,150,59,91,2016-09-13 06:00:00,621,51,79,30,109,160,2016-09-13 06:00:00,621,84175,83777
"2496",14911,2016-09-13 07:00:00,621,246,150,96,46,50,2016-09-13 07:00:00,621,53,50,23,73,126,2016-09-13 07:00:00,621,88535,88094
"2497",14912,2016-09-13 08:00:00,621,209,162,47,20,27,2016-09-13 08:00:00,621,25,32,15,47,72,2016-09-13 08:00:00,621,88624,88128
"2498",14913,2016-09-13 09:00:00,621,248,167,81,37,44,2016-09-13 09:00:00,621,52,35,25,60,112,2016-09-13 09:00:00,621,90096,89664
"2499",14914,2016-09-13 10:00:00,621,229,142,87,31,56,2016-09-13 10:00:00,621,66,54,34,88,154,2016-09-13 10:00:00,621,98531,98087
"2500",14915,2016-09-13 11:00:00,621,289,187,102,36,66,2016-09-13 11:00:00,621,95,106,58,164,259,2016-09-13 11:00:00,621,141430,140985
"2501",14916,2016-09-13 12:00:00,621,386,240,146,66,80,2016-09-13 12:00:00,621,193,264,138,402,595,2016-09-13 12:00:00,621,209358,208725
"2502",14917,2016-09-13 13:00:00,621,513,358,155,56,99,2016-09-13 13:00:00,621,384,500,284,784,1168,2016-09-13 13:00:00,621,244511,243748
"2503",14918,2016-09-13 14:00:00,621,637,432,205,75,130,2016-09-13 14:00:00,621,478,578,302,880,1358,2016-09-13 14:00:00,621,246094,245235
"2504",14919,2016-09-13 15:00:00,621,684,459,225,101,124,2016-09-13 15:00:00,621,664,783,387,1170,1834,2016-09-13 15:00:00,621,238476,237651
"2505",14920,2016-09-13 16:00:00,621,713,481,232,88,144,2016-09-13 16:00:00,621,686,849,425,1274,1960,2016-09-13 16:00:00,621,213229,212356
"2506",14921,2016-09-13 17:00:00,621,843,502,341,106,235,2016-09-13 17:00:00,621,698,884,426,1310,2008,2016-09-13 17:00:00,621,207945,207152
"2507",14922,2016-09-13 18:00:00,621,738,414,324,110,214,2016-09-13 18:00:00,621,724,873,408,1281,2005,2016-09-13 18:00:00,621,205093,204259
"2508",14923,2016-09-13 19:00:00,621,791,423,368,122,246,2016-09-13 19:00:00,621,692,1069,490,1559,2251,2016-09-13 19:00:00,621,193185,192351
"2509",14924,2016-09-13 20:00:00,621,837,417,420,152,268,2016-09-13 20:00:00,621,734,1264,568,1832,2566,2016-09-13 20:00:00,621,175923,175111
"2510",14925,2016-09-13 21:00:00,621,833,421,412,135,277,2016-09-13 21:00:00,621,675,1405,626,2031,2706,2016-09-13 21:00:00,621,150030,149342
"2511",14926,2016-09-13 22:00:00,621,911,452,459,157,302,2016-09-13 22:00:00,621,648,1315,569,1884,2532,2016-09-13 22:00:00,621,124421,123823
"2512",14927,2016-09-13 23:00:00,621,841,374,467,155,312,2016-09-13 23:00:00,621,554,1299,541,1840,2394,2016-09-13 23:00:00,621,113417,112889
"2513",14928,2016-09-14 00:00:00,622,855,373,482,145,337,2016-09-14 00:00:00,622,496,1154,492,1646,2142,2016-09-14 00:00:00,622,110688,110166
"2514",14929,2016-09-14 01:00:00,622,803,345,458,148,310,2016-09-14 01:00:00,622,358,960,374,1334,1692,2016-09-14 01:00:00,622,109803,109237
"2515",14930,2016-09-14 02:00:00,622,684,253,431,168,263,2016-09-14 02:00:00,622,324,799,332,1131,1455,2016-09-14 02:00:00,622,104894,104343
"2516",14931,2016-09-14 03:00:00,622,607,299,308,77,231,2016-09-14 03:00:00,622,212,520,234,754,966,2016-09-14 03:00:00,622,96937,96454
"2517",14932,2016-09-14 04:00:00,622,516,259,257,80,177,2016-09-14 04:00:00,622,131,334,145,479,610,2016-09-14 04:00:00,622,89304,88873
"2518",14933,2016-09-14 05:00:00,622,388,194,194,63,131,2016-09-14 05:00:00,622,114,161,68,229,343,2016-09-14 05:00:00,622,84863,84460
"2519",14934,2016-09-14 06:00:00,622,273,160,113,35,78,2016-09-14 06:00:00,622,82,88,51,139,221,2016-09-14 06:00:00,622,92181,91720
"2520",14935,2016-09-14 07:00:00,622,264,178,86,29,57,2016-09-14 07:00:00,622,64,44,15,59,123,2016-09-14 07:00:00,622,98646,98162
"2521",14936,2016-09-14 08:00:00,622,258,189,69,33,36,2016-09-14 08:00:00,622,46,35,20,55,101,2016-09-14 08:00:00,622,98719,98219
"2522",14937,2016-09-14 09:00:00,622,264,176,88,40,48,2016-09-14 09:00:00,622,39,17,9,26,65,2016-09-14 09:00:00,622,100090,99553
"2523",14938,2016-09-14 10:00:00,622,239,165,74,31,43,2016-09-14 10:00:00,622,54,50,31,81,135,2016-09-14 10:00:00,622,104449,103974
"2524",14939,2016-09-14 11:00:00,622,304,232,72,25,47,2016-09-14 11:00:00,622,135,113,50,163,298,2016-09-14 11:00:00,622,133096,132564
"2525",14940,2016-09-14 12:00:00,622,463,308,155,66,89,2016-09-14 12:00:00,622,268,270,143,413,681,2016-09-14 12:00:00,622,182423,181772
"2526",14941,2016-09-14 13:00:00,622,575,390,185,83,102,2016-09-14 13:00:00,622,454,481,261,742,1196,2016-09-14 13:00:00,622,221077,220185
"2527",14942,2016-09-14 14:00:00,622,698,474,224,94,130,2016-09-14 14:00:00,622,581,637,319,956,1537,2016-09-14 14:00:00,622,232301,231322
"2528",14943,2016-09-14 15:00:00,622,768,514,254,105,149,2016-09-14 15:00:00,622,670,741,369,1110,1780,2016-09-14 15:00:00,622,228441,227448
"2529",14944,2016-09-14 16:00:00,622,769,493,276,117,159,2016-09-14 16:00:00,622,742,845,415,1260,2002,2016-09-14 16:00:00,622,219328,218384
"2530",14945,2016-09-14 17:00:00,622,801,496,305,117,188,2016-09-14 17:00:00,622,731,861,429,1290,2021,2016-09-14 17:00:00,622,208847,207935
"2531",14946,2016-09-14 18:00:00,622,864,525,339,130,209,2016-09-14 18:00:00,622,808,849,379,1228,2036,2016-09-14 18:00:00,622,205284,204316
"2532",14947,2016-09-14 19:00:00,622,812,443,369,116,253,2016-09-14 19:00:00,622,828,1080,498,1578,2406,2016-09-14 19:00:00,622,193202,192287
"2533",14948,2016-09-14 20:00:00,622,907,475,432,154,278,2016-09-14 20:00:00,622,743,1202,535,1737,2480,2016-09-14 20:00:00,622,177048,176204
"2534",14949,2016-09-14 21:00:00,622,881,440,441,140,301,2016-09-14 21:00:00,622,739,1349,579,1928,2667,2016-09-14 21:00:00,622,150352,149655
"2535",14950,2016-09-14 22:00:00,622,932,453,479,176,303,2016-09-14 22:00:00,622,554,1260,536,1796,2350,2016-09-14 22:00:00,622,126991,126420
"2536",14951,2016-09-14 23:00:00,622,889,438,451,133,318,2016-09-14 23:00:00,622,581,1316,528,1844,2425,2016-09-14 23:00:00,622,116777,116267
"2537",14952,2016-09-15 00:00:00,623,888,388,500,174,326,2016-09-15 00:00:00,623,453,1216,516,1732,2185,2016-09-15 00:00:00,623,111694,111168
"2538",14953,2016-09-15 01:00:00,623,835,398,437,127,310,2016-09-15 01:00:00,623,418,903,371,1274,1692,2016-09-15 01:00:00,623,111358,110829
"2539",14954,2016-09-15 02:00:00,623,695,354,341,125,216,2016-09-15 02:00:00,623,279,717,297,1014,1293,2016-09-15 02:00:00,623,105723,105222
"2540",14955,2016-09-15 03:00:00,623,563,288,275,105,170,2016-09-15 03:00:00,623,252,487,184,671,923,2016-09-15 03:00:00,623,97651,97189
"2541",14956,2016-09-15 04:00:00,623,491,264,227,75,152,2016-09-15 04:00:00,623,155,346,137,483,638,2016-09-15 04:00:00,623,89242,88836
"2542",14957,2016-09-15 05:00:00,623,382,216,166,52,114,2016-09-15 05:00:00,623,127,152,71,223,350,2016-09-15 05:00:00,623,85572,85190
"2543",14958,2016-09-15 06:00:00,623,305,175,130,41,89,2016-09-15 06:00:00,623,72,86,28,114,186,2016-09-15 06:00:00,623,93629,93182
"2544",14959,2016-09-15 07:00:00,623,297,200,97,41,56,2016-09-15 07:00:00,623,59,60,22,82,141,2016-09-15 07:00:00,623,100085,99604
"2545",14960,2016-09-15 08:00:00,623,225,169,56,23,33,2016-09-15 08:00:00,623,40,29,14,43,83,2016-09-15 08:00:00,623,99953,99441
"2546",14961,2016-09-15 09:00:00,623,247,188,59,20,39,2016-09-15 09:00:00,623,70,27,15,42,112,2016-09-15 09:00:00,623,101245,100772
"2547",14962,2016-09-15 10:00:00,623,248,179,69,28,41,2016-09-15 10:00:00,623,65,56,26,82,147,2016-09-15 10:00:00,623,108884,108394
"2548",14963,2016-09-15 11:00:00,623,272,213,59,25,34,2016-09-15 11:00:00,623,114,147,75,222,336,2016-09-15 11:00:00,623,146379,145850
"2549",14964,2016-09-15 12:00:00,623,435,321,114,46,68,2016-09-15 12:00:00,623,294,297,151,448,742,2016-09-15 12:00:00,623,217544,216789
"2550",14965,2016-09-15 13:00:00,623,592,410,182,72,110,2016-09-15 13:00:00,623,476,495,244,739,1215,2016-09-15 13:00:00,623,262332,261453
"2551",14966,2016-09-15 14:00:00,623,709,522,187,72,115,2016-09-15 14:00:00,623,581,611,324,935,1516,2016-09-15 14:00:00,623,272199,271157
"2552",14967,2016-09-15 15:00:00,623,725,485,240,101,139,2016-09-15 15:00:00,623,702,704,369,1073,1775,2016-09-15 15:00:00,623,267176,266150
"2553",14968,2016-09-15 16:00:00,623,796,537,259,101,158,2016-09-15 16:00:00,623,751,834,431,1265,2016,2016-09-15 16:00:00,623,243670,242725
"2554",14969,2016-09-15 17:00:00,623,806,520,286,113,173,2016-09-15 17:00:00,623,817,910,422,1332,2149,2016-09-15 17:00:00,623,240193,239316
"2555",14970,2016-09-15 18:00:00,623,838,519,319,129,190,2016-09-15 18:00:00,623,776,884,412,1296,2072,2016-09-15 18:00:00,623,239555,238657
"2556",14971,2016-09-15 19:00:00,623,834,514,320,128,192,2016-09-15 19:00:00,623,851,1088,473,1561,2412,2016-09-15 19:00:00,623,222525,221693
"2557",14972,2016-09-15 20:00:00,623,898,490,408,164,244,2016-09-15 20:00:00,623,737,1242,552,1794,2531,2016-09-15 20:00:00,623,200554,199765
"2558",14973,2016-09-15 21:00:00,623,858,441,417,152,265,2016-09-15 21:00:00,623,689,1456,617,2073,2762,2016-09-15 21:00:00,623,164053,163400
"2559",14974,2016-09-15 22:00:00,623,844,389,455,154,301,2016-09-15 22:00:00,623,663,1461,589,2050,2713,2016-09-15 22:00:00,623,131070,130513
"2560",14975,2016-09-15 23:00:00,623,859,432,427,129,298,2016-09-15 23:00:00,623,591,1436,599,2035,2626,2016-09-15 23:00:00,623,116312,115819
"2561",14976,2016-09-16 00:00:00,624,911,395,516,175,341,2016-09-16 00:00:00,624,474,1236,539,1775,2249,2016-09-16 00:00:00,624,110110,109545
"2562",14977,2016-09-16 01:00:00,624,924,388,536,180,356,2016-09-16 01:00:00,624,354,1151,451,1602,1956,2016-09-16 01:00:00,624,107623,107144
"2563",14978,2016-09-16 02:00:00,624,765,344,421,131,290,2016-09-16 02:00:00,624,307,755,325,1080,1387,2016-09-16 02:00:00,624,99152,98692
"2564",14979,2016-09-16 03:00:00,624,702,297,405,142,263,2016-09-16 03:00:00,624,215,573,226,799,1014,2016-09-16 03:00:00,624,91065,90623
"2565",14980,2016-09-16 04:00:00,624,597,222,375,126,249,2016-09-16 04:00:00,624,148,563,197,760,908,2016-09-16 04:00:00,624,83039,82636
"2566",14981,2016-09-16 05:00:00,624,486,175,311,106,205,2016-09-16 05:00:00,624,104,319,116,435,539,2016-09-16 05:00:00,624,80139,79776
"2567",14982,2016-09-16 06:00:00,624,361,170,191,63,128,2016-09-16 06:00:00,624,67,153,67,220,287,2016-09-16 06:00:00,624,87307,86881
"2568",14983,2016-09-16 07:00:00,624,295,164,131,40,91,2016-09-16 07:00:00,624,50,100,40,140,190,2016-09-16 07:00:00,624,90396,89947
"2569",14984,2016-09-16 08:00:00,624,298,198,100,36,64,2016-09-16 08:00:00,624,53,53,21,74,127,2016-09-16 08:00:00,624,90287,89871
"2570",14985,2016-09-16 09:00:00,624,279,173,106,57,49,2016-09-16 09:00:00,624,40,55,25,80,120,2016-09-16 09:00:00,624,94525,94042
"2571",14986,2016-09-16 10:00:00,624,276,175,101,39,62,2016-09-16 10:00:00,624,59,83,32,115,174,2016-09-16 10:00:00,624,104522,104104
"2572",14987,2016-09-16 11:00:00,624,323,220,103,40,63,2016-09-16 11:00:00,624,110,250,116,366,476,2016-09-16 11:00:00,624,149409,148904
"2573",14988,2016-09-16 12:00:00,624,418,299,119,47,72,2016-09-16 12:00:00,624,274,434,219,653,927,2016-09-16 12:00:00,624,221731,221086
"2574",14989,2016-09-16 13:00:00,624,617,395,222,93,129,2016-09-16 13:00:00,624,490,713,356,1069,1559,2016-09-16 13:00:00,624,254191,253374
"2575",14990,2016-09-16 14:00:00,624,747,492,255,87,168,2016-09-16 14:00:00,624,641,809,393,1202,1843,2016-09-16 14:00:00,624,251531,250596
"2576",14991,2016-09-16 15:00:00,624,674,421,253,85,168,2016-09-16 15:00:00,624,739,893,435,1328,2067,2016-09-16 15:00:00,624,241374,240422
"2577",14992,2016-09-16 16:00:00,624,859,519,340,131,209,2016-09-16 16:00:00,624,705,1066,491,1557,2262,2016-09-16 16:00:00,624,215698,214841
"2578",14993,2016-09-16 17:00:00,624,761,489,272,69,203,2016-09-16 17:00:00,624,798,1268,522,1790,2588,2016-09-16 17:00:00,624,207916,207057
"2579",14994,2016-09-16 18:00:00,624,957,482,475,170,305,2016-09-16 18:00:00,624,802,1387,587,1974,2776,2016-09-16 18:00:00,624,200603,199797
"2580",14995,2016-09-16 19:00:00,624,898,430,468,169,299,2016-09-16 19:00:00,624,822,1450,629,2079,2901,2016-09-16 19:00:00,624,185741,184966
"2581",14996,2016-09-16 20:00:00,624,967,465,502,171,331,2016-09-16 20:00:00,624,838,1510,593,2103,2941,2016-09-16 20:00:00,624,164221,163527
"2582",14997,2016-09-16 21:00:00,624,735,385,350,122,228,2016-09-16 21:00:00,624,658,1514,608,2122,2780,2016-09-16 21:00:00,624,135180,134575
"2583",14998,2016-09-16 22:00:00,624,923,374,549,172,377,2016-09-16 22:00:00,624,579,1477,623,2100,2679,2016-09-16 22:00:00,624,109479,108963
"2584",14999,2016-09-16 23:00:00,624,918,424,494,145,349,2016-09-16 23:00:00,624,504,1423,602,2025,2529,2016-09-16 23:00:00,624,96087,95662
"2585",15000,2016-09-17 00:00:00,625,785,345,440,149,291,2016-09-17 00:00:00,625,434,1369,525,1894,2328,2016-09-17 00:00:00,625,88196,87777
"2586",15001,2016-09-17 01:00:00,625,884,342,542,153,389,2016-09-17 01:00:00,625,353,1286,509,1795,2148,2016-09-17 01:00:00,625,84208,83803
"2587",15002,2016-09-17 02:00:00,625,678,288,390,115,275,2016-09-17 02:00:00,625,306,1014,371,1385,1691,2016-09-17 02:00:00,625,81421,81065
"2588",15003,2016-09-17 03:00:00,625,598,243,355,92,263,2016-09-17 03:00:00,625,263,800,333,1133,1396,2016-09-17 03:00:00,625,77904,77530
"2589",15004,2016-09-17 04:00:00,625,561,225,336,89,247,2016-09-17 04:00:00,625,154,546,216,762,916,2016-09-17 04:00:00,625,72468,72146
"2590",15005,2016-09-17 05:00:00,625,416,158,258,85,173,2016-09-17 05:00:00,625,106,293,111,404,510,2016-09-17 05:00:00,625,67870,67539
"2591",15006,2016-09-17 06:00:00,625,309,153,156,55,101,2016-09-17 06:00:00,625,82,157,71,228,310,2016-09-17 06:00:00,625,65117,64807
"2592",15007,2016-09-17 07:00:00,625,271,149,122,42,80,2016-09-17 07:00:00,625,53,74,30,104,157,2016-09-17 07:00:00,625,64983,64682
"2593",15008,2016-09-17 08:00:00,625,231,134,97,42,55,2016-09-17 08:00:00,625,74,55,21,76,150,2016-09-17 08:00:00,625,63853,63499
"2594",15009,2016-09-17 09:00:00,625,225,133,92,36,56,2016-09-17 09:00:00,625,46,24,7,31,77,2016-09-17 09:00:00,625,65987,65675
"2595",15010,2016-09-17 10:00:00,625,265,160,105,39,66,2016-09-17 10:00:00,625,68,45,19,64,132,2016-09-17 10:00:00,625,70823,70504
"2596",15011,2016-09-17 11:00:00,625,279,180,99,30,69,2016-09-17 11:00:00,625,77,164,69,233,310,2016-09-17 11:00:00,625,80554,80173
"2597",15012,2016-09-17 12:00:00,625,379,210,169,64,105,2016-09-17 12:00:00,625,204,374,165,539,743,2016-09-17 12:00:00,625,95349,94906
"2598",15013,2016-09-17 13:00:00,625,627,299,328,126,202,2016-09-17 13:00:00,625,341,804,356,1160,1501,2016-09-17 13:00:00,625,107319,106886
"2599",15014,2016-09-17 14:00:00,625,799,331,468,187,281,2016-09-17 14:00:00,625,452,1193,521,1714,2166,2016-09-17 14:00:00,625,115521,114997
"2600",15015,2016-09-17 15:00:00,625,788,274,514,168,346,2016-09-17 15:00:00,625,462,1124,462,1586,2048,2016-09-17 15:00:00,625,119142,118575
"2601",15016,2016-09-17 16:00:00,625,809,302,507,173,334,2016-09-17 16:00:00,625,524,1376,602,1978,2502,2016-09-17 16:00:00,625,117026,116461
"2602",15017,2016-09-17 17:00:00,625,863,312,551,181,370,2016-09-17 17:00:00,625,639,1385,583,1968,2607,2016-09-17 17:00:00,625,113865,113268
"2603",15018,2016-09-17 18:00:00,625,1003,367,636,231,405,2016-09-17 18:00:00,625,594,1392,575,1967,2561,2016-09-17 18:00:00,625,109588,109015
"2604",15019,2016-09-17 19:00:00,625,855,275,580,205,375,2016-09-17 19:00:00,625,584,1275,523,1798,2382,2016-09-17 19:00:00,625,104299,103787
"2605",15020,2016-09-17 20:00:00,625,873,298,575,172,403,2016-09-17 20:00:00,625,539,1277,532,1809,2348,2016-09-17 20:00:00,625,97368,96862
"2606",15021,2016-09-17 21:00:00,625,918,309,609,234,375,2016-09-17 21:00:00,625,459,1200,453,1653,2112,2016-09-17 21:00:00,625,89480,89035
"2607",15022,2016-09-17 22:00:00,625,922,357,565,184,381,2016-09-17 22:00:00,625,421,1238,512,1750,2171,2016-09-17 22:00:00,625,83189,82753
"2608",15023,2016-09-17 23:00:00,625,781,337,444,164,280,2016-09-17 23:00:00,625,422,1086,422,1508,1930,2016-09-17 23:00:00,625,79137,78721
"2609",15024,2016-09-18 00:00:00,626,908,347,561,170,391,2016-09-18 00:00:00,626,364,1278,465,1743,2107,2016-09-18 00:00:00,626,80786,80384
"2610",15025,2016-09-18 01:00:00,626,856,331,525,129,396,2016-09-18 01:00:00,626,346,1052,398,1450,1796,2016-09-18 01:00:00,626,81470,81072
"2611",15026,2016-09-18 02:00:00,626,628,283,345,111,234,2016-09-18 02:00:00,626,239,752,292,1044,1283,2016-09-18 02:00:00,626,79397,78979
"2612",15027,2016-09-18 03:00:00,626,621,234,387,120,267,2016-09-18 03:00:00,626,204,528,207,735,939,2016-09-18 03:00:00,626,77789,77404
"2613",15028,2016-09-18 04:00:00,626,551,219,332,109,223,2016-09-18 04:00:00,626,137,385,156,541,678,2016-09-18 04:00:00,626,75620,75275
"2614",15029,2016-09-18 05:00:00,626,466,194,272,110,162,2016-09-18 05:00:00,626,93,231,103,334,427,2016-09-18 05:00:00,626,71382,71074
"2615",15030,2016-09-18 06:00:00,626,380,169,211,78,133,2016-09-18 06:00:00,626,68,130,53,183,251,2016-09-18 06:00:00,626,68116,67769
"2616",15031,2016-09-18 07:00:00,626,274,136,138,60,78,2016-09-18 07:00:00,626,64,92,41,133,197,2016-09-18 07:00:00,626,66541,66221
"2617",15032,2016-09-18 08:00:00,626,250,147,103,38,65,2016-09-18 08:00:00,626,50,56,22,78,128,2016-09-18 08:00:00,626,65348,65058
"2618",15033,2016-09-18 09:00:00,626,191,104,87,36,51,2016-09-18 09:00:00,626,61,43,22,65,126,2016-09-18 09:00:00,626,65211,64909
"2619",15034,2016-09-18 10:00:00,626,215,127,88,34,54,2016-09-18 10:00:00,626,39,46,22,68,107,2016-09-18 10:00:00,626,67890,67537
"2620",15035,2016-09-18 11:00:00,626,243,157,86,30,56,2016-09-18 11:00:00,626,70,108,49,157,227,2016-09-18 11:00:00,626,75550,75192
"2621",15036,2016-09-18 12:00:00,626,372,176,196,85,111,2016-09-18 12:00:00,626,129,249,116,365,494,2016-09-18 12:00:00,626,85746,85363
"2622",15037,2016-09-18 13:00:00,626,489,233,256,89,167,2016-09-18 13:00:00,626,243,587,276,863,1106,2016-09-18 13:00:00,626,96394,95978
"2623",15038,2016-09-18 14:00:00,626,684,297,387,135,252,2016-09-18 14:00:00,626,311,879,390,1269,1580,2016-09-18 14:00:00,626,106640,106139
"2624",15039,2016-09-18 15:00:00,626,841,346,495,173,322,2016-09-18 15:00:00,626,422,1082,486,1568,1990,2016-09-18 15:00:00,626,112162,111605
"2625",15040,2016-09-18 16:00:00,626,826,342,484,176,308,2016-09-18 16:00:00,626,450,1174,496,1670,2120,2016-09-18 16:00:00,626,112543,111990
"2626",15041,2016-09-18 17:00:00,626,885,380,505,185,320,2016-09-18 17:00:00,626,493,1112,450,1562,2055,2016-09-18 17:00:00,626,111262,110707
"2627",15042,2016-09-18 18:00:00,626,941,407,534,167,367,2016-09-18 18:00:00,626,465,1194,502,1696,2161,2016-09-18 18:00:00,626,110227,109643
"2628",15043,2016-09-18 19:00:00,626,867,307,560,200,360,2016-09-18 19:00:00,626,452,1202,493,1695,2147,2016-09-18 19:00:00,626,107970,107425
"2629",15044,2016-09-18 20:00:00,626,829,266,563,174,389,2016-09-18 20:00:00,626,510,1249,497,1746,2256,2016-09-18 20:00:00,626,101675,101164
"2630",15045,2016-09-18 21:00:00,626,870,316,554,185,369,2016-09-18 21:00:00,626,451,1341,516,1857,2308,2016-09-18 21:00:00,626,97931,97453
"2631",15046,2016-09-18 22:00:00,626,892,365,527,171,356,2016-09-18 22:00:00,626,415,1240,535,1775,2190,2016-09-18 22:00:00,626,93325,92889
"2632",15047,2016-09-18 23:00:00,626,835,351,484,162,322,2016-09-18 23:00:00,626,333,1105,427,1532,1865,2016-09-18 23:00:00,626,94530,94076
"2633",15048,2016-09-19 00:00:00,627,860,344,516,147,369,2016-09-19 00:00:00,627,361,1033,412,1445,1806,2016-09-19 00:00:00,627,103767,103264
"2634",15049,2016-09-19 01:00:00,627,850,373,477,141,336,2016-09-19 01:00:00,627,310,843,338,1181,1491,2016-09-19 01:00:00,627,109738,109284
"2635",15050,2016-09-19 02:00:00,627,732,338,394,128,266,2016-09-19 02:00:00,627,199,588,222,810,1009,2016-09-19 02:00:00,627,101505,101037
"2636",15051,2016-09-19 03:00:00,627,576,242,334,124,210,2016-09-19 03:00:00,627,171,361,159,520,691,2016-09-19 03:00:00,627,96039,95632
"2637",15052,2016-09-19 04:00:00,627,544,249,295,89,206,2016-09-19 04:00:00,627,117,292,116,408,525,2016-09-19 04:00:00,627,92083,91699
"2638",15053,2016-09-19 05:00:00,627,390,215,175,55,120,2016-09-19 05:00:00,627,95,121,54,175,270,2016-09-19 05:00:00,627,91780,91392
"2639",15054,2016-09-19 06:00:00,627,292,186,106,39,67,2016-09-19 06:00:00,627,72,61,26,87,159,2016-09-19 06:00:00,627,100267,99785
"2640",15055,2016-09-19 07:00:00,627,259,164,95,35,60,2016-09-19 07:00:00,627,42,59,25,84,126,2016-09-19 07:00:00,627,108317,107885
"2641",15056,2016-09-19 08:00:00,627,242,176,66,32,34,2016-09-19 08:00:00,627,33,37,12,49,82,2016-09-19 08:00:00,627,103720,103202
"2642",15057,2016-09-19 09:00:00,627,242,174,68,25,43,2016-09-19 09:00:00,627,44,30,16,46,90,2016-09-19 09:00:00,627,108866,108342
"2643",15058,2016-09-19 10:00:00,627,269,198,71,28,43,2016-09-19 10:00:00,627,63,50,24,74,137,2016-09-19 10:00:00,627,127646,127148
"2644",15059,2016-09-19 11:00:00,627,303,231,72,27,45,2016-09-19 11:00:00,627,135,141,62,203,338,2016-09-19 11:00:00,627,208141,207599
"2645",15060,2016-09-19 12:00:00,627,438,277,161,67,94,2016-09-19 12:00:00,627,291,329,173,502,793,2016-09-19 12:00:00,627,327511,326758
"2646",15061,2016-09-19 13:00:00,627,559,362,197,88,109,2016-09-19 13:00:00,627,480,589,307,896,1376,2016-09-19 13:00:00,627,359173,358244
"2647",15062,2016-09-19 14:00:00,627,735,466,269,104,165,2016-09-19 14:00:00,627,623,665,333,998,1621,2016-09-19 14:00:00,627,331652,330654
"2648",15063,2016-09-19 15:00:00,627,795,452,343,133,210,2016-09-19 15:00:00,627,758,881,422,1303,2061,2016-09-19 15:00:00,627,307983,306962
"2649",15064,2016-09-19 16:00:00,627,928,504,424,161,263,2016-09-19 16:00:00,627,789,1227,591,1818,2607,2016-09-19 16:00:00,627,266572,265604
"2650",15065,2016-09-19 17:00:00,627,835,447,388,150,238,2016-09-19 17:00:00,627,859,1340,597,1937,2796,2016-09-19 17:00:00,627,250771,249876
"2651",15066,2016-09-19 18:00:00,627,981,533,448,193,255,2016-09-19 18:00:00,627,895,1319,557,1876,2771,2016-09-19 18:00:00,627,241888,240947
"2652",15067,2016-09-19 19:00:00,627,922,443,479,164,315,2016-09-19 19:00:00,627,876,1514,616,2130,3006,2016-09-19 19:00:00,627,228125,227184
"2653",15068,2016-09-19 20:00:00,627,925,426,499,159,340,2016-09-19 20:00:00,627,871,1785,703,2488,3359,2016-09-19 20:00:00,627,202475,201655
"2654",15069,2016-09-19 21:00:00,627,938,479,459,151,308,2016-09-19 21:00:00,627,779,2102,827,2929,3708,2016-09-19 21:00:00,627,167039,166339
"2655",15070,2016-09-19 22:00:00,627,903,482,421,150,271,2016-09-19 22:00:00,627,742,2090,837,2927,3669,2016-09-19 22:00:00,627,135186,134605
"2656",15071,2016-09-19 23:00:00,627,790,483,307,78,229,2016-09-19 23:00:00,627,667,2117,821,2938,3605,2016-09-19 23:00:00,627,121089,120576
"2657",15072,2016-09-20 00:00:00,628,725,484,241,56,185,2016-09-20 00:00:00,628,558,2049,687,2736,3294,2016-09-20 00:00:00,628,115065,114570
"2658",15073,2016-09-20 01:00:00,628,1099,467,632,242,390,2016-09-20 01:00:00,628,466,1440,531,1971,2437,2016-09-20 01:00:00,628,113214,112731
"2659",15074,2016-09-20 02:00:00,628,867,380,487,195,292,2016-09-20 02:00:00,628,365,1065,385,1450,1815,2016-09-20 02:00:00,628,105707,105212
"2660",15075,2016-09-20 03:00:00,628,777,338,439,160,279,2016-09-20 03:00:00,628,253,651,259,910,1163,2016-09-20 03:00:00,628,94823,94373
"2661",15076,2016-09-20 04:00:00,628,567,267,300,121,179,2016-09-20 04:00:00,628,144,413,152,565,709,2016-09-20 04:00:00,628,87304,86915
"2662",15077,2016-09-20 05:00:00,628,507,214,293,113,180,2016-09-20 05:00:00,628,101,245,101,346,447,2016-09-20 05:00:00,628,85048,84666
"2663",15078,2016-09-20 06:00:00,628,347,150,197,72,125,2016-09-20 06:00:00,628,53,130,51,181,234,2016-09-20 06:00:00,628,93678,93225
"2664",15079,2016-09-20 07:00:00,628,258,155,103,38,65,2016-09-20 07:00:00,628,53,82,22,104,157,2016-09-20 07:00:00,628,97168,96664
"2665",15080,2016-09-20 08:00:00,628,245,164,81,36,45,2016-09-20 08:00:00,628,46,60,25,85,131,2016-09-20 08:00:00,628,99014,98490
"2666",15081,2016-09-20 09:00:00,628,251,135,116,40,76,2016-09-20 09:00:00,628,38,96,29,125,163,2016-09-20 09:00:00,628,100878,100367
"2667",15082,2016-09-20 10:00:00,628,295,180,115,49,66,2016-09-20 10:00:00,628,71,141,58,199,270,2016-09-20 10:00:00,628,107769,107291
"2668",15083,2016-09-20 11:00:00,628,304,194,110,40,70,2016-09-20 11:00:00,628,133,754,305,1059,1192,2016-09-20 11:00:00,628,144761,144216
"2669",15084,2016-09-20 12:00:00,628,440,264,176,57,119,2016-09-20 12:00:00,628,295,873,340,1213,1508,2016-09-20 12:00:00,628,209462,208780
"2670",15085,2016-09-20 13:00:00,628,670,400,270,99,171,2016-09-20 13:00:00,628,506,1239,532,1771,2277,2016-09-20 13:00:00,628,245675,244807
"2671",15086,2016-09-20 14:00:00,628,765,476,289,93,196,2016-09-20 14:00:00,628,642,1197,516,1713,2355,2016-09-20 14:00:00,628,252309,251337
"2672",15087,2016-09-20 15:00:00,628,911,480,431,173,258,2016-09-20 15:00:00,628,781,1443,584,2027,2808,2016-09-20 15:00:00,628,244010,242986
"2673",15088,2016-09-20 16:00:00,628,1014,554,460,168,292,2016-09-20 16:00:00,628,833,1357,569,1926,2759,2016-09-20 16:00:00,628,220197,219275
"2674",15089,2016-09-20 17:00:00,628,949,557,392,119,273,2016-09-20 17:00:00,628,761,1436,585,2021,2782,2016-09-20 17:00:00,628,215856,214945
"2675",15090,2016-09-20 18:00:00,628,1070,551,519,186,333,2016-09-20 18:00:00,628,872,1648,671,2319,3191,2016-09-20 18:00:00,628,214660,213783
"2676",15091,2016-09-20 19:00:00,628,982,482,500,166,334,2016-09-20 19:00:00,628,784,1931,802,2733,3517,2016-09-20 19:00:00,628,201990,201073
"2677",15092,2016-09-20 20:00:00,628,1010,489,521,152,369,2016-09-20 20:00:00,628,833,2301,903,3204,4037,2016-09-20 20:00:00,628,182139,181365
"2678",15093,2016-09-20 21:00:00,628,1095,496,599,198,401,2016-09-20 21:00:00,628,706,2500,925,3425,4131,2016-09-20 21:00:00,628,151524,150877
"2679",15094,2016-09-20 22:00:00,628,1079,502,577,200,377,2016-09-20 22:00:00,628,672,2464,881,3345,4017,2016-09-20 22:00:00,628,125628,125039
"2680",15095,2016-09-20 23:00:00,628,1026,484,542,175,367,2016-09-20 23:00:00,628,614,2723,992,3715,4329,2016-09-20 23:00:00,628,115907,115367
"2681",15096,2016-09-21 00:00:00,629,962,401,561,194,367,2016-09-21 00:00:00,629,491,2040,767,2807,3298,2016-09-21 00:00:00,629,111602,111115
"2682",15097,2016-09-21 01:00:00,629,945,361,584,217,367,2016-09-21 01:00:00,629,410,1622,577,2199,2609,2016-09-21 01:00:00,629,111517,110980
"2683",15098,2016-09-21 02:00:00,629,907,300,607,215,392,2016-09-21 02:00:00,629,338,1198,412,1610,1948,2016-09-21 02:00:00,629,105415,104908
"2684",15099,2016-09-21 03:00:00,629,752,300,452,189,263,2016-09-21 03:00:00,629,239,755,291,1046,1285,2016-09-21 03:00:00,629,97779,97301
"2685",15100,2016-09-21 04:00:00,629,589,235,354,134,220,2016-09-21 04:00:00,629,158,427,159,586,744,2016-09-21 04:00:00,629,94184,93770
"2686",15101,2016-09-21 05:00:00,629,496,202,294,107,187,2016-09-21 05:00:00,629,103,212,90,302,405,2016-09-21 05:00:00,629,88590,88200
"2687",15102,2016-09-21 06:00:00,629,330,161,169,71,98,2016-09-21 06:00:00,629,87,93,49,142,229,2016-09-21 06:00:00,629,97403,96915
"2688",15103,2016-09-21 07:00:00,629,278,181,97,32,65,2016-09-21 07:00:00,629,84,84,26,110,194,2016-09-21 07:00:00,629,101407,100856
"2689",15104,2016-09-21 08:00:00,629,218,156,62,25,37,2016-09-21 08:00:00,629,75,50,22,72,147,2016-09-21 08:00:00,629,102490,101965
"2690",15105,2016-09-21 09:00:00,629,281,177,104,37,67,2016-09-21 09:00:00,629,43,35,16,51,94,2016-09-21 09:00:00,629,103196,102710
"2691",15106,2016-09-21 10:00:00,629,272,185,87,31,56,2016-09-21 10:00:00,629,99,64,30,94,193,2016-09-21 10:00:00,629,108370,107877
"2692",15107,2016-09-21 11:00:00,629,360,251,109,50,59,2016-09-21 11:00:00,629,125,168,86,254,379,2016-09-21 11:00:00,629,134716,134173
"2693",15108,2016-09-21 12:00:00,629,433,252,181,90,91,2016-09-21 12:00:00,629,276,423,210,633,909,2016-09-21 12:00:00,629,182300,181573
"2694",15109,2016-09-21 13:00:00,629,589,399,190,77,113,2016-09-21 13:00:00,629,556,652,314,966,1522,2016-09-21 13:00:00,629,219482,218594
"2695",15110,2016-09-21 14:00:00,629,694,415,279,108,171,2016-09-21 14:00:00,629,672,733,374,1107,1779,2016-09-21 14:00:00,629,231991,230985
"2696",15111,2016-09-21 15:00:00,629,833,453,380,137,243,2016-09-21 15:00:00,629,781,805,378,1183,1964,2016-09-21 15:00:00,629,228857,227860
"2697",15112,2016-09-21 16:00:00,629,539,230,309,108,201,2016-09-21 16:00:00,629,780,919,444,1363,2143,2016-09-21 16:00:00,629,211367,210399
"2698",15113,2016-09-21 17:00:00,629,668,308,360,130,230,2016-09-21 17:00:00,629,798,1004,444,1448,2246,2016-09-21 17:00:00,629,207266,206160
"2699",15114,2016-09-21 18:00:00,629,998,556,442,184,258,2016-09-21 18:00:00,629,832,1027,445,1472,2304,2016-09-21 18:00:00,629,205019,204049
"2700",15115,2016-09-21 19:00:00,629,811,409,402,136,266,2016-09-21 19:00:00,629,885,1301,531,1832,2717,2016-09-21 19:00:00,629,194124,193127
"2701",15116,2016-09-21 20:00:00,629,924,475,449,150,299,2016-09-21 20:00:00,629,859,1335,550,1885,2744,2016-09-21 20:00:00,629,177785,176897
"2702",15117,2016-09-21 21:00:00,629,780,506,274,114,160,2016-09-21 21:00:00,629,823,1643,644,2287,3110,2016-09-21 21:00:00,629,149035,148188
"2703",15118,2016-09-21 22:00:00,629,506,479,27,9,18,2016-09-21 22:00:00,629,699,1799,713,2512,3211,2016-09-21 22:00:00,629,126172,125601
"2704",15119,2016-09-21 23:00:00,629,852,482,370,125,245,2016-09-21 23:00:00,629,648,1742,631,2373,3021,2016-09-21 23:00:00,629,115319,114772
"2705",15120,2016-09-22 00:00:00,630,995,436,559,188,371,2016-09-22 00:00:00,630,520,1397,532,1929,2449,2016-09-22 00:00:00,630,113688,113213
"2706",15121,2016-09-22 01:00:00,630,880,400,480,148,332,2016-09-22 01:00:00,630,393,1080,400,1480,1873,2016-09-22 01:00:00,630,113543,113040
"2707",15122,2016-09-22 02:00:00,630,825,344,481,150,331,2016-09-22 02:00:00,630,342,780,296,1076,1418,2016-09-22 02:00:00,630,107473,106974
"2708",15123,2016-09-22 03:00:00,630,718,287,431,150,281,2016-09-22 03:00:00,630,281,529,204,733,1014,2016-09-22 03:00:00,630,101641,101214
"2709",15124,2016-09-22 04:00:00,630,570,286,284,112,172,2016-09-22 04:00:00,630,172,285,117,402,574,2016-09-22 04:00:00,630,94007,93641
"2710",15125,2016-09-22 05:00:00,630,425,221,204,84,120,2016-09-22 05:00:00,630,119,152,56,208,327,2016-09-22 05:00:00,630,91427,91030
"2711",15126,2016-09-22 06:00:00,630,299,168,131,57,74,2016-09-22 06:00:00,630,93,99,48,147,240,2016-09-22 06:00:00,630,99840,99419
"2712",15127,2016-09-22 07:00:00,630,245,165,80,25,55,2016-09-22 07:00:00,630,77,62,22,84,161,2016-09-22 07:00:00,630,104696,104183
"2713",15128,2016-09-22 08:00:00,630,229,176,53,20,33,2016-09-22 08:00:00,630,47,49,13,62,109,2016-09-22 08:00:00,630,105234,104700
"2714",15129,2016-09-22 09:00:00,630,262,172,90,45,45,2016-09-22 09:00:00,630,52,25,14,39,91,2016-09-22 09:00:00,630,107169,106659
"2715",15130,2016-09-22 10:00:00,630,271,193,78,35,43,2016-09-22 10:00:00,630,83,60,29,89,172,2016-09-22 10:00:00,630,118123,117642
"2716",15131,2016-09-22 11:00:00,630,291,195,96,38,58,2016-09-22 11:00:00,630,152,149,84,233,385,2016-09-22 11:00:00,630,162335,161770
"2717",15132,2016-09-22 12:00:00,630,375,279,96,41,55,2016-09-22 12:00:00,630,363,307,163,470,833,2016-09-22 12:00:00,630,240749,240036
"2718",15133,2016-09-22 13:00:00,630,612,407,205,91,114,2016-09-22 13:00:00,630,559,545,280,825,1384,2016-09-22 13:00:00,630,286402,285485
"2719",15134,2016-09-22 14:00:00,630,680,514,166,63,103,2016-09-22 14:00:00,630,797,677,328,1005,1802,2016-09-22 14:00:00,630,287840,286849
"2720",15135,2016-09-22 15:00:00,630,780,570,210,59,151,2016-09-22 15:00:00,630,804,795,381,1176,1980,2016-09-22 15:00:00,630,278649,277561
"2721",15136,2016-09-22 16:00:00,630,793,580,213,55,158,2016-09-22 16:00:00,630,862,802,359,1161,2023,2016-09-22 16:00:00,630,250655,249703
"2722",15137,2016-09-22 17:00:00,630,807,563,244,82,162,2016-09-22 17:00:00,630,932,904,426,1330,2262,2016-09-22 17:00:00,630,243635,242679
"2723",15138,2016-09-22 18:00:00,630,885,581,304,114,190,2016-09-22 18:00:00,630,938,977,476,1453,2391,2016-09-22 18:00:00,630,237712,236731
"2724",15139,2016-09-22 19:00:00,630,846,512,334,111,223,2016-09-22 19:00:00,630,869,1140,526,1666,2535,2016-09-22 19:00:00,630,221016,220119
"2725",15140,2016-09-22 20:00:00,630,962,560,402,144,258,2016-09-22 20:00:00,630,916,1261,484,1745,2661,2016-09-22 20:00:00,630,202201,201382
"2726",15141,2016-09-22 21:00:00,630,962,557,405,127,278,2016-09-22 21:00:00,630,781,1432,614,2046,2827,2016-09-22 21:00:00,630,165318,164675
"2727",15142,2016-09-22 22:00:00,630,872,485,387,140,247,2016-09-22 22:00:00,630,785,1452,600,2052,2837,2016-09-22 22:00:00,630,134467,133914
"2728",15143,2016-09-22 23:00:00,630,810,472,338,112,226,2016-09-22 23:00:00,630,656,1329,544,1873,2529,2016-09-22 23:00:00,630,121013,120507
"2729",15144,2016-09-23 00:00:00,631,869,429,440,155,285,2016-09-23 00:00:00,631,553,1192,462,1654,2207,2016-09-23 00:00:00,631,116355,115810
"2730",15145,2016-09-23 01:00:00,631,967,482,485,191,294,2016-09-23 01:00:00,631,395,1109,441,1550,1945,2016-09-23 01:00:00,631,115237,114719
"2731",15146,2016-09-23 02:00:00,631,763,387,376,138,238,2016-09-23 02:00:00,631,344,854,339,1193,1537,2016-09-23 02:00:00,631,107370,106848
"2732",15147,2016-09-23 03:00:00,631,596,287,309,116,193,2016-09-23 03:00:00,631,274,551,218,769,1043,2016-09-23 03:00:00,631,97775,97324
"2733",15148,2016-09-23 04:00:00,631,529,261,268,105,163,2016-09-23 04:00:00,631,181,389,151,540,721,2016-09-23 04:00:00,631,88173,87795
"2734",15149,2016-09-23 05:00:00,631,437,209,228,94,134,2016-09-23 05:00:00,631,116,212,79,291,407,2016-09-23 05:00:00,631,85779,85402
"2735",15150,2016-09-23 06:00:00,631,336,207,129,44,85,2016-09-23 06:00:00,631,87,108,34,142,229,2016-09-23 06:00:00,631,97898,97496
"2736",15151,2016-09-23 07:00:00,631,256,191,65,26,39,2016-09-23 07:00:00,631,62,68,29,97,159,2016-09-23 07:00:00,631,96601,96155
"2737",15152,2016-09-23 08:00:00,631,240,179,61,18,43,2016-09-23 08:00:00,631,44,41,16,57,101,2016-09-23 08:00:00,631,96780,96317
"2738",15153,2016-09-23 09:00:00,631,295,180,115,46,69,2016-09-23 09:00:00,631,39,53,20,73,112,2016-09-23 09:00:00,631,99016,98575
"2739",15154,2016-09-23 10:00:00,631,252,184,68,30,38,2016-09-23 10:00:00,631,61,58,31,89,150,2016-09-23 10:00:00,631,107261,106806
"2740",15155,2016-09-23 11:00:00,631,257,222,35,7,28,2016-09-23 11:00:00,631,132,139,77,216,348,2016-09-23 11:00:00,631,150529,150024
"2741",15156,2016-09-23 12:00:00,631,331,248,83,31,52,2016-09-23 12:00:00,631,330,319,164,483,813,2016-09-23 12:00:00,631,220855,220230
"2742",15157,2016-09-23 13:00:00,631,490,317,173,64,109,2016-09-23 13:00:00,631,483,612,334,946,1429,2016-09-23 13:00:00,631,254421,253601
"2743",15158,2016-09-23 14:00:00,631,524,368,156,55,101,2016-09-23 14:00:00,631,687,676,341,1017,1704,2016-09-23 14:00:00,631,255335,254394
"2744",15159,2016-09-23 15:00:00,631,639,465,174,49,125,2016-09-23 15:00:00,631,760,778,364,1142,1902,2016-09-23 15:00:00,631,245454,244520
"2745",15160,2016-09-23 16:00:00,631,711,486,225,82,143,2016-09-23 16:00:00,631,874,987,433,1420,2294,2016-09-23 16:00:00,631,219730,218880
"2746",15161,2016-09-23 17:00:00,631,714,493,221,62,159,2016-09-23 17:00:00,631,921,987,442,1429,2350,2016-09-23 17:00:00,631,209964,209114
"2747",15162,2016-09-23 18:00:00,631,755,525,230,75,155,2016-09-23 18:00:00,631,901,1088,465,1553,2454,2016-09-23 18:00:00,631,205353,204509
"2748",15163,2016-09-23 19:00:00,631,684,451,233,88,145,2016-09-23 19:00:00,631,922,1205,481,1686,2608,2016-09-23 19:00:00,631,187691,186921
"2749",15164,2016-09-23 20:00:00,631,807,428,379,134,245,2016-09-23 20:00:00,631,896,1416,625,2041,2937,2016-09-23 20:00:00,631,167787,167064
"2750",15165,2016-09-23 21:00:00,631,783,474,309,87,222,2016-09-23 21:00:00,631,748,1522,653,2175,2923,2016-09-23 21:00:00,631,137772,137170
"2751",15166,2016-09-23 22:00:00,631,676,450,226,82,144,2016-09-23 22:00:00,631,744,3584,1080,4664,5408,2016-09-23 22:00:00,631,114583,114081
"2752",15167,2016-09-23 23:00:00,631,642,414,228,86,142,2016-09-23 23:00:00,631,630,2921,1007,3928,4558,2016-09-23 23:00:00,631,99885,99414
"2753",15168,2016-09-24 00:00:00,632,709,366,343,123,220,2016-09-24 00:00:00,632,376,1283,529,1812,2188,2016-09-24 00:00:00,632,91417,91001
"2754",15169,2016-09-24 01:00:00,632,692,354,338,123,215,2016-09-24 01:00:00,632,230,824,309,1133,1363,2016-09-24 01:00:00,632,87747,87314
"2755",15170,2016-09-24 02:00:00,632,618,318,300,121,179,2016-09-24 02:00:00,632,215,721,276,997,1212,2016-09-24 02:00:00,632,83795,83399
"2756",15171,2016-09-24 03:00:00,632,553,271,282,105,177,2016-09-24 03:00:00,632,203,604,213,817,1020,2016-09-24 03:00:00,632,80511,80161
"2757",15172,2016-09-24 04:00:00,632,526,262,264,99,165,2016-09-24 04:00:00,632,233,451,180,631,864,2016-09-24 04:00:00,632,74799,74441
"2758",15173,2016-09-24 05:00:00,632,448,202,246,94,152,2016-09-24 05:00:00,632,180,270,106,376,556,2016-09-24 05:00:00,632,69776,69479
"2759",15174,2016-09-24 06:00:00,632,312,176,136,49,87,2016-09-24 06:00:00,632,67,136,60,196,263,2016-09-24 06:00:00,632,67611,67303
"2760",15175,2016-09-24 07:00:00,632,239,166,73,28,45,2016-09-24 07:00:00,632,59,84,36,120,179,2016-09-24 07:00:00,632,67291,66967
"2761",15176,2016-09-24 08:00:00,632,176,128,48,19,29,2016-09-24 08:00:00,632,56,50,21,71,127,2016-09-24 08:00:00,632,66009,65690
"2762",15177,2016-09-24 09:00:00,632,177,118,59,16,43,2016-09-24 09:00:00,632,66,45,28,73,139,2016-09-24 09:00:00,632,67296,66975
"2763",15178,2016-09-24 10:00:00,632,285,177,108,49,59,2016-09-24 10:00:00,632,62,64,24,88,150,2016-09-24 10:00:00,632,72081,71725
"2764",15179,2016-09-24 11:00:00,632,263,199,64,27,37,2016-09-24 11:00:00,632,106,172,83,255,361,2016-09-24 11:00:00,632,82959,82611
"2765",15180,2016-09-24 12:00:00,632,310,197,113,42,71,2016-09-24 12:00:00,632,217,352,144,496,713,2016-09-24 12:00:00,632,97597,97182
"2766",15181,2016-09-24 13:00:00,632,424,229,195,67,128,2016-09-24 13:00:00,632,388,764,344,1108,1496,2016-09-24 13:00:00,632,110388,109905
"2767",15182,2016-09-24 14:00:00,632,488,263,225,77,148,2016-09-24 14:00:00,632,452,1099,475,1574,2026,2016-09-24 14:00:00,632,119790,119275
"2768",15183,2016-09-24 15:00:00,632,614,298,316,100,216,2016-09-24 15:00:00,632,520,1187,503,1690,2210,2016-09-24 15:00:00,632,122216,121646
"2769",15184,2016-09-24 16:00:00,632,581,267,314,103,211,2016-09-24 16:00:00,632,606,1311,544,1855,2461,2016-09-24 16:00:00,632,120864,120274
"2770",15185,2016-09-24 17:00:00,632,686,350,336,96,240,2016-09-24 17:00:00,632,663,1442,613,2055,2718,2016-09-24 17:00:00,632,116444,115897
"2771",15186,2016-09-24 18:00:00,632,847,389,458,141,317,2016-09-24 18:00:00,632,650,1456,576,2032,2682,2016-09-24 18:00:00,632,112387,111786
"2772",15187,2016-09-24 19:00:00,632,848,342,506,149,357,2016-09-24 19:00:00,632,691,1312,522,1834,2525,2016-09-24 19:00:00,632,107644,107067
"2773",15188,2016-09-24 20:00:00,632,869,381,488,154,334,2016-09-24 20:00:00,632,663,1319,506,1825,2488,2016-09-24 20:00:00,632,100507,99989
"2774",15189,2016-09-24 21:00:00,632,824,337,487,143,344,2016-09-24 21:00:00,632,578,1251,473,1724,2302,2016-09-24 21:00:00,632,93155,92698
"2775",15190,2016-09-24 22:00:00,632,969,378,591,180,411,2016-09-24 22:00:00,632,493,1261,465,1726,2219,2016-09-24 22:00:00,632,84530,84138
"2776",15191,2016-09-24 23:00:00,632,791,357,434,125,309,2016-09-24 23:00:00,632,483,1190,464,1654,2137,2016-09-24 23:00:00,632,80692,80306
"2777",15192,2016-09-25 00:00:00,633,810,311,499,128,371,2016-09-25 00:00:00,633,424,933,362,1295,1719,2016-09-25 00:00:00,633,80901,80509
"2778",15193,2016-09-25 01:00:00,633,790,335,455,133,322,2016-09-25 01:00:00,633,382,916,327,1243,1625,2016-09-25 01:00:00,633,79939,79531
"2779",15194,2016-09-25 02:00:00,633,619,294,325,91,234,2016-09-25 02:00:00,633,275,824,285,1109,1384,2016-09-25 02:00:00,633,80126,79697
"2780",15195,2016-09-25 03:00:00,633,566,230,336,87,249,2016-09-25 03:00:00,633,208,689,229,918,1126,2016-09-25 03:00:00,633,77898,77553
"2781",15196,2016-09-25 04:00:00,633,423,181,242,66,176,2016-09-25 04:00:00,633,171,343,106,449,620,2016-09-25 04:00:00,633,75827,75502
"2782",15197,2016-09-25 05:00:00,633,457,245,212,60,152,2016-09-25 05:00:00,633,102,243,88,331,433,2016-09-25 05:00:00,633,70965,70658
"2783",15198,2016-09-25 06:00:00,633,416,209,207,73,134,2016-09-25 06:00:00,633,76,137,58,195,271,2016-09-25 06:00:00,633,68921,68608
"2784",15199,2016-09-25 07:00:00,633,280,183,97,24,73,2016-09-25 07:00:00,633,38,74,34,108,146,2016-09-25 07:00:00,633,67720,67373
"2785",15200,2016-09-25 08:00:00,633,267,151,116,52,64,2016-09-25 08:00:00,633,54,48,19,67,121,2016-09-25 08:00:00,633,66390,66113
"2786",15201,2016-09-25 09:00:00,633,225,146,79,32,47,2016-09-25 09:00:00,633,43,42,14,56,99,2016-09-25 09:00:00,633,67085,66771
"2787",15202,2016-09-25 10:00:00,633,274,181,93,46,47,2016-09-25 10:00:00,633,46,38,19,57,103,2016-09-25 10:00:00,633,71474,71143
"2788",15203,2016-09-25 11:00:00,633,237,176,61,26,35,2016-09-25 11:00:00,633,73,101,42,143,216,2016-09-25 11:00:00,633,80184,79829
"2789",15204,2016-09-25 12:00:00,633,398,256,142,41,101,2016-09-25 12:00:00,633,151,257,107,364,515,2016-09-25 12:00:00,633,94506,94094
"2790",15205,2016-09-25 13:00:00,633,484,311,173,59,114,2016-09-25 13:00:00,633,285,586,245,831,1116,2016-09-25 13:00:00,633,105116,104670
"2791",15206,2016-09-25 14:00:00,633,693,331,362,122,240,2016-09-25 14:00:00,633,403,890,378,1268,1671,2016-09-25 14:00:00,633,117854,117307
"2792",15207,2016-09-25 15:00:00,633,675,315,360,109,251,2016-09-25 15:00:00,633,463,972,387,1359,1822,2016-09-25 15:00:00,633,118385,117871
"2793",15208,2016-09-25 16:00:00,633,716,302,414,136,278,2016-09-25 16:00:00,633,526,1087,466,1553,2079,2016-09-25 16:00:00,633,119313,118748
"2794",15209,2016-09-25 17:00:00,633,762,385,377,94,283,2016-09-25 17:00:00,633,548,1140,463,1603,2151,2016-09-25 17:00:00,633,119080,118527
"2795",15210,2016-09-25 18:00:00,633,857,410,447,145,302,2016-09-25 18:00:00,633,566,1202,499,1701,2267,2016-09-25 18:00:00,633,117998,117439
"2796",15211,2016-09-25 19:00:00,633,877,370,507,174,333,2016-09-25 19:00:00,633,616,1221,473,1694,2310,2016-09-25 19:00:00,633,111959,111459
"2797",15212,2016-09-25 20:00:00,633,787,320,467,167,300,2016-09-25 20:00:00,633,611,1179,446,1625,2236,2016-09-25 20:00:00,633,110198,109675
"2798",15213,2016-09-25 21:00:00,633,943,403,540,183,357,2016-09-25 21:00:00,633,524,1151,436,1587,2111,2016-09-25 21:00:00,633,101644,101133
"2799",15214,2016-09-25 22:00:00,633,950,391,559,175,384,2016-09-25 22:00:00,633,492,1036,406,1442,1934,2016-09-25 22:00:00,633,95504,95039
"2800",15215,2016-09-25 23:00:00,633,826,364,462,154,308,2016-09-25 23:00:00,633,458,1060,417,1477,1935,2016-09-25 23:00:00,633,98291,97811
"2801",15216,2016-09-26 00:00:00,634,956,453,503,120,383,2016-09-26 00:00:00,634,378,880,351,1231,1609,2016-09-26 00:00:00,634,109422,108933
"2802",15217,2016-09-26 01:00:00,634,868,439,429,123,306,2016-09-26 01:00:00,634,383,788,320,1108,1491,2016-09-26 01:00:00,634,115133,114659
"2803",15218,2016-09-26 02:00:00,634,681,318,363,113,250,2016-09-26 02:00:00,634,247,468,210,678,925,2016-09-26 02:00:00,634,106495,106028
"2804",15219,2016-09-26 03:00:00,634,612,286,326,106,220,2016-09-26 03:00:00,634,211,341,151,492,703,2016-09-26 03:00:00,634,99328,98893
"2805",15220,2016-09-26 04:00:00,634,499,258,241,67,174,2016-09-26 04:00:00,634,108,195,77,272,380,2016-09-26 04:00:00,634,94450,94035
"2806",15221,2016-09-26 05:00:00,634,414,248,166,56,110,2016-09-26 05:00:00,634,74,109,50,159,233,2016-09-26 05:00:00,634,93981,93615
"2807",15222,2016-09-26 06:00:00,634,310,198,112,41,71,2016-09-26 06:00:00,634,74,78,36,114,188,2016-09-26 06:00:00,634,104841,104382
"2808",15223,2016-09-26 07:00:00,634,272,203,69,37,32,2016-09-26 07:00:00,634,63,26,19,45,108,2016-09-26 07:00:00,634,105747,105275
"2809",15224,2016-09-26 08:00:00,634,216,165,51,24,27,2016-09-26 08:00:00,634,39,25,11,36,75,2016-09-26 08:00:00,634,106089,105553
"2810",15225,2016-09-26 09:00:00,634,277,177,100,39,61,2016-09-26 09:00:00,634,70,26,11,37,107,2016-09-26 09:00:00,634,111361,110854
"2811",15226,2016-09-26 10:00:00,634,320,242,78,33,45,2016-09-26 10:00:00,634,65,54,25,79,144,2016-09-26 10:00:00,634,132072,131568
"2812",15227,2016-09-26 11:00:00,634,362,256,106,37,69,2016-09-26 11:00:00,634,143,97,58,155,298,2016-09-26 11:00:00,634,214135,213580
"2813",15228,2016-09-26 12:00:00,634,456,306,150,71,79,2016-09-26 12:00:00,634,389,324,188,512,901,2016-09-26 12:00:00,634,334894,334140
"2814",15229,2016-09-26 13:00:00,634,581,389,192,77,115,2016-09-26 13:00:00,634,606,607,312,919,1525,2016-09-26 13:00:00,634,365760,364860
"2815",15230,2016-09-26 14:00:00,634,663,424,239,87,152,2016-09-26 14:00:00,634,726,730,356,1086,1812,2016-09-26 14:00:00,634,335432,334384
"2816",15231,2016-09-26 15:00:00,634,763,487,276,110,166,2016-09-26 15:00:00,634,871,862,462,1324,2195,2016-09-26 15:00:00,634,311647,310595
"2817",15232,2016-09-26 16:00:00,634,878,534,344,151,193,2016-09-26 16:00:00,634,943,958,454,1412,2355,2016-09-26 16:00:00,634,267745,266817
"2818",15233,2016-09-26 17:00:00,634,892,560,332,138,194,2016-09-26 17:00:00,634,1008,965,476,1441,2449,2016-09-26 17:00:00,634,255596,254652
"2819",15234,2016-09-26 18:00:00,634,989,623,366,156,210,2016-09-26 18:00:00,634,1052,1082,508,1590,2642,2016-09-26 18:00:00,634,249181,248218
"2820",15235,2016-09-26 19:00:00,634,900,528,372,132,240,2016-09-26 19:00:00,634,1106,1277,624,1901,3007,2016-09-26 19:00:00,634,231671,230750
"2821",15236,2016-09-26 20:00:00,634,934,498,436,177,259,2016-09-26 20:00:00,634,1043,1405,624,2029,3072,2016-09-26 20:00:00,634,208070,207258
"2822",15237,2016-09-26 21:00:00,634,909,455,454,156,298,2016-09-26 21:00:00,634,978,1460,657,2117,3095,2016-09-26 21:00:00,634,170741,170039
"2823",15238,2016-09-26 22:00:00,634,1009,504,505,204,301,2016-09-26 22:00:00,634,775,1519,662,2181,2956,2016-09-26 22:00:00,634,139867,139270
"2824",15239,2016-09-26 23:00:00,634,885,500,385,131,254,2016-09-26 23:00:00,634,733,1422,596,2018,2751,2016-09-26 23:00:00,634,126608,126065
"2825",15240,2016-09-27 00:00:00,635,974,543,431,121,310,2016-09-27 00:00:00,635,636,1355,567,1922,2558,2016-09-27 00:00:00,635,117540,117049
"2826",15241,2016-09-27 01:00:00,635,844,406,438,136,302,2016-09-27 01:00:00,635,422,877,341,1218,1640,2016-09-27 01:00:00,635,104133,103670
"2827",15242,2016-09-27 02:00:00,635,680,344,336,122,214,2016-09-27 02:00:00,635,303,642,269,911,1214,2016-09-27 02:00:00,635,97910,97474
"2828",15243,2016-09-27 03:00:00,635,623,305,318,112,206,2016-09-27 03:00:00,635,250,477,185,662,912,2016-09-27 03:00:00,635,96618,96207
"2829",15244,2016-09-27 04:00:00,635,579,305,274,104,170,2016-09-27 04:00:00,635,217,337,123,460,677,2016-09-27 04:00:00,635,90108,89723
"2830",15245,2016-09-27 05:00:00,635,427,208,219,77,142,2016-09-27 05:00:00,635,117,164,52,216,333,2016-09-27 05:00:00,635,87030,86625
"2831",15246,2016-09-27 06:00:00,635,372,237,135,51,84,2016-09-27 06:00:00,635,79,102,40,142,221,2016-09-27 06:00:00,635,95358,94934
"2832",15247,2016-09-27 07:00:00,635,252,202,50,19,31,2016-09-27 07:00:00,635,60,50,23,73,133,2016-09-27 07:00:00,635,98427,97919
"2833",15248,2016-09-27 08:00:00,635,255,211,44,13,31,2016-09-27 08:00:00,635,42,34,15,49,91,2016-09-27 08:00:00,635,99567,99060
"2834",15249,2016-09-27 09:00:00,635,246,169,77,33,44,2016-09-27 09:00:00,635,52,33,15,48,100,2016-09-27 09:00:00,635,102767,102217
"2835",15250,2016-09-27 10:00:00,635,272,178,94,31,63,2016-09-27 10:00:00,635,74,60,29,89,163,2016-09-27 10:00:00,635,109314,108805
"2836",15251,2016-09-27 11:00:00,635,319,237,82,38,44,2016-09-27 11:00:00,635,142,120,73,193,335,2016-09-27 11:00:00,635,145763,145284
"2837",15252,2016-09-27 12:00:00,635,440,293,147,52,95,2016-09-27 12:00:00,635,355,337,173,510,865,2016-09-27 12:00:00,635,209506,208844
"2838",15253,2016-09-27 13:00:00,635,630,422,208,93,115,2016-09-27 13:00:00,635,570,544,308,852,1422,2016-09-27 13:00:00,635,250772,249874
"2839",15254,2016-09-27 14:00:00,635,683,450,233,89,144,2016-09-27 14:00:00,635,742,716,358,1074,1816,2016-09-27 14:00:00,635,256775,255734
"2840",15255,2016-09-27 15:00:00,635,845,553,292,112,180,2016-09-27 15:00:00,635,849,847,421,1268,2117,2016-09-27 15:00:00,635,251455,250456
"2841",15256,2016-09-27 16:00:00,635,918,624,294,106,188,2016-09-27 16:00:00,635,906,900,468,1368,2274,2016-09-27 16:00:00,635,225002,224078
"2842",15257,2016-09-27 17:00:00,635,998,720,278,100,178,2016-09-27 17:00:00,635,944,1015,480,1495,2439,2016-09-27 17:00:00,635,219376,218478
"2843",15258,2016-09-27 18:00:00,635,923,620,303,109,194,2016-09-27 18:00:00,635,998,1021,483,1504,2502,2016-09-27 18:00:00,635,216188,215306
"2844",15259,2016-09-27 19:00:00,635,920,568,352,127,225,2016-09-27 19:00:00,635,988,1203,559,1762,2750,2016-09-27 19:00:00,635,202294,201307
"2845",15260,2016-09-27 20:00:00,635,908,559,349,119,230,2016-09-27 20:00:00,635,997,1406,634,2040,3037,2016-09-27 20:00:00,635,184402,183466
"2846",15261,2016-09-27 21:00:00,635,887,486,401,140,261,2016-09-27 21:00:00,635,979,1452,609,2061,3040,2016-09-27 21:00:00,635,152948,152271
"2847",15262,2016-09-27 22:00:00,635,1108,635,473,162,311,2016-09-27 22:00:00,635,817,1558,660,2218,3035,2016-09-27 22:00:00,635,126424,125800
"2848",15263,2016-09-27 23:00:00,635,992,567,425,149,276,2016-09-27 23:00:00,635,725,1490,606,2096,2821,2016-09-27 23:00:00,635,116433,115787
"2849",15264,2016-09-28 00:00:00,636,1002,558,444,159,285,2016-09-28 00:00:00,636,641,1486,607,2093,2734,2016-09-28 00:00:00,636,109841,109361
"2850",15265,2016-09-28 01:00:00,636,991,492,499,154,345,2016-09-28 01:00:00,636,485,1176,465,1641,2126,2016-09-28 01:00:00,636,108693,108179
"2851",15266,2016-09-28 02:00:00,636,745,337,408,133,275,2016-09-28 02:00:00,636,395,918,373,1291,1686,2016-09-28 02:00:00,636,103068,102529
"2852",15267,2016-09-28 03:00:00,636,739,371,368,133,235,2016-09-28 03:00:00,636,302,586,240,826,1128,2016-09-28 03:00:00,636,95493,95027
"2853",15268,2016-09-28 04:00:00,636,587,320,267,90,177,2016-09-28 04:00:00,636,169,370,162,532,701,2016-09-28 04:00:00,636,89259,88883
"2854",15269,2016-09-28 05:00:00,636,460,260,200,64,136,2016-09-28 05:00:00,636,139,156,72,228,367,2016-09-28 05:00:00,636,86118,85767
"2855",15270,2016-09-28 06:00:00,636,315,172,143,44,99,2016-09-28 06:00:00,636,87,77,38,115,202,2016-09-28 06:00:00,636,103816,103394
"2856",15271,2016-09-28 07:00:00,636,247,184,63,17,46,2016-09-28 07:00:00,636,61,56,23,79,140,2016-09-28 07:00:00,636,97708,97210
"2857",15272,2016-09-28 08:00:00,636,271,209,62,18,44,2016-09-28 08:00:00,636,59,34,16,50,109,2016-09-28 08:00:00,636,99016,98482
"2858",15273,2016-09-28 09:00:00,636,297,208,89,39,50,2016-09-28 09:00:00,636,48,27,13,40,88,2016-09-28 09:00:00,636,99207,98704
"2859",15274,2016-09-28 10:00:00,636,291,197,94,33,61,2016-09-28 10:00:00,636,93,74,40,114,207,2016-09-28 10:00:00,636,103193,102716
"2860",15275,2016-09-28 11:00:00,636,388,277,111,55,56,2016-09-28 11:00:00,636,131,167,86,253,384,2016-09-28 11:00:00,636,129406,128896
"2861",15276,2016-09-28 12:00:00,636,496,329,167,67,100,2016-09-28 12:00:00,636,314,293,153,446,760,2016-09-28 12:00:00,636,176196,175515
"2862",15277,2016-09-28 13:00:00,636,635,438,197,65,132,2016-09-28 13:00:00,636,578,580,298,878,1456,2016-09-28 13:00:00,636,215053,214242
"2863",15278,2016-09-28 14:00:00,636,700,462,238,95,143,2016-09-28 14:00:00,636,697,669,370,1039,1736,2016-09-28 14:00:00,636,229690,228772
"2864",15279,2016-09-28 15:00:00,636,857,577,280,103,177,2016-09-28 15:00:00,636,861,764,393,1157,2018,2016-09-28 15:00:00,636,225191,224263
"2865",15280,2016-09-28 16:00:00,636,900,594,306,103,203,2016-09-28 16:00:00,636,926,910,442,1352,2278,2016-09-28 16:00:00,636,208891,208042
"2866",15281,2016-09-28 17:00:00,636,912,613,299,103,196,2016-09-28 17:00:00,636,898,814,412,1226,2124,2016-09-28 17:00:00,636,205881,204981
"2867",15282,2016-09-28 18:00:00,636,990,676,314,110,204,2016-09-28 18:00:00,636,934,1046,467,1513,2447,2016-09-28 18:00:00,636,206136,205256
"2868",15283,2016-09-28 19:00:00,636,859,539,320,103,217,2016-09-28 19:00:00,636,975,1110,501,1611,2586,2016-09-28 19:00:00,636,193444,192543
"2869",15284,2016-09-28 20:00:00,636,879,558,321,92,229,2016-09-28 20:00:00,636,1024,1357,596,1953,2977,2016-09-28 20:00:00,636,176481,175650
"2870",15285,2016-09-28 21:00:00,636,881,527,354,111,243,2016-09-28 21:00:00,636,824,1575,644,2219,3043,2016-09-28 21:00:00,636,149309,148652
"2871",15286,2016-09-28 22:00:00,636,1040,562,478,151,327,2016-09-28 22:00:00,636,811,1672,703,2375,3186,2016-09-28 22:00:00,636,127151,126587
"2872",15287,2016-09-28 23:00:00,636,876,475,401,139,262,2016-09-28 23:00:00,636,646,1523,586,2109,2755,2016-09-28 23:00:00,636,114856,114381
"2873",15288,2016-09-29 00:00:00,637,949,491,458,148,310,2016-09-29 00:00:00,637,579,1258,530,1788,2367,2016-09-29 00:00:00,637,112475,111962
"2874",15289,2016-09-29 01:00:00,637,830,402,428,139,289,2016-09-29 01:00:00,637,472,935,394,1329,1801,2016-09-29 01:00:00,637,113372,112862
"2875",15290,2016-09-29 02:00:00,637,754,399,355,115,240,2016-09-29 02:00:00,637,357,715,281,996,1353,2016-09-29 02:00:00,637,106107,105612
"2876",15291,2016-09-29 03:00:00,637,603,323,280,85,195,2016-09-29 03:00:00,637,275,486,195,681,956,2016-09-29 03:00:00,637,98199,97778
"2877",15292,2016-09-29 04:00:00,637,467,246,221,68,153,2016-09-29 04:00:00,637,184,282,127,409,593,2016-09-29 04:00:00,637,90465,90066
"2878",15293,2016-09-29 05:00:00,637,399,207,192,61,131,2016-09-29 05:00:00,637,94,141,58,199,293,2016-09-29 05:00:00,637,88507,88131
"2879",15294,2016-09-29 06:00:00,637,299,185,114,52,62,2016-09-29 06:00:00,637,58,102,45,147,205,2016-09-29 06:00:00,637,97079,96644
"2880",15295,2016-09-29 07:00:00,637,294,226,68,23,45,2016-09-29 07:00:00,637,44,43,22,65,109,2016-09-29 07:00:00,637,101217,100718
"2881",15296,2016-09-29 08:00:00,637,256,200,56,23,33,2016-09-29 08:00:00,637,58,41,14,55,113,2016-09-29 08:00:00,637,101403,100871
"2882",15297,2016-09-29 09:00:00,637,278,194,84,38,46,2016-09-29 09:00:00,637,70,25,15,40,110,2016-09-29 09:00:00,637,103501,102997
"2883",15298,2016-09-29 10:00:00,637,225,160,65,25,40,2016-09-29 10:00:00,637,83,61,27,88,171,2016-09-29 10:00:00,637,112634,112147
"2884",15299,2016-09-29 11:00:00,637,306,234,72,21,51,2016-09-29 11:00:00,637,130,109,65,174,304,2016-09-29 11:00:00,637,156668,156113
"2885",15300,2016-09-29 12:00:00,637,422,322,100,33,67,2016-09-29 12:00:00,637,340,280,139,419,759,2016-09-29 12:00:00,637,235787,235132
"2886",15301,2016-09-29 13:00:00,637,581,422,159,64,95,2016-09-29 13:00:00,637,515,513,267,780,1295,2016-09-29 13:00:00,637,281377,280523
"2887",15302,2016-09-29 14:00:00,637,722,520,202,75,127,2016-09-29 14:00:00,637,676,556,291,847,1523,2016-09-29 14:00:00,637,281622,280625
"2888",15303,2016-09-29 15:00:00,637,793,595,198,75,123,2016-09-29 15:00:00,637,801,632,312,944,1745,2016-09-29 15:00:00,637,273128,272131
"2889",15304,2016-09-29 16:00:00,637,799,570,229,87,142,2016-09-29 16:00:00,637,885,737,329,1066,1951,2016-09-29 16:00:00,637,245259,244333
"2890",15305,2016-09-29 17:00:00,637,797,602,195,68,127,2016-09-29 17:00:00,637,858,818,410,1228,2086,2016-09-29 17:00:00,637,238303,237398
"2891",15306,2016-09-29 18:00:00,637,787,562,225,70,155,2016-09-29 18:00:00,637,935,865,411,1276,2211,2016-09-29 18:00:00,637,234119,233177
"2892",15307,2016-09-29 19:00:00,637,848,540,308,100,208,2016-09-29 19:00:00,637,957,963,412,1375,2332,2016-09-29 19:00:00,637,219402,218538
"2893",15308,2016-09-29 20:00:00,637,974,600,374,134,240,2016-09-29 20:00:00,637,939,1128,502,1630,2569,2016-09-29 20:00:00,637,200405,199570
"2894",15309,2016-09-29 21:00:00,637,905,517,388,131,257,2016-09-29 21:00:00,637,907,1300,531,1831,2738,2016-09-29 21:00:00,637,167481,166777
"2895",15310,2016-09-29 22:00:00,637,881,482,399,127,272,2016-09-29 22:00:00,637,700,1141,523,1664,2364,2016-09-29 22:00:00,637,138854,138280
"2896",15311,2016-09-29 23:00:00,637,917,496,421,132,289,2016-09-29 23:00:00,637,620,1265,512,1777,2397,2016-09-29 23:00:00,637,124444,123898
"2897",15312,2016-09-30 00:00:00,638,829,434,395,112,283,2016-09-30 00:00:00,638,552,1072,454,1526,2078,2016-09-30 00:00:00,638,119595,119075
"2898",15313,2016-09-30 01:00:00,638,778,422,356,112,244,2016-09-30 01:00:00,638,427,809,344,1153,1580,2016-09-30 01:00:00,638,118303,117779
"2899",15314,2016-09-30 02:00:00,638,716,400,316,89,227,2016-09-30 02:00:00,638,351,646,253,899,1250,2016-09-30 02:00:00,638,109636,109148
"2900",15315,2016-09-30 03:00:00,638,585,344,241,77,164,2016-09-30 03:00:00,638,249,469,178,647,896,2016-09-30 03:00:00,638,99699,99254
"2901",15316,2016-09-30 04:00:00,638,538,267,271,99,172,2016-09-30 04:00:00,638,185,338,151,489,674,2016-09-30 04:00:00,638,88687,88283
"2902",15317,2016-09-30 05:00:00,638,409,220,189,69,120,2016-09-30 05:00:00,638,124,205,87,292,416,2016-09-30 05:00:00,638,85996,85599
"2903",15318,2016-09-30 06:00:00,638,301,191,110,46,64,2016-09-30 06:00:00,638,88,105,47,152,240,2016-09-30 06:00:00,638,92762,92305
"2904",15319,2016-09-30 07:00:00,638,292,187,105,43,62,2016-09-30 07:00:00,638,61,77,35,112,173,2016-09-30 07:00:00,638,95914,95447
"2905",15320,2016-09-30 08:00:00,638,241,183,58,22,36,2016-09-30 08:00:00,638,43,54,23,77,120,2016-09-30 08:00:00,638,96053,95587
"2906",15321,2016-09-30 09:00:00,638,264,178,86,37,49,2016-09-30 09:00:00,638,59,37,20,57,116,2016-09-30 09:00:00,638,99130,98662
"2907",15322,2016-09-30 10:00:00,638,282,192,90,23,67,2016-09-30 10:00:00,638,83,74,43,117,200,2016-09-30 10:00:00,638,109118,108673
"2908",15323,2016-09-30 11:00:00,638,308,222,86,26,60,2016-09-30 11:00:00,638,145,131,69,200,345,2016-09-30 11:00:00,638,151221,150698
"2909",15324,2016-09-30 12:00:00,638,374,251,123,42,81,2016-09-30 12:00:00,638,320,258,139,397,717,2016-09-30 12:00:00,638,219786,219133
"2910",15325,2016-09-30 13:00:00,638,512,334,178,67,111,2016-09-30 13:00:00,638,507,492,246,738,1245,2016-09-30 13:00:00,638,253295,252498
"2911",15326,2016-09-30 14:00:00,638,608,415,193,72,121,2016-09-30 14:00:00,638,700,631,309,940,1640,2016-09-30 14:00:00,638,254321,253478
"2912",15327,2016-09-30 15:00:00,638,738,519,219,71,148,2016-09-30 15:00:00,638,763,721,363,1084,1847,2016-09-30 15:00:00,638,249652,248715
"2913",15328,2016-09-30 16:00:00,638,763,511,252,86,166,2016-09-30 16:00:00,638,951,820,371,1191,2142,2016-09-30 16:00:00,638,222285,221426
"2914",15329,2016-09-30 17:00:00,638,770,504,266,94,172,2016-09-30 17:00:00,638,919,843,369,1212,2131,2016-09-30 17:00:00,638,212905,212087
"2915",15330,2016-09-30 18:00:00,638,777,503,274,104,170,2016-09-30 18:00:00,638,956,913,396,1309,2265,2016-09-30 18:00:00,638,206375,205546
"2916",15331,2016-09-30 19:00:00,638,763,471,292,108,184,2016-09-30 19:00:00,638,921,1062,469,1531,2452,2016-09-30 19:00:00,638,192261,191459
"2917",15332,2016-09-30 20:00:00,638,775,430,345,112,233,2016-09-30 20:00:00,638,916,1285,566,1851,2767,2016-09-30 20:00:00,638,172261,171571
"2918",15333,2016-09-30 21:00:00,638,853,437,416,142,274,2016-09-30 21:00:00,638,857,1359,592,1951,2808,2016-09-30 21:00:00,638,146757,146104
"2919",15334,2016-09-30 22:00:00,638,878,488,390,134,256,2016-09-30 22:00:00,638,751,1359,541,1900,2651,2016-09-30 22:00:00,638,122003,121481
"2920",15335,2016-09-30 23:00:00,638,776,457,319,111,208,2016-09-30 23:00:00,638,652,1419,538,1957,2609,2016-09-30 23:00:00,638,107485,107066
"2921",15336,2016-10-01 00:00:00,639,733,401,332,89,243,2016-10-01 00:00:00,639,510,1300,509,1809,2319,2016-10-01 00:00:00,639,98660,98220
"2922",15337,2016-10-01 01:00:00,639,797,420,377,134,243,2016-10-01 01:00:00,639,392,1105,425,1530,1922,2016-10-01 01:00:00,639,92864,92391
"2923",15338,2016-10-01 02:00:00,639,666,325,341,113,228,2016-10-01 02:00:00,639,317,870,350,1220,1537,2016-10-01 02:00:00,639,88553,88157
"2924",15339,2016-10-01 03:00:00,639,553,290,263,91,172,2016-10-01 03:00:00,639,249,624,258,882,1131,2016-10-01 03:00:00,639,82419,82027
"2925",15340,2016-10-01 04:00:00,639,519,227,292,103,189,2016-10-01 04:00:00,639,196,436,151,587,783,2016-10-01 04:00:00,639,75939,75620
"2926",15341,2016-10-01 05:00:00,639,426,244,182,51,131,2016-10-01 05:00:00,639,140,236,98,334,474,2016-10-01 05:00:00,639,70467,70145
"2927",15342,2016-10-01 06:00:00,639,323,175,148,48,100,2016-10-01 06:00:00,639,75,140,58,198,273,2016-10-01 06:00:00,639,68377,68093
"2928",15343,2016-10-01 07:00:00,639,225,161,64,24,40,2016-10-01 07:00:00,639,60,61,28,89,149,2016-10-01 07:00:00,639,67134,66818
"2929",15344,2016-10-01 08:00:00,639,236,160,76,26,50,2016-10-01 08:00:00,639,73,42,14,56,129,2016-10-01 08:00:00,639,66156,65841
"2930",15345,2016-10-01 09:00:00,639,280,182,98,45,53,2016-10-01 09:00:00,639,49,48,13,61,110,2016-10-01 09:00:00,639,68169,67816
"2931",15346,2016-10-01 10:00:00,639,231,141,90,32,58,2016-10-01 10:00:00,639,38,47,22,69,107,2016-10-01 10:00:00,639,73407,73073
"2932",15347,2016-10-01 11:00:00,639,327,223,104,36,68,2016-10-01 11:00:00,639,117,102,47,149,266,2016-10-01 11:00:00,639,85253,84865
"2933",15348,2016-10-01 12:00:00,639,380,204,176,65,111,2016-10-01 12:00:00,639,217,276,121,397,614,2016-10-01 12:00:00,639,101243,100825
"2934",15349,2016-10-01 13:00:00,639,494,250,244,89,155,2016-10-01 13:00:00,639,384,669,278,947,1331,2016-10-01 13:00:00,639,114236,113784
"2935",15350,2016-10-01 14:00:00,639,627,335,292,92,200,2016-10-01 14:00:00,639,530,1031,449,1480,2010,2016-10-01 14:00:00,639,124602,124069
"2936",15351,2016-10-01 15:00:00,639,763,309,454,180,274,2016-10-01 15:00:00,639,568,1100,461,1561,2129,2016-10-01 15:00:00,639,126918,126313
"2937",15352,2016-10-01 16:00:00,639,831,370,461,168,293,2016-10-01 16:00:00,639,652,1236,533,1769,2421,2016-10-01 16:00:00,639,124476,123884
"2938",15353,2016-10-01 17:00:00,639,742,364,378,132,246,2016-10-01 17:00:00,639,602,1216,503,1719,2321,2016-10-01 17:00:00,639,119687,119104
"2939",15354,2016-10-01 18:00:00,639,936,465,471,190,281,2016-10-01 18:00:00,639,717,1384,574,1958,2675,2016-10-01 18:00:00,639,115196,114614
"2940",15355,2016-10-01 19:00:00,639,842,392,450,176,274,2016-10-01 19:00:00,639,635,1413,582,1995,2630,2016-10-01 19:00:00,639,111188,110616
"2941",15356,2016-10-01 20:00:00,639,837,373,464,161,303,2016-10-01 20:00:00,639,571,1348,526,1874,2445,2016-10-01 20:00:00,639,105274,104773
"2942",15357,2016-10-01 21:00:00,639,856,371,485,150,335,2016-10-01 21:00:00,639,598,1252,519,1771,2369,2016-10-01 21:00:00,639,97295,96783
"2943",15358,2016-10-01 22:00:00,639,976,419,557,170,387,2016-10-01 22:00:00,639,516,1215,483,1698,2214,2016-10-01 22:00:00,639,87997,87555
"2944",15359,2016-10-01 23:00:00,639,769,375,394,133,261,2016-10-01 23:00:00,639,495,1260,506,1766,2261,2016-10-01 23:00:00,639,83029,82636
"2945",15360,2016-10-02 00:00:00,640,868,435,433,126,307,2016-10-02 00:00:00,640,473,1117,436,1553,2026,2016-10-02 00:00:00,640,81224,80801
"2946",15361,2016-10-02 01:00:00,640,883,445,438,130,308,2016-10-02 01:00:00,640,380,919,349,1268,1648,2016-10-02 01:00:00,640,80285,79865
"2947",15362,2016-10-02 02:00:00,640,752,367,385,122,263,2016-10-02 02:00:00,640,284,760,301,1061,1345,2016-10-02 02:00:00,640,78901,78514
"2948",15363,2016-10-02 03:00:00,640,612,302,310,103,207,2016-10-02 03:00:00,640,208,485,208,693,901,2016-10-02 03:00:00,640,74873,74536
"2949",15364,2016-10-02 04:00:00,640,504,258,246,79,167,2016-10-02 04:00:00,640,153,350,143,493,646,2016-10-02 04:00:00,640,70437,70079
"2950",15365,2016-10-02 05:00:00,640,464,209,255,93,162,2016-10-02 05:00:00,640,98,228,86,314,412,2016-10-02 05:00:00,640,65545,65243
"2951",15366,2016-10-02 06:00:00,640,366,181,185,65,120,2016-10-02 06:00:00,640,95,136,61,197,292,2016-10-02 06:00:00,640,63928,63625
"2952",15367,2016-10-02 07:00:00,640,269,159,110,42,68,2016-10-02 07:00:00,640,63,73,29,102,165,2016-10-02 07:00:00,640,63616,63291
"2953",15368,2016-10-02 08:00:00,640,276,176,100,41,59,2016-10-02 08:00:00,640,74,52,29,81,155,2016-10-02 08:00:00,640,62403,62102
"2954",15369,2016-10-02 09:00:00,640,259,168,91,40,51,2016-10-02 09:00:00,640,71,30,13,43,114,2016-10-02 09:00:00,640,63664,63350
"2955",15370,2016-10-02 10:00:00,640,286,174,112,50,62,2016-10-02 10:00:00,640,58,34,12,46,104,2016-10-02 10:00:00,640,68221,67870
"2956",15371,2016-10-02 11:00:00,640,299,191,108,46,62,2016-10-02 11:00:00,640,92,68,23,91,183,2016-10-02 11:00:00,640,76540,76167
"2957",15372,2016-10-02 12:00:00,640,435,252,183,71,112,2016-10-02 12:00:00,640,162,227,101,328,490,2016-10-02 12:00:00,640,87451,87083
"2958",15373,2016-10-02 13:00:00,640,535,273,262,93,169,2016-10-02 13:00:00,640,272,496,244,740,1012,2016-10-02 13:00:00,640,100754,100326
"2959",15374,2016-10-02 14:00:00,640,684,346,338,121,217,2016-10-02 14:00:00,640,343,831,351,1182,1525,2016-10-02 14:00:00,640,110753,110240
"2960",15375,2016-10-02 15:00:00,640,734,366,368,139,229,2016-10-02 15:00:00,640,425,923,430,1353,1778,2016-10-02 15:00:00,640,116361,115848
"2961",15376,2016-10-02 16:00:00,640,835,420,415,165,250,2016-10-02 16:00:00,640,471,1106,472,1578,2049,2016-10-02 16:00:00,640,117541,116990
"2962",15377,2016-10-02 17:00:00,640,779,399,380,137,243,2016-10-02 17:00:00,640,538,1075,439,1514,2052,2016-10-02 17:00:00,640,115019,114426
"2963",15378,2016-10-02 18:00:00,640,871,454,417,152,265,2016-10-02 18:00:00,640,541,1189,483,1672,2213,2016-10-02 18:00:00,640,114799,114261
"2964",15379,2016-10-02 19:00:00,640,777,354,423,174,249,2016-10-02 19:00:00,640,579,1193,494,1687,2266,2016-10-02 19:00:00,640,111546,111044
"2965",15380,2016-10-02 20:00:00,640,775,366,409,152,257,2016-10-02 20:00:00,640,502,1249,505,1754,2256,2016-10-02 20:00:00,640,105283,104775
"2966",15381,2016-10-02 21:00:00,640,844,410,434,148,286,2016-10-02 21:00:00,640,487,1233,480,1713,2200,2016-10-02 21:00:00,640,100114,99643
"2967",15382,2016-10-02 22:00:00,640,873,446,427,126,301,2016-10-02 22:00:00,640,481,1143,445,1588,2069,2016-10-02 22:00:00,640,95263,94782
"2968",15383,2016-10-02 23:00:00,640,855,436,419,145,274,2016-10-02 23:00:00,640,420,1132,459,1591,2011,2016-10-02 23:00:00,640,94328,93901
"2969",15384,2016-10-03 00:00:00,641,882,434,448,141,307,2016-10-03 00:00:00,641,386,955,376,1331,1717,2016-10-03 00:00:00,641,101838,101338
"2970",15385,2016-10-03 01:00:00,641,891,435,456,147,309,2016-10-03 01:00:00,641,325,676,264,940,1265,2016-10-03 01:00:00,641,107221,106756
"2971",15386,2016-10-03 02:00:00,641,690,342,348,118,230,2016-10-03 02:00:00,641,240,461,188,649,889,2016-10-03 02:00:00,641,100584,100163
"2972",15387,2016-10-03 03:00:00,641,679,319,360,117,243,2016-10-03 03:00:00,641,188,367,171,538,726,2016-10-03 03:00:00,641,97157,96764
"2973",15388,2016-10-03 04:00:00,641,457,227,230,98,132,2016-10-03 04:00:00,641,124,224,93,317,441,2016-10-03 04:00:00,641,92683,92296
"2974",15389,2016-10-03 05:00:00,641,369,209,160,55,105,2016-10-03 05:00:00,641,95,106,43,149,244,2016-10-03 05:00:00,641,96321,96008
"2975",15390,2016-10-03 06:00:00,641,317,193,124,53,71,2016-10-03 06:00:00,641,76,77,29,106,182,2016-10-03 06:00:00,641,96313,95943
"2976",15391,2016-10-03 07:00:00,641,261,180,81,31,50,2016-10-03 07:00:00,641,40,50,24,74,114,2016-10-03 07:00:00,641,98401,97972
"2977",15392,2016-10-03 08:00:00,641,253,196,57,26,31,2016-10-03 08:00:00,641,55,28,10,38,93,2016-10-03 08:00:00,641,98804,98359
"2978",15393,2016-10-03 09:00:00,641,252,175,77,36,41,2016-10-03 09:00:00,641,55,21,9,30,85,2016-10-03 09:00:00,641,104088,103622
"2979",15394,2016-10-03 10:00:00,641,270,198,72,29,43,2016-10-03 10:00:00,641,64,53,29,82,146,2016-10-03 10:00:00,641,125852,125389
"2980",15395,2016-10-03 11:00:00,641,296,226,70,29,41,2016-10-03 11:00:00,641,117,131,95,226,343,2016-10-03 11:00:00,641,204867,204345
"2981",15396,2016-10-03 12:00:00,641,501,356,145,56,89,2016-10-03 12:00:00,641,311,389,218,607,918,2016-10-03 12:00:00,641,326408,325697
"2982",15397,2016-10-03 13:00:00,641,499,351,148,54,94,2016-10-03 13:00:00,641,587,646,353,999,1586,2016-10-03 13:00:00,641,353585,352715
"2983",15398,2016-10-03 14:00:00,641,668,470,198,87,111,2016-10-03 14:00:00,641,710,725,368,1093,1803,2016-10-03 14:00:00,641,323648,322670
"2984",15399,2016-10-03 15:00:00,641,764,507,257,105,152,2016-10-03 15:00:00,641,764,860,442,1302,2066,2016-10-03 15:00:00,641,302890,301939
"2985",15400,2016-10-03 16:00:00,641,755,516,239,93,146,2016-10-03 16:00:00,641,859,984,473,1457,2316,2016-10-03 16:00:00,641,260975,260061
"2986",15401,2016-10-03 17:00:00,641,818,493,325,109,216,2016-10-03 17:00:00,641,921,1146,558,1704,2625,2016-10-03 17:00:00,641,244764,243848
"2987",15402,2016-10-03 18:00:00,641,913,564,349,121,228,2016-10-03 18:00:00,641,965,1103,551,1654,2619,2016-10-03 18:00:00,641,236356,235447
"2988",15403,2016-10-03 19:00:00,641,748,425,323,117,206,2016-10-03 19:00:00,641,995,1162,562,1724,2719,2016-10-03 19:00:00,641,218817,217991
"2989",15404,2016-10-03 20:00:00,641,797,400,397,140,257,2016-10-03 20:00:00,641,1062,1500,647,2147,3209,2016-10-03 20:00:00,641,197908,197130
"2990",15405,2016-10-03 21:00:00,641,818,423,395,154,241,2016-10-03 21:00:00,641,951,1587,664,2251,3202,2016-10-03 21:00:00,641,162582,161972
"2991",15406,2016-10-03 22:00:00,641,944,541,403,143,260,2016-10-03 22:00:00,641,799,1592,662,2254,3053,2016-10-03 22:00:00,641,139813,139272
"2992",15407,2016-10-03 23:00:00,641,994,514,480,158,322,2016-10-03 23:00:00,641,712,1552,639,2191,2903,2016-10-03 23:00:00,641,124323,123754
"2993",15408,2016-10-04 00:00:00,642,910,432,478,184,294,2016-10-04 00:00:00,642,632,1340,519,1859,2491,2016-10-04 00:00:00,642,117795,117308
"2994",15409,2016-10-04 01:00:00,642,906,485,421,124,297,2016-10-04 01:00:00,642,503,1097,455,1552,2055,2016-10-04 01:00:00,642,116350,115792
"2995",15410,2016-10-04 02:00:00,642,634,303,331,116,215,2016-10-04 02:00:00,642,386,737,304,1041,1427,2016-10-04 02:00:00,642,106907,106397
"2996",15411,2016-10-04 03:00:00,642,606,308,298,106,192,2016-10-04 03:00:00,642,235,426,191,617,852,2016-10-04 03:00:00,642,97248,96806
"2997",15412,2016-10-04 04:00:00,642,508,306,202,86,116,2016-10-04 04:00:00,642,167,303,139,442,609,2016-10-04 04:00:00,642,88682,88304
"2998",15413,2016-10-04 05:00:00,642,423,250,173,63,110,2016-10-04 05:00:00,642,125,170,66,236,361,2016-10-04 05:00:00,642,84766,84387
"2999",15414,2016-10-04 06:00:00,642,292,183,109,38,71,2016-10-04 06:00:00,642,72,107,49,156,228,2016-10-04 06:00:00,642,91568,91155
"3000",15415,2016-10-04 07:00:00,642,285,189,96,24,72,2016-10-04 07:00:00,642,72,37,16,53,125,2016-10-04 07:00:00,642,96898,96439
"3001",15416,2016-10-04 08:00:00,642,252,175,77,35,42,2016-10-04 08:00:00,642,35,38,15,53,88,2016-10-04 08:00:00,642,97998,97518
"3002",15417,2016-10-04 09:00:00,642,229,177,52,23,29,2016-10-04 09:00:00,642,46,24,13,37,83,2016-10-04 09:00:00,642,99778,99257
"3003",15418,2016-10-04 10:00:00,642,238,178,60,25,35,2016-10-04 10:00:00,642,88,79,34,113,201,2016-10-04 10:00:00,642,106477,106016
"3004",15419,2016-10-04 11:00:00,642,343,258,85,31,54,2016-10-04 11:00:00,642,120,131,76,207,327,2016-10-04 11:00:00,642,143953,143462
"3005",15420,2016-10-04 12:00:00,642,490,347,143,55,88,2016-10-04 12:00:00,642,305,326,155,481,786,2016-10-04 12:00:00,642,205088,204415
"3006",15421,2016-10-04 13:00:00,642,571,426,145,60,85,2016-10-04 13:00:00,642,536,532,283,815,1351,2016-10-04 13:00:00,642,242714,241899
"3007",15422,2016-10-04 14:00:00,642,662,478,184,76,108,2016-10-04 14:00:00,642,663,578,271,849,1512,2016-10-04 14:00:00,642,249270,248360
"3008",15423,2016-10-04 15:00:00,642,779,550,229,77,152,2016-10-04 15:00:00,642,765,710,353,1063,1828,2016-10-04 15:00:00,642,241532,240601
"3009",15424,2016-10-04 16:00:00,642,788,565,223,85,138,2016-10-04 16:00:00,642,823,866,447,1313,2136,2016-10-04 16:00:00,642,218573,217657
"3010",15425,2016-10-04 17:00:00,642,811,558,253,91,162,2016-10-04 17:00:00,642,884,941,465,1406,2290,2016-10-04 17:00:00,642,212903,212058
"3011",15426,2016-10-04 18:00:00,642,833,552,281,95,186,2016-10-04 18:00:00,642,912,898,426,1324,2236,2016-10-04 18:00:00,642,210014,209093
"3012",15427,2016-10-04 19:00:00,642,819,528,291,97,194,2016-10-04 19:00:00,642,842,1069,476,1545,2387,2016-10-04 19:00:00,642,196272,195395
"3013",15428,2016-10-04 20:00:00,642,822,488,334,116,218,2016-10-04 20:00:00,642,896,1238,562,1800,2696,2016-10-04 20:00:00,642,178426,177604
"3014",15429,2016-10-04 21:00:00,642,858,526,332,109,223,2016-10-04 21:00:00,642,720,1302,593,1895,2615,2016-10-04 21:00:00,642,148610,147952
"3015",15430,2016-10-04 22:00:00,642,900,530,370,129,241,2016-10-04 22:00:00,642,699,1216,523,1739,2438,2016-10-04 22:00:00,642,123273,122755
"3016",15431,2016-10-04 23:00:00,642,846,502,344,114,230,2016-10-04 23:00:00,642,639,1264,545,1809,2448,2016-10-04 23:00:00,642,113010,112504
"3017",15432,2016-10-05 00:00:00,643,874,448,426,113,313,2016-10-05 00:00:00,643,561,1574,665,2239,2800,2016-10-05 00:00:00,643,109422,108931
"3018",15433,2016-10-05 01:00:00,643,930,429,501,141,360,2016-10-05 01:00:00,643,406,1763,692,2455,2861,2016-10-05 01:00:00,643,106280,105790
"3019",15434,2016-10-05 02:00:00,643,622,322,300,99,201,2016-10-05 02:00:00,643,320,694,308,1002,1322,2016-10-05 02:00:00,643,96763,96329
"3020",15435,2016-10-05 03:00:00,643,577,315,262,88,174,2016-10-05 03:00:00,643,247,452,180,632,879,2016-10-05 03:00:00,643,90296,89906
"3021",15436,2016-10-05 04:00:00,643,489,267,222,80,142,2016-10-05 04:00:00,643,186,326,127,453,639,2016-10-05 04:00:00,643,83980,83636
"3022",15437,2016-10-05 05:00:00,643,368,218,150,47,103,2016-10-05 05:00:00,643,122,158,59,217,339,2016-10-05 05:00:00,643,81347,80980
"3023",15438,2016-10-05 06:00:00,643,303,190,113,36,77,2016-10-05 06:00:00,643,62,70,25,95,157,2016-10-05 06:00:00,643,87875,87471
"3024",15439,2016-10-05 07:00:00,643,254,176,78,29,49,2016-10-05 07:00:00,643,57,31,13,44,101,2016-10-05 07:00:00,643,92278,91829
"3025",15440,2016-10-05 08:00:00,643,283,201,82,31,51,2016-10-05 08:00:00,643,31,23,12,35,66,2016-10-05 08:00:00,643,93993,93509
"3026",15441,2016-10-05 09:00:00,643,215,157,58,29,29,2016-10-05 09:00:00,643,58,35,21,56,114,2016-10-05 09:00:00,643,96131,95670
"3027",15442,2016-10-05 10:00:00,643,307,228,79,33,46,2016-10-05 10:00:00,643,70,55,30,85,155,2016-10-05 10:00:00,643,100131,99693
"3028",15443,2016-10-05 11:00:00,643,351,257,94,33,61,2016-10-05 11:00:00,643,122,118,60,178,300,2016-10-05 11:00:00,643,124360,123865
"3029",15444,2016-10-05 12:00:00,643,492,349,143,58,85,2016-10-05 12:00:00,643,272,226,105,331,603,2016-10-05 12:00:00,643,169434,168843
"3030",15445,2016-10-05 13:00:00,643,576,430,146,50,96,2016-10-05 13:00:00,643,478,464,246,710,1188,2016-10-05 13:00:00,643,205723,204937
"3031",15446,2016-10-05 14:00:00,643,688,506,182,51,131,2016-10-05 14:00:00,643,599,559,289,848,1447,2016-10-05 14:00:00,643,219120,218255
"3032",15447,2016-10-05 15:00:00,643,754,548,206,84,122,2016-10-05 15:00:00,643,685,646,298,944,1629,2016-10-05 15:00:00,643,216347,215421
"3033",15448,2016-10-05 16:00:00,643,790,550,240,81,159,2016-10-05 16:00:00,643,713,739,377,1116,1829,2016-10-05 16:00:00,643,199494,198643
"3034",15449,2016-10-05 17:00:00,643,798,551,247,96,151,2016-10-05 17:00:00,643,718,757,352,1109,1827,2016-10-05 17:00:00,643,195123,194314
"3035",15450,2016-10-05 18:00:00,643,853,557,296,117,179,2016-10-05 18:00:00,643,775,934,423,1357,2132,2016-10-05 18:00:00,643,193896,193069
"3036",15451,2016-10-05 19:00:00,643,765,481,284,99,185,2016-10-05 19:00:00,643,824,987,449,1436,2260,2016-10-05 19:00:00,643,182202,181397
"3037",15452,2016-10-05 20:00:00,643,884,536,348,105,243,2016-10-05 20:00:00,643,783,1200,511,1711,2494,2016-10-05 20:00:00,643,166849,166120
"3038",15453,2016-10-05 21:00:00,643,844,474,370,138,232,2016-10-05 21:00:00,643,745,1148,475,1623,2368,2016-10-05 21:00:00,643,140664,140086
"3039",15454,2016-10-05 22:00:00,643,1008,512,496,167,329,2016-10-05 22:00:00,643,660,1742,737,2479,3139,2016-10-05 22:00:00,643,118777,118273
"3040",15455,2016-10-05 23:00:00,643,989,454,535,189,346,2016-10-05 23:00:00,643,558,1538,640,2178,2736,2016-10-05 23:00:00,643,107551,107043
"3041",15456,2016-10-06 00:00:00,644,892,454,438,163,275,2016-10-06 00:00:00,644,464,1208,451,1659,2123,2016-10-06 00:00:00,644,106334,105854
"3042",15457,2016-10-06 01:00:00,644,809,428,381,139,242,2016-10-06 01:00:00,644,354,1054,407,1461,1815,2016-10-06 01:00:00,644,106534,106083
"3043",15458,2016-10-06 02:00:00,644,690,358,332,124,208,2016-10-06 02:00:00,644,349,757,296,1053,1402,2016-10-06 02:00:00,644,100025,99587
"3044",15459,2016-10-06 03:00:00,644,718,328,390,113,277,2016-10-06 03:00:00,644,214,1742,411,2153,2367,2016-10-06 03:00:00,644,95477,95076
"3045",15460,2016-10-06 04:00:00,644,605,264,341,105,236,2016-10-06 04:00:00,644,189,851,211,1062,1251,2016-10-06 04:00:00,644,89129,88750
"3046",15461,2016-10-06 05:00:00,644,409,197,212,69,143,2016-10-06 05:00:00,644,111,180,70,250,361,2016-10-06 05:00:00,644,84979,84582
"3047",15462,2016-10-06 06:00:00,644,351,195,156,55,101,2016-10-06 06:00:00,644,89,97,45,142,231,2016-10-06 06:00:00,644,92241,91836
"3048",15463,2016-10-06 07:00:00,644,271,175,96,25,71,2016-10-06 07:00:00,644,62,66,33,99,161,2016-10-06 07:00:00,644,95878,95454
"3049",15464,2016-10-06 08:00:00,644,254,198,56,24,32,2016-10-06 08:00:00,644,52,41,14,55,107,2016-10-06 08:00:00,644,97159,96691
"3050",15465,2016-10-06 09:00:00,644,240,156,84,36,48,2016-10-06 09:00:00,644,72,39,13,52,124,2016-10-06 09:00:00,644,99470,98999
"3051",15466,2016-10-06 10:00:00,644,301,227,74,24,50,2016-10-06 10:00:00,644,102,75,32,107,209,2016-10-06 10:00:00,644,106911,106460
"3052",15467,2016-10-06 11:00:00,644,307,243,64,29,35,2016-10-06 11:00:00,644,128,133,56,189,317,2016-10-06 11:00:00,644,148893,148418
"3053",15468,2016-10-06 12:00:00,644,454,323,131,42,89,2016-10-06 12:00:00,644,265,340,168,508,773,2016-10-06 12:00:00,644,222205,221543
"3054",15469,2016-10-06 13:00:00,644,635,424,211,87,124,2016-10-06 13:00:00,644,430,520,240,760,1190,2016-10-06 13:00:00,644,263672,262918
"3055",15470,2016-10-06 14:00:00,644,687,506,181,66,115,2016-10-06 14:00:00,644,528,652,310,962,1490,2016-10-06 14:00:00,644,264716,263806
"3056",15471,2016-10-06 15:00:00,644,731,496,235,81,154,2016-10-06 15:00:00,644,666,803,326,1129,1795,2016-10-06 15:00:00,644,256328,255368
"3057",15472,2016-10-06 16:00:00,644,856,555,301,97,204,2016-10-06 16:00:00,644,687,927,388,1315,2002,2016-10-06 16:00:00,644,230193,229387
"3058",15473,2016-10-06 17:00:00,644,864,567,297,112,185,2016-10-06 17:00:00,644,756,902,383,1285,2041,2016-10-06 17:00:00,644,225795,224916
"3059",15474,2016-10-06 18:00:00,644,837,537,300,102,198,2016-10-06 18:00:00,644,350,410,196,606,956,2016-10-06 18:00:00,644,223377,222442
"3060",15475,2016-10-06 19:00:00,644,910,628,282,94,188,2016-10-06 19:00:00,644,671,973,407,1380,2051,2016-10-06 19:00:00,644,204757,203964
"3061",15476,2016-10-06 20:00:00,644,837,572,265,69,196,2016-10-06 20:00:00,644,698,1274,552,1826,2524,2016-10-06 20:00:00,644,184293,183568
"3062",15477,2016-10-06 21:00:00,644,942,600,342,111,231,2016-10-06 21:00:00,644,587,1356,559,1915,2502,2016-10-06 21:00:00,644,153383,152822
"3063",15478,2016-10-06 22:00:00,644,897,522,375,120,255,2016-10-06 22:00:00,644,633,1526,617,2143,2776,2016-10-06 22:00:00,644,124176,123667
"3064",15479,2016-10-06 23:00:00,644,910,492,418,116,302,2016-10-06 23:00:00,644,521,1364,532,1896,2417,2016-10-06 23:00:00,644,110304,109827
"3065",15480,2016-10-07 00:00:00,645,860,521,339,86,253,2016-10-07 00:00:00,645,482,1250,494,1744,2226,2016-10-07 00:00:00,645,105253,104790
"3066",15481,2016-10-07 01:00:00,645,921,519,402,115,287,2016-10-07 01:00:00,645,390,1037,406,1443,1833,2016-10-07 01:00:00,645,103965,103538
"3067",15482,2016-10-07 02:00:00,645,804,442,362,128,234,2016-10-07 02:00:00,645,329,831,326,1157,1486,2016-10-07 02:00:00,645,96401,95997
"3068",15483,2016-10-07 03:00:00,645,694,412,282,71,211,2016-10-07 03:00:00,645,231,615,247,862,1093,2016-10-07 03:00:00,645,88676,88285
"3069",15484,2016-10-07 04:00:00,645,572,330,242,52,190,2016-10-07 04:00:00,645,182,491,191,682,864,2016-10-07 04:00:00,645,81053,80731
"3070",15485,2016-10-07 05:00:00,645,503,266,237,60,177,2016-10-07 05:00:00,645,104,262,105,367,471,2016-10-07 05:00:00,645,77630,77312
"3071",15486,2016-10-07 06:00:00,645,372,225,147,52,95,2016-10-07 06:00:00,645,65,136,55,191,256,2016-10-07 06:00:00,645,83492,83117
"3072",15487,2016-10-07 07:00:00,645,301,205,96,40,56,2016-10-07 07:00:00,645,51,77,37,114,165,2016-10-07 07:00:00,645,87505,87084
"3073",15488,2016-10-07 08:00:00,645,251,182,69,27,42,2016-10-07 08:00:00,645,55,44,23,67,122,2016-10-07 08:00:00,645,304,304
"3074",15491,2016-10-07 11:00:00,645,251,187,64,19,45,2016-10-07 11:00:00,645,97,139,61,200,297,2016-10-07 11:00:00,645,73,73
"3075",15492,2016-10-07 12:00:00,645,336,233,103,35,68,2016-10-07 12:00:00,645,243,347,152,499,742,2016-10-07 12:00:00,645,193679,193122
"3076",15493,2016-10-07 13:00:00,645,562,399,163,54,109,2016-10-07 13:00:00,645,428,619,281,900,1328,2016-10-07 13:00:00,645,226155,225415
"3077",15494,2016-10-07 14:00:00,645,587,447,140,34,106,2016-10-07 14:00:00,645,520,793,340,1133,1653,2016-10-07 14:00:00,645,227958,227167
"3078",15495,2016-10-07 15:00:00,645,729,526,203,50,153,2016-10-07 15:00:00,645,584,942,427,1369,1953,2016-10-07 15:00:00,645,221316,220514
"3079",15496,2016-10-07 16:00:00,645,839,566,273,111,162,2016-10-07 16:00:00,645,669,1053,493,1546,2215,2016-10-07 16:00:00,645,197478,196704
"3080",15497,2016-10-07 17:00:00,645,767,556,211,43,168,2016-10-07 17:00:00,645,732,1152,507,1659,2391,2016-10-07 17:00:00,645,189794,189024
"3081",15498,2016-10-07 18:00:00,645,847,581,266,61,205,2016-10-07 18:00:00,645,667,1171,478,1649,2316,2016-10-07 18:00:00,645,183596,182876
"3082",15499,2016-10-07 19:00:00,645,837,564,273,101,172,2016-10-07 19:00:00,645,714,1367,568,1935,2649,2016-10-07 19:00:00,645,168985,168245
"3083",15500,2016-10-07 20:00:00,645,772,540,232,31,201,2016-10-07 20:00:00,645,688,1426,590,2016,2704,2016-10-07 20:00:00,645,518,518
"3084",15502,2016-10-07 22:00:00,645,1006,618,388,145,243,2016-10-07 22:00:00,645,528,1588,653,2241,2769,2016-10-07 22:00:00,645,103425,103016
"3085",15503,2016-10-07 23:00:00,645,902,498,404,126,278,2016-10-07 23:00:00,645,455,1530,624,2154,2609,2016-10-07 23:00:00,645,91538,91161
"3086",15504,2016-10-08 00:00:00,646,826,457,369,94,275,2016-10-08 00:00:00,646,381,1309,506,1815,2196,2016-10-08 00:00:00,646,85398,85015
"3087",15505,2016-10-08 01:00:00,646,707,420,287,63,224,2016-10-08 01:00:00,646,319,1070,440,1510,1829,2016-10-08 01:00:00,646,81626,81205
"3088",15506,2016-10-08 02:00:00,646,690,390,300,62,238,2016-10-08 02:00:00,646,245,925,367,1292,1537,2016-10-08 02:00:00,646,78964,78598
"3089",15507,2016-10-08 03:00:00,646,599,321,278,81,197,2016-10-08 03:00:00,646,199,725,268,993,1192,2016-10-08 03:00:00,646,73941,73614
"3090",15508,2016-10-08 04:00:00,646,512,296,216,53,163,2016-10-08 04:00:00,646,172,484,177,661,833,2016-10-08 04:00:00,646,68522,68232
"3091",15509,2016-10-08 05:00:00,646,487,266,221,58,163,2016-10-08 05:00:00,646,99,255,106,361,460,2016-10-08 05:00:00,646,64840,64545
"3092",15510,2016-10-08 06:00:00,646,370,209,161,56,105,2016-10-08 06:00:00,646,57,120,45,165,222,2016-10-08 06:00:00,646,63826,63499
"3093",15511,2016-10-08 07:00:00,646,286,177,109,44,65,2016-10-08 07:00:00,646,71,97,42,139,210,2016-10-08 07:00:00,646,62905,62620
"3094",15512,2016-10-08 08:00:00,646,249,178,71,23,48,2016-10-08 08:00:00,646,39,60,24,84,123,2016-10-08 08:00:00,646,61993,61717
"3095",15513,2016-10-08 09:00:00,646,298,205,93,30,63,2016-10-08 09:00:00,646,34,30,13,43,77,2016-10-08 09:00:00,646,62912,62586
"3096",15514,2016-10-08 10:00:00,646,258,172,86,26,60,2016-10-08 10:00:00,646,47,37,14,51,98,2016-10-08 10:00:00,646,66287,65977
"3097",15515,2016-10-08 11:00:00,646,328,218,110,36,74,2016-10-08 11:00:00,646,82,142,67,209,291,2016-10-08 11:00:00,646,75929,75589
"3098",15516,2016-10-08 12:00:00,646,448,284,164,50,114,2016-10-08 12:00:00,646,155,289,125,414,569,2016-10-08 12:00:00,646,89927,89540
"3099",15517,2016-10-08 13:00:00,646,583,366,217,61,156,2016-10-08 13:00:00,646,250,685,309,994,1244,2016-10-08 13:00:00,646,100682,100267
"3100",15518,2016-10-08 14:00:00,646,671,430,241,72,169,2016-10-08 14:00:00,646,349,994,402,1396,1745,2016-10-08 14:00:00,646,382,382
"3101",15519,2016-10-08 15:00:00,646,893,540,353,110,243,2016-10-08 15:00:00,646,419,1120,485,1605,2024,2016-10-08 15:00:00,646,11,11
"3102",15520,2016-10-08 16:00:00,646,795,495,300,88,212,2016-10-08 16:00:00,646,471,1423,626,2049,2520,2016-10-08 16:00:00,646,110048,109518
"3103",15521,2016-10-08 17:00:00,646,931,552,379,110,269,2016-10-08 17:00:00,646,456,1429,590,2019,2475,2016-10-08 17:00:00,646,106155,105630
"3104",15522,2016-10-08 18:00:00,646,1015,632,383,129,254,2016-10-08 18:00:00,646,523,1420,604,2024,2547,2016-10-08 18:00:00,646,102286,101804
"3105",15523,2016-10-08 19:00:00,646,897,561,336,104,232,2016-10-08 19:00:00,646,504,1454,582,2036,2540,2016-10-08 19:00:00,646,98216,97739
"3106",15524,2016-10-08 20:00:00,646,976,564,412,144,268,2016-10-08 20:00:00,646,510,1378,555,1933,2443,2016-10-08 20:00:00,646,93047,92568
"3107",15525,2016-10-08 21:00:00,646,927,499,428,133,295,2016-10-08 21:00:00,646,474,1261,497,1758,2232,2016-10-08 21:00:00,646,85808,85404
"3108",15526,2016-10-08 22:00:00,646,928,508,420,112,308,2016-10-08 22:00:00,646,390,1296,510,1806,2196,2016-10-08 22:00:00,646,77930,77553
"3109",15527,2016-10-08 23:00:00,646,808,474,334,78,256,2016-10-08 23:00:00,646,320,1216,447,1663,1983,2016-10-08 23:00:00,646,73541,73198
"3110",15528,2016-10-09 00:00:00,647,799,424,375,85,290,2016-10-09 00:00:00,647,285,1013,364,1377,1662,2016-10-09 00:00:00,647,72025,71652
"3111",15529,2016-10-09 01:00:00,647,796,447,349,74,275,2016-10-09 01:00:00,647,237,952,348,1300,1537,2016-10-09 01:00:00,647,72348,71995
"3112",15530,2016-10-09 02:00:00,647,696,395,301,61,240,2016-10-09 02:00:00,647,207,714,263,977,1184,2016-10-09 02:00:00,647,72027,71704
"3113",15531,2016-10-09 03:00:00,647,535,296,239,43,196,2016-10-09 03:00:00,647,159,707,218,925,1084,2016-10-09 03:00:00,647,71485,71163
"3114",15532,2016-10-09 04:00:00,647,493,283,210,46,164,2016-10-09 04:00:00,647,115,381,142,523,638,2016-10-09 04:00:00,647,69219,68946
"3115",15533,2016-10-09 05:00:00,647,380,218,162,40,122,2016-10-09 05:00:00,647,118,212,78,290,408,2016-10-09 05:00:00,647,66744,66431
"3116",15534,2016-10-09 06:00:00,647,394,227,167,42,125,2016-10-09 06:00:00,647,69,120,43,163,232,2016-10-09 06:00:00,647,65236,64937
"3117",15535,2016-10-09 07:00:00,647,296,198,98,33,65,2016-10-09 07:00:00,647,48,76,37,113,161,2016-10-09 07:00:00,647,64594,64298
"3118",15536,2016-10-09 08:00:00,647,293,214,79,25,54,2016-10-09 08:00:00,647,41,43,20,63,104,2016-10-09 08:00:00,647,63074,62780
"3119",15537,2016-10-09 09:00:00,647,266,195,71,26,45,2016-10-09 09:00:00,647,35,39,8,47,82,2016-10-09 09:00:00,647,62902,62600
"3120",15538,2016-10-09 10:00:00,647,257,170,87,29,58,2016-10-09 10:00:00,647,25,32,18,50,75,2016-10-09 10:00:00,647,65238,64981
"3121",15539,2016-10-09 11:00:00,647,254,189,65,24,41,2016-10-09 11:00:00,647,52,85,36,121,173,2016-10-09 11:00:00,647,71736,71408
"3122",15540,2016-10-09 12:00:00,647,463,309,154,60,94,2016-10-09 12:00:00,647,104,220,83,303,407,2016-10-09 12:00:00,647,82379,82051
"3123",15541,2016-10-09 13:00:00,647,524,363,161,49,112,2016-10-09 13:00:00,647,172,504,232,736,908,2016-10-09 13:00:00,647,91487,91065
"3124",15542,2016-10-09 14:00:00,647,648,411,237,71,166,2016-10-09 14:00:00,647,279,789,328,1117,1396,2016-10-09 14:00:00,647,442,442
"3125",15543,2016-10-09 15:00:00,647,642,383,259,83,176,2016-10-09 15:00:00,647,316,965,422,1387,1703,2016-10-09 15:00:00,647,54,54
"3126",15544,2016-10-09 16:00:00,647,772,503,269,75,194,2016-10-09 16:00:00,647,406,1167,508,1675,2081,2016-10-09 16:00:00,647,107080,106594
"3127",15545,2016-10-09 17:00:00,647,792,483,309,99,210,2016-10-09 17:00:00,647,439,1107,462,1569,2008,2016-10-09 17:00:00,647,104980,104507
"3128",15546,2016-10-09 18:00:00,647,857,516,341,105,236,2016-10-09 18:00:00,647,438,1221,464,1685,2123,2016-10-09 18:00:00,647,103278,102777
"3129",15547,2016-10-09 19:00:00,647,824,461,363,111,252,2016-10-09 19:00:00,647,436,1187,479,1666,2102,2016-10-09 19:00:00,647,99743,99275
"3130",15548,2016-10-09 20:00:00,647,760,433,327,97,230,2016-10-09 20:00:00,647,401,1213,505,1718,2119,2016-10-09 20:00:00,647,94744,94307
"3131",15549,2016-10-09 21:00:00,647,761,416,345,119,226,2016-10-09 21:00:00,647,433,1195,432,1627,2060,2016-10-09 21:00:00,647,90659,90213
"3132",15550,2016-10-09 22:00:00,647,810,487,323,124,199,2016-10-09 22:00:00,647,361,1250,487,1737,2098,2016-10-09 22:00:00,647,86281,85883
"3133",15551,2016-10-09 23:00:00,647,804,508,296,95,201,2016-10-09 23:00:00,647,353,1094,429,1523,1876,2016-10-09 23:00:00,647,85350,84982
"3134",15552,2016-10-10 00:00:00,648,876,518,358,106,252,2016-10-10 00:00:00,648,235,992,369,1361,1596,2016-10-10 00:00:00,648,91202,90849
"3135",15553,2016-10-10 01:00:00,648,879,477,402,125,277,2016-10-10 01:00:00,648,234,740,296,1036,1270,2016-10-10 01:00:00,648,88108,87758
"3136",15554,2016-10-10 02:00:00,648,709,414,295,95,200,2016-10-10 02:00:00,648,164,520,200,720,884,2016-10-10 02:00:00,648,85123,84768
"3137",15555,2016-10-10 03:00:00,648,626,364,262,84,178,2016-10-10 03:00:00,648,164,370,152,522,686,2016-10-10 03:00:00,648,86664,86298
"3138",15556,2016-10-10 04:00:00,648,469,276,193,52,141,2016-10-10 04:00:00,648,107,235,96,331,438,2016-10-10 04:00:00,648,83128,82808
"3139",15557,2016-10-10 05:00:00,648,411,268,143,54,89,2016-10-10 05:00:00,648,81,160,59,219,300,2016-10-10 05:00:00,648,83382,83060
"3140",15558,2016-10-10 06:00:00,648,332,225,107,35,72,2016-10-10 06:00:00,648,58,76,31,107,165,2016-10-10 06:00:00,648,90837,90450
"3141",15559,2016-10-10 07:00:00,648,275,205,70,26,44,2016-10-10 07:00:00,648,37,52,22,74,111,2016-10-10 07:00:00,648,93271,92856
"3142",15560,2016-10-10 08:00:00,648,269,210,59,19,40,2016-10-10 08:00:00,648,33,24,9,33,66,2016-10-10 08:00:00,648,94883,94408
"3143",15561,2016-10-10 09:00:00,648,273,211,62,28,34,2016-10-10 09:00:00,648,37,35,14,49,86,2016-10-10 09:00:00,648,96314,95841
"3144",15562,2016-10-10 10:00:00,648,274,227,47,16,31,2016-10-10 10:00:00,648,49,42,24,66,115,2016-10-10 10:00:00,648,111398,110960
"3145",15563,2016-10-10 11:00:00,648,312,250,62,26,36,2016-10-10 11:00:00,648,91,133,74,207,298,2016-10-10 11:00:00,648,174745,174257
"3146",15564,2016-10-10 12:00:00,648,467,364,103,35,68,2016-10-10 12:00:00,648,183,275,141,416,599,2016-10-10 12:00:00,648,264394,263781
"3147",15565,2016-10-10 13:00:00,648,618,477,141,51,90,2016-10-10 13:00:00,648,430,568,288,856,1286,2016-10-10 13:00:00,648,287264,286574
"3148",15566,2016-10-10 14:00:00,648,770,570,200,71,129,2016-10-10 14:00:00,648,487,752,395,1147,1634,2016-10-10 14:00:00,648,269504,268684
"3149",15567,2016-10-10 15:00:00,648,895,634,261,104,157,2016-10-10 15:00:00,648,586,1034,494,1528,2114,2016-10-10 15:00:00,648,253868,253058
"3150",15568,2016-10-10 16:00:00,648,898,656,242,73,169,2016-10-10 16:00:00,648,672,1088,488,1576,2248,2016-10-10 16:00:00,648,219450,218638
"3151",15569,2016-10-10 17:00:00,648,939,674,265,79,186,2016-10-10 17:00:00,648,745,1109,461,1570,2315,2016-10-10 17:00:00,648,201132,200370
"3152",15570,2016-10-10 18:00:00,648,988,680,308,95,213,2016-10-10 18:00:00,648,744,1185,516,1701,2445,2016-10-10 18:00:00,648,195704,194967
"3153",15571,2016-10-10 19:00:00,648,939,676,263,69,194,2016-10-10 19:00:00,648,775,1277,520,1797,2572,2016-10-10 19:00:00,648,185131,184382
"3154",15572,2016-10-10 20:00:00,648,935,630,305,105,200,2016-10-10 20:00:00,648,740,1312,523,1835,2575,2016-10-10 20:00:00,648,168504,167802
"3155",15573,2016-10-10 21:00:00,648,885,558,327,92,235,2016-10-10 21:00:00,648,678,1392,602,1994,2672,2016-10-10 21:00:00,648,143081,142492
"3156",15574,2016-10-10 22:00:00,648,916,587,329,114,215,2016-10-10 22:00:00,648,599,1461,606,2067,2666,2016-10-10 22:00:00,648,117660,117103
"3157",15575,2016-10-10 23:00:00,648,895,564,331,96,235,2016-10-10 23:00:00,648,520,1320,547,1867,2387,2016-10-10 23:00:00,648,107013,106530
"3158",15576,2016-10-11 00:00:00,649,837,491,346,108,238,2016-10-11 00:00:00,649,413,1202,462,1664,2077,2016-10-11 00:00:00,649,103699,103249
"3159",15577,2016-10-11 01:00:00,649,853,555,298,112,186,2016-10-11 01:00:00,649,381,993,379,1372,1753,2016-10-11 01:00:00,649,102598,102165
"3160",15578,2016-10-11 02:00:00,649,699,404,295,108,187,2016-10-11 02:00:00,649,282,683,280,963,1245,2016-10-11 02:00:00,649,95988,95575
"3161",15579,2016-10-11 03:00:00,649,657,426,231,86,145,2016-10-11 03:00:00,649,217,519,209,728,945,2016-10-11 03:00:00,649,86541,86185
"3162",15580,2016-10-11 04:00:00,649,598,363,235,87,148,2016-10-11 04:00:00,649,164,340,131,471,635,2016-10-11 04:00:00,649,78495,78135
"3163",15581,2016-10-11 05:00:00,649,469,312,157,43,114,2016-10-11 05:00:00,649,97,185,72,257,354,2016-10-11 05:00:00,649,75090,74758
"3164",15582,2016-10-11 06:00:00,649,340,230,110,37,73,2016-10-11 06:00:00,649,60,116,49,165,225,2016-10-11 06:00:00,649,81689,81320
"3165",15583,2016-10-11 07:00:00,649,289,213,76,20,56,2016-10-11 07:00:00,649,51,161,42,203,254,2016-10-11 07:00:00,649,86287,85858
"3166",15584,2016-10-11 08:00:00,649,247,195,52,16,36,2016-10-11 08:00:00,649,67,428,74,502,569,2016-10-11 08:00:00,649,87966,87537
"3167",15585,2016-10-11 09:00:00,649,266,175,91,12,79,2016-10-11 09:00:00,649,41,390,48,438,479,2016-10-11 09:00:00,649,87957,87526
"3168",15586,2016-10-11 10:00:00,649,257,192,65,11,54,2016-10-11 10:00:00,649,91,603,82,685,776,2016-10-11 10:00:00,649,95952,95582
"3169",15587,2016-10-11 11:00:00,649,429,303,126,24,102,2016-10-11 11:00:00,649,116,355,85,440,556,2016-10-11 11:00:00,649,140565,140144
"3170",15588,2016-10-11 12:00:00,649,513,372,141,42,99,2016-10-11 12:00:00,649,221,319,137,456,677,2016-10-11 12:00:00,649,218472,217943
"3171",15589,2016-10-11 13:00:00,649,599,458,141,53,88,2016-10-11 13:00:00,649,385,544,237,781,1166,2016-10-11 13:00:00,649,247074,246380
"3172",15590,2016-10-11 14:00:00,649,730,569,161,61,100,2016-10-11 14:00:00,649,516,623,294,917,1433,2016-10-11 14:00:00,649,242460,241628
"3173",15591,2016-10-11 15:00:00,649,814,615,199,60,139,2016-10-11 15:00:00,649,612,816,355,1171,1783,2016-10-11 15:00:00,649,233578,232791
"3174",15592,2016-10-11 16:00:00,649,849,597,252,95,157,2016-10-11 16:00:00,649,685,916,399,1315,2000,2016-10-11 16:00:00,649,208593,207787
"3175",15593,2016-10-11 17:00:00,649,860,628,232,72,160,2016-10-11 17:00:00,649,704,933,391,1324,2028,2016-10-11 17:00:00,649,200860,200087
"3176",15594,2016-10-11 18:00:00,649,859,628,231,62,169,2016-10-11 18:00:00,649,758,1083,454,1537,2295,2016-10-11 18:00:00,649,203865,203001
"3177",15595,2016-10-11 19:00:00,649,768,583,185,43,142,2016-10-11 19:00:00,649,726,1232,545,1777,2503,2016-10-11 19:00:00,649,189829,188965
"3178",15596,2016-10-11 20:00:00,649,793,612,181,41,140,2016-10-11 20:00:00,649,722,1319,602,1921,2643,2016-10-11 20:00:00,649,174753,174064
"3179",15597,2016-10-11 21:00:00,649,906,579,327,85,242,2016-10-11 21:00:00,649,635,1465,592,2057,2692,2016-10-11 21:00:00,649,147409,146773
"3180",15598,2016-10-11 22:00:00,649,951,599,352,101,251,2016-10-11 22:00:00,649,633,1483,570,2053,2686,2016-10-11 22:00:00,649,126096,125542
"3181",15599,2016-10-11 23:00:00,649,929,651,278,42,236,2016-10-11 23:00:00,649,502,1458,582,2040,2542,2016-10-11 23:00:00,649,115913,115406
"3182",15600,2016-10-12 00:00:00,650,987,616,371,66,305,2016-10-12 00:00:00,650,476,1356,547,1903,2379,2016-10-12 00:00:00,650,111762,111257
"3183",15601,2016-10-12 01:00:00,650,924,548,376,55,321,2016-10-12 01:00:00,650,303,805,303,1108,1411,2016-10-12 01:00:00,650,111098,110554
"3184",15602,2016-10-12 02:00:00,650,718,440,278,39,239,2016-10-12 02:00:00,650,328,782,304,1086,1414,2016-10-12 02:00:00,650,105636,105157
"3185",15603,2016-10-12 03:00:00,650,624,438,186,29,157,2016-10-12 03:00:00,650,215,585,232,817,1032,2016-10-12 03:00:00,650,98768,98297
"3186",15604,2016-10-12 04:00:00,650,576,370,206,44,162,2016-10-12 04:00:00,650,156,335,108,443,599,2016-10-12 04:00:00,650,90584,90214
"3187",15605,2016-10-12 05:00:00,650,465,308,157,16,141,2016-10-12 05:00:00,650,87,178,66,244,331,2016-10-12 05:00:00,650,87553,87154
"3188",15606,2016-10-12 06:00:00,650,323,211,112,12,100,2016-10-12 06:00:00,650,73,83,34,117,190,2016-10-12 06:00:00,650,92993,92588
"3189",15607,2016-10-12 07:00:00,650,287,217,70,8,62,2016-10-12 07:00:00,650,64,49,22,71,135,2016-10-12 07:00:00,650,98089,97622
"3190",15608,2016-10-12 08:00:00,650,254,228,26,5,21,2016-10-12 08:00:00,650,43,34,11,45,88,2016-10-12 08:00:00,650,100259,99780
"3191",15609,2016-10-12 09:00:00,650,237,175,62,10,52,2016-10-12 09:00:00,650,43,36,21,57,100,2016-10-12 09:00:00,650,100622,100136
"3192",15610,2016-10-12 10:00:00,650,301,254,47,8,39,2016-10-12 10:00:00,650,58,39,27,66,124,2016-10-12 10:00:00,650,105451,105037
"3193",15611,2016-10-12 11:00:00,650,302,254,48,4,44,2016-10-12 11:00:00,650,99,137,65,202,301,2016-10-12 11:00:00,650,133009,132491
"3194",15612,2016-10-12 12:00:00,650,403,327,76,15,61,2016-10-12 12:00:00,650,259,336,155,491,750,2016-10-12 12:00:00,650,181134,180473
"3195",15613,2016-10-12 13:00:00,650,583,461,122,19,103,2016-10-12 13:00:00,650,417,565,278,843,1260,2016-10-12 13:00:00,650,218286,217439
"3196",15614,2016-10-12 14:00:00,650,741,579,162,22,140,2016-10-12 14:00:00,650,588,666,295,961,1549,2016-10-12 14:00:00,650,230178,229200
"3197",15615,2016-10-12 15:00:00,650,842,670,172,23,149,2016-10-12 15:00:00,650,664,765,355,1120,1784,2016-10-12 15:00:00,650,226850,225892
"3198",15616,2016-10-12 16:00:00,650,861,620,241,81,160,2016-10-12 16:00:00,650,714,867,426,1293,2007,2016-10-12 16:00:00,650,210598,209725
"3199",15617,2016-10-12 17:00:00,650,888,660,228,89,139,2016-10-12 17:00:00,650,761,998,457,1455,2216,2016-10-12 17:00:00,650,204672,203787
"3200",15618,2016-10-12 18:00:00,650,976,699,277,84,193,2016-10-12 18:00:00,650,786,1021,450,1471,2257,2016-10-12 18:00:00,650,201781,200900
"3201",15619,2016-10-12 19:00:00,650,947,664,283,87,196,2016-10-12 19:00:00,650,774,1108,510,1618,2392,2016-10-12 19:00:00,650,190178,189332
"3202",15620,2016-10-12 20:00:00,650,948,687,261,81,180,2016-10-12 20:00:00,650,794,1216,564,1780,2574,2016-10-12 20:00:00,650,176877,176098
"3203",15621,2016-10-12 21:00:00,650,975,639,336,115,221,2016-10-12 21:00:00,650,696,1294,558,1852,2548,2016-10-12 21:00:00,650,154011,153314
"3204",15622,2016-10-12 22:00:00,650,953,588,365,136,229,2016-10-12 22:00:00,650,600,1301,550,1851,2451,2016-10-12 22:00:00,650,132848,132271
"3205",15623,2016-10-12 23:00:00,650,924,596,328,110,218,2016-10-12 23:00:00,650,578,1349,514,1863,2441,2016-10-12 23:00:00,650,122706,122156
"3206",15624,2016-10-13 00:00:00,651,948,594,354,122,232,2016-10-13 00:00:00,651,443,1092,422,1514,1957,2016-10-13 00:00:00,651,127143,126652
"3207",15625,2016-10-13 01:00:00,651,985,609,376,108,268,2016-10-13 01:00:00,651,367,1107,453,1560,1927,2016-10-13 01:00:00,651,119931,119454
"3208",15626,2016-10-13 02:00:00,651,784,476,308,99,209,2016-10-13 02:00:00,651,305,727,253,980,1285,2016-10-13 02:00:00,651,111249,110813
"3209",15627,2016-10-13 03:00:00,651,706,442,264,88,176,2016-10-13 03:00:00,651,285,513,198,711,996,2016-10-13 03:00:00,651,109443,108999
"3210",15628,2016-10-13 04:00:00,651,561,338,223,71,152,2016-10-13 04:00:00,651,218,295,138,433,651,2016-10-13 04:00:00,651,96383,95985
"3211",15629,2016-10-13 05:00:00,651,433,279,154,61,93,2016-10-13 05:00:00,651,90,204,85,289,379,2016-10-13 05:00:00,651,94249,93859
"3212",15630,2016-10-13 06:00:00,651,392,261,131,50,81,2016-10-13 06:00:00,651,77,109,41,150,227,2016-10-13 06:00:00,651,100843,100414
"3213",15631,2016-10-13 07:00:00,651,317,237,80,33,47,2016-10-13 07:00:00,651,43,71,19,90,133,2016-10-13 07:00:00,651,107801,107308
"3214",15632,2016-10-13 08:00:00,651,268,209,59,21,38,2016-10-13 08:00:00,651,53,32,7,39,92,2016-10-13 08:00:00,651,107517,106996
"3215",15633,2016-10-13 09:00:00,651,266,200,66,21,45,2016-10-13 09:00:00,651,44,35,18,53,97,2016-10-13 09:00:00,651,107460,106928
"3216",15634,2016-10-13 10:00:00,651,316,246,70,28,42,2016-10-13 10:00:00,651,48,58,29,87,135,2016-10-13 10:00:00,651,116265,115764
"3217",15635,2016-10-13 11:00:00,651,302,247,55,32,23,2016-10-13 11:00:00,651,106,105,61,166,272,2016-10-13 11:00:00,651,157352,156873
"3218",15636,2016-10-13 12:00:00,651,407,318,89,31,58,2016-10-13 12:00:00,651,287,259,123,382,669,2016-10-13 12:00:00,651,230656,229940
"3219",15637,2016-10-13 13:00:00,651,532,406,126,53,73,2016-10-13 13:00:00,651,466,503,245,748,1214,2016-10-13 13:00:00,651,274375,273529
"3220",15638,2016-10-13 14:00:00,651,665,528,137,57,80,2016-10-13 14:00:00,651,576,611,294,905,1481,2016-10-13 14:00:00,651,275254,274288
"3221",15639,2016-10-13 15:00:00,651,776,639,137,32,105,2016-10-13 15:00:00,651,749,731,350,1081,1830,2016-10-13 15:00:00,651,267456,266470
"3222",15640,2016-10-13 16:00:00,651,766,598,168,67,101,2016-10-13 16:00:00,651,770,772,347,1119,1889,2016-10-13 16:00:00,651,241245,240320
"3223",15641,2016-10-13 17:00:00,651,823,635,188,63,125,2016-10-13 17:00:00,651,788,865,398,1263,2051,2016-10-13 17:00:00,651,231008,230142
"3224",15642,2016-10-13 18:00:00,651,907,703,204,64,140,2016-10-13 18:00:00,651,805,882,379,1261,2066,2016-10-13 18:00:00,651,226596,225640
"3225",15643,2016-10-13 19:00:00,651,869,630,239,75,164,2016-10-13 19:00:00,651,806,1079,458,1537,2343,2016-10-13 19:00:00,651,212874,211998
"3226",15644,2016-10-13 20:00:00,651,936,680,256,78,178,2016-10-13 20:00:00,651,761,1207,539,1746,2507,2016-10-13 20:00:00,651,193367,192627
"3227",15645,2016-10-13 21:00:00,651,977,627,350,113,237,2016-10-13 21:00:00,651,669,1322,555,1877,2546,2016-10-13 21:00:00,651,163102,162486
"3228",15646,2016-10-13 22:00:00,651,939,589,350,111,239,2016-10-13 22:00:00,651,587,1297,528,1825,2412,2016-10-13 22:00:00,651,133430,132870
"3229",15647,2016-10-13 23:00:00,651,894,562,332,112,220,2016-10-13 23:00:00,651,571,1184,456,1640,2211,2016-10-13 23:00:00,651,120000,119470
"3230",15648,2016-10-14 00:00:00,652,899,567,332,97,235,2016-10-14 00:00:00,652,451,1101,436,1537,1988,2016-10-14 00:00:00,652,114043,113546
"3231",15649,2016-10-14 01:00:00,652,841,486,355,102,253,2016-10-14 01:00:00,652,406,879,348,1227,1633,2016-10-14 01:00:00,652,112304,111809
"3232",15650,2016-10-14 02:00:00,652,807,485,322,107,215,2016-10-14 02:00:00,652,275,606,244,850,1125,2016-10-14 02:00:00,652,103946,103491
"3233",15651,2016-10-14 03:00:00,652,564,356,208,64,144,2016-10-14 03:00:00,652,192,454,179,633,825,2016-10-14 03:00:00,652,93364,92967
"3234",15652,2016-10-14 04:00:00,652,467,279,188,60,128,2016-10-14 04:00:00,652,176,337,131,468,644,2016-10-14 04:00:00,652,85133,84764
"3235",15653,2016-10-14 05:00:00,652,434,293,141,40,101,2016-10-14 05:00:00,652,115,161,63,224,339,2016-10-14 05:00:00,652,81190,80843
"3236",15654,2016-10-14 06:00:00,652,340,234,106,38,68,2016-10-14 06:00:00,652,84,101,36,137,221,2016-10-14 06:00:00,652,88270,87876
"3237",15655,2016-10-14 07:00:00,652,297,193,104,37,67,2016-10-14 07:00:00,652,43,53,26,79,122,2016-10-14 07:00:00,652,92777,92352
"3238",15656,2016-10-14 08:00:00,652,251,186,65,17,48,2016-10-14 08:00:00,652,33,43,16,59,92,2016-10-14 08:00:00,652,91082,90616
"3239",15657,2016-10-14 09:00:00,652,227,173,54,20,34,2016-10-14 09:00:00,652,53,29,11,40,93,2016-10-14 09:00:00,652,94745,94355
"3240",15658,2016-10-14 10:00:00,652,269,216,53,23,30,2016-10-14 10:00:00,652,46,70,39,109,155,2016-10-14 10:00:00,652,103205,102777
"3241",15659,2016-10-14 11:00:00,652,317,270,47,14,33,2016-10-14 11:00:00,652,133,111,49,160,293,2016-10-14 11:00:00,652,142264,141854
"3242",15660,2016-10-14 12:00:00,652,388,310,78,31,47,2016-10-14 12:00:00,652,267,249,138,387,654,2016-10-14 12:00:00,652,207159,206573
"3243",15661,2016-10-14 13:00:00,652,590,453,137,62,75,2016-10-14 13:00:00,652,484,526,290,816,1300,2016-10-14 13:00:00,652,243486,242719
"3244",15662,2016-10-14 14:00:00,652,680,530,150,51,99,2016-10-14 14:00:00,652,579,588,290,878,1457,2016-10-14 14:00:00,652,243575,242726
"3245",15663,2016-10-14 15:00:00,652,789,603,186,61,125,2016-10-14 15:00:00,652,675,768,374,1142,1817,2016-10-14 15:00:00,652,236062,235235
"3246",15664,2016-10-14 16:00:00,652,856,644,212,69,143,2016-10-14 16:00:00,652,651,806,393,1199,1850,2016-10-14 16:00:00,652,211543,210720
"3247",15665,2016-10-14 17:00:00,652,849,635,214,63,151,2016-10-14 17:00:00,652,749,973,444,1417,2166,2016-10-14 17:00:00,652,201240,200418
"3248",15666,2016-10-14 18:00:00,652,855,634,221,69,152,2016-10-14 18:00:00,652,685,1006,466,1472,2157,2016-10-14 18:00:00,652,196436,195611
"3249",15667,2016-10-14 19:00:00,652,920,652,268,74,194,2016-10-14 19:00:00,652,702,1477,628,2105,2807,2016-10-14 19:00:00,652,181519,180824
"3250",15668,2016-10-14 20:00:00,652,936,623,313,92,221,2016-10-14 20:00:00,652,730,1953,825,2778,3508,2016-10-14 20:00:00,652,162994,162275
"3251",15669,2016-10-14 21:00:00,652,883,592,291,106,185,2016-10-14 21:00:00,652,620,1317,568,1885,2505,2016-10-14 21:00:00,652,133373,132788
"3252",15670,2016-10-14 22:00:00,652,897,561,336,97,239,2016-10-14 22:00:00,652,571,1297,561,1858,2429,2016-10-14 22:00:00,652,108954,108497
"3253",15671,2016-10-14 23:00:00,652,839,525,314,91,223,2016-10-14 23:00:00,652,475,1298,506,1804,2279,2016-10-14 23:00:00,652,95909,95523
"3254",15672,2016-10-15 00:00:00,653,816,484,332,101,231,2016-10-15 00:00:00,653,376,1148,463,1611,1987,2016-10-15 00:00:00,653,91242,90863
"3255",15673,2016-10-15 01:00:00,653,814,472,342,117,225,2016-10-15 01:00:00,653,331,1057,394,1451,1782,2016-10-15 01:00:00,653,84050,83679
"3256",15674,2016-10-15 02:00:00,653,761,426,335,101,234,2016-10-15 02:00:00,653,258,798,298,1096,1354,2016-10-15 02:00:00,653,80062,79688
"3257",15675,2016-10-15 03:00:00,653,671,400,271,85,186,2016-10-15 03:00:00,653,230,623,250,873,1103,2016-10-15 03:00:00,653,77284,76952
"3258",15676,2016-10-15 04:00:00,653,559,296,263,89,174,2016-10-15 04:00:00,653,149,454,189,643,792,2016-10-15 04:00:00,653,72631,72328
"3259",15677,2016-10-15 05:00:00,653,495,295,200,64,136,2016-10-15 05:00:00,653,103,291,120,411,514,2016-10-15 05:00:00,653,66889,66583
"3260",15678,2016-10-15 06:00:00,653,390,234,156,54,102,2016-10-15 06:00:00,653,77,150,62,212,289,2016-10-15 06:00:00,653,65938,65664
"3261",15679,2016-10-15 07:00:00,653,389,273,116,36,80,2016-10-15 07:00:00,653,41,84,32,116,157,2016-10-15 07:00:00,653,64772,64474
"3262",15680,2016-10-15 08:00:00,653,262,193,69,27,42,2016-10-15 08:00:00,653,38,50,19,69,107,2016-10-15 08:00:00,653,64613,64351
"3263",15681,2016-10-15 09:00:00,653,263,183,80,28,52,2016-10-15 09:00:00,653,57,15,6,21,78,2016-10-15 09:00:00,653,65689,65383
"3264",15682,2016-10-15 10:00:00,653,241,186,55,15,40,2016-10-15 10:00:00,653,57,40,14,54,111,2016-10-15 10:00:00,653,69241,68925
"3265",15683,2016-10-15 11:00:00,653,317,237,80,27,53,2016-10-15 11:00:00,653,59,105,50,155,214,2016-10-15 11:00:00,653,79228,78907
"3266",15684,2016-10-15 12:00:00,653,386,244,142,55,87,2016-10-15 12:00:00,653,161,290,126,416,577,2016-10-15 12:00:00,653,91671,91294
"3267",15685,2016-10-15 13:00:00,653,574,370,204,57,147,2016-10-15 13:00:00,653,264,537,246,783,1047,2016-10-15 13:00:00,653,104512,104092
"3268",15686,2016-10-15 14:00:00,653,662,432,230,85,145,2016-10-15 14:00:00,653,363,862,354,1216,1579,2016-10-15 14:00:00,653,112687,112200
"3269",15687,2016-10-15 15:00:00,653,750,439,311,97,214,2016-10-15 15:00:00,653,419,1080,462,1542,1961,2016-10-15 15:00:00,653,114789,114281
"3270",15688,2016-10-15 16:00:00,653,760,456,304,81,223,2016-10-15 16:00:00,653,469,1216,535,1751,2220,2016-10-15 16:00:00,653,113427,112907
"3271",15689,2016-10-15 17:00:00,653,808,488,320,99,221,2016-10-15 17:00:00,653,481,1146,512,1658,2139,2016-10-15 17:00:00,653,109073,108551
"3272",15690,2016-10-15 18:00:00,653,904,541,363,114,249,2016-10-15 18:00:00,653,528,1283,533,1816,2344,2016-10-15 18:00:00,653,105467,104940
"3273",15691,2016-10-15 19:00:00,653,891,533,358,101,257,2016-10-15 19:00:00,653,511,1369,568,1937,2448,2016-10-15 19:00:00,653,100127,99608
"3274",15692,2016-10-15 20:00:00,653,818,498,320,60,260,2016-10-15 20:00:00,653,449,1453,590,2043,2492,2016-10-15 20:00:00,653,95023,94564
"3275",15693,2016-10-15 21:00:00,653,939,489,450,103,347,2016-10-15 21:00:00,653,434,1530,647,2177,2611,2016-10-15 21:00:00,653,87818,87409
"3276",15694,2016-10-15 22:00:00,653,1063,590,473,179,294,2016-10-15 22:00:00,653,385,1496,637,2133,2518,2016-10-15 22:00:00,653,81164,80761
"3277",15695,2016-10-15 23:00:00,653,806,453,353,61,292,2016-10-15 23:00:00,653,358,1397,560,1957,2315,2016-10-15 23:00:00,653,76893,76535
"3278",15696,2016-10-16 00:00:00,654,908,496,412,94,318,2016-10-16 00:00:00,654,312,1387,504,1891,2203,2016-10-16 00:00:00,654,75763,75394
"3279",15697,2016-10-16 01:00:00,654,834,445,389,98,291,2016-10-16 01:00:00,654,259,958,370,1328,1587,2016-10-16 01:00:00,654,75178,74842
"3280",15698,2016-10-16 02:00:00,654,669,357,312,59,253,2016-10-16 02:00:00,654,211,719,274,993,1204,2016-10-16 02:00:00,654,74098,73739
"3281",15699,2016-10-16 03:00:00,654,637,331,306,72,234,2016-10-16 03:00:00,654,169,586,216,802,971,2016-10-16 03:00:00,654,73409,73068
"3282",15700,2016-10-16 04:00:00,654,495,267,228,54,174,2016-10-16 04:00:00,654,114,420,168,588,702,2016-10-16 04:00:00,654,72170,71896
"3283",15701,2016-10-16 05:00:00,654,454,255,199,50,149,2016-10-16 05:00:00,654,100,210,82,292,392,2016-10-16 05:00:00,654,68157,67849
"3284",15702,2016-10-16 06:00:00,654,350,195,155,52,103,2016-10-16 06:00:00,654,68,136,56,192,260,2016-10-16 06:00:00,654,64603,64334
"3285",15703,2016-10-16 07:00:00,654,314,208,106,35,71,2016-10-16 07:00:00,654,51,63,29,92,143,2016-10-16 07:00:00,654,63931,63663
"3286",15704,2016-10-16 08:00:00,654,275,169,106,34,72,2016-10-16 08:00:00,654,29,58,24,82,111,2016-10-16 08:00:00,654,63425,63116
"3287",15705,2016-10-16 09:00:00,654,239,181,58,17,41,2016-10-16 09:00:00,654,30,28,11,39,69,2016-10-16 09:00:00,654,63572,63277
"3288",15706,2016-10-16 10:00:00,654,219,155,64,23,41,2016-10-16 10:00:00,654,38,49,19,68,106,2016-10-16 10:00:00,654,67587,67278
"3289",15707,2016-10-16 11:00:00,654,253,194,59,11,48,2016-10-16 11:00:00,654,62,96,52,148,210,2016-10-16 11:00:00,654,74157,73859
"3290",15708,2016-10-16 12:00:00,654,368,247,121,34,87,2016-10-16 12:00:00,654,121,266,135,401,522,2016-10-16 12:00:00,654,84521,84183
"3291",15709,2016-10-16 13:00:00,654,530,350,180,45,135,2016-10-16 13:00:00,654,216,540,236,776,992,2016-10-16 13:00:00,654,95009,94595
"3292",15710,2016-10-16 14:00:00,654,629,411,218,56,162,2016-10-16 14:00:00,654,314,1003,437,1440,1754,2016-10-16 14:00:00,654,103228,102763
"3293",15711,2016-10-16 15:00:00,654,745,446,299,81,218,2016-10-16 15:00:00,654,375,1140,458,1598,1973,2016-10-16 15:00:00,654,108414,107913
"3294",15712,2016-10-16 16:00:00,654,731,458,273,53,220,2016-10-16 16:00:00,654,391,1246,540,1786,2177,2016-10-16 16:00:00,654,109509,108973
"3295",15713,2016-10-16 17:00:00,654,864,542,322,101,221,2016-10-16 17:00:00,654,442,1306,478,1784,2226,2016-10-16 17:00:00,654,116771,116296
"3296",15714,2016-10-16 18:00:00,654,998,627,371,129,242,2016-10-16 18:00:00,654,419,1244,492,1736,2155,2016-10-16 18:00:00,654,107677,107159
"3297",15715,2016-10-16 19:00:00,654,863,541,322,90,232,2016-10-16 19:00:00,654,506,1214,517,1731,2237,2016-10-16 19:00:00,654,104833,104309
"3298",15716,2016-10-16 20:00:00,654,869,529,340,123,217,2016-10-16 20:00:00,654,482,1297,527,1824,2306,2016-10-16 20:00:00,654,99217,98737
"3299",15717,2016-10-16 21:00:00,654,906,535,371,108,263,2016-10-16 21:00:00,654,408,1173,463,1636,2044,2016-10-16 21:00:00,654,95314,94830
"3300",15718,2016-10-16 22:00:00,654,917,506,411,143,268,2016-10-16 22:00:00,654,412,1318,485,1803,2215,2016-10-16 22:00:00,654,91567,91101
"3301",15719,2016-10-16 23:00:00,654,823,479,344,116,228,2016-10-16 23:00:00,654,324,1165,433,1598,1922,2016-10-16 23:00:00,654,92431,92014
"3302",15720,2016-10-17 00:00:00,655,924,508,416,109,307,2016-10-17 00:00:00,655,299,1098,403,1501,1800,2016-10-17 00:00:00,655,101450,101034
"3303",15721,2016-10-17 01:00:00,655,924,545,379,93,286,2016-10-17 01:00:00,655,270,866,321,1187,1457,2016-10-17 01:00:00,655,108466,108016
"3304",15722,2016-10-17 02:00:00,655,782,436,346,73,273,2016-10-17 02:00:00,655,199,532,209,741,940,2016-10-17 02:00:00,655,100479,100064
"3305",15723,2016-10-17 03:00:00,655,639,379,260,61,199,2016-10-17 03:00:00,655,144,347,124,471,615,2016-10-17 03:00:00,655,93827,93435
"3306",15724,2016-10-17 04:00:00,655,487,285,202,64,138,2016-10-17 04:00:00,655,104,212,87,299,403,2016-10-17 04:00:00,655,90189,89832
"3307",15725,2016-10-17 05:00:00,655,465,278,187,63,124,2016-10-17 05:00:00,655,63,133,56,189,252,2016-10-17 05:00:00,655,90089,89739
"3308",15726,2016-10-17 06:00:00,655,325,209,116,25,91,2016-10-17 06:00:00,655,60,78,33,111,171,2016-10-17 06:00:00,655,98022,97575
"3309",15727,2016-10-17 07:00:00,655,265,189,76,27,49,2016-10-17 07:00:00,655,45,40,15,55,100,2016-10-17 07:00:00,655,101272,100796
"3310",15728,2016-10-17 08:00:00,655,258,213,45,17,28,2016-10-17 08:00:00,655,56,28,14,42,98,2016-10-17 08:00:00,655,101585,101138
"3311",15729,2016-10-17 09:00:00,655,234,184,50,17,33,2016-10-17 09:00:00,655,42,21,11,32,74,2016-10-17 09:00:00,655,104486,104025
"3312",15730,2016-10-17 10:00:00,655,288,228,60,25,35,2016-10-17 10:00:00,655,55,53,30,83,138,2016-10-17 10:00:00,655,121693,121211
"3313",15731,2016-10-17 11:00:00,655,354,284,70,29,41,2016-10-17 11:00:00,655,123,134,63,197,320,2016-10-17 11:00:00,655,194811,194326
"3314",15732,2016-10-17 12:00:00,655,512,384,128,49,79,2016-10-17 12:00:00,655,248,316,163,479,727,2016-10-17 12:00:00,655,304554,303891
"3315",15733,2016-10-17 13:00:00,655,646,498,148,62,86,2016-10-17 13:00:00,655,427,582,330,912,1339,2016-10-17 13:00:00,655,334004,333111
"3316",15734,2016-10-17 14:00:00,655,737,582,155,59,96,2016-10-17 14:00:00,655,503,717,355,1072,1575,2016-10-17 14:00:00,655,309263,308266
"3317",15735,2016-10-17 15:00:00,655,861,644,217,73,144,2016-10-17 15:00:00,655,656,942,467,1409,2065,2016-10-17 15:00:00,655,292220,291323
"3318",15736,2016-10-17 16:00:00,655,880,650,230,96,134,2016-10-17 16:00:00,655,697,907,435,1342,2039,2016-10-17 16:00:00,655,253360,252457
"3319",15737,2016-10-17 17:00:00,655,898,653,245,103,142,2016-10-17 17:00:00,655,801,985,457,1442,2243,2016-10-17 17:00:00,655,240028,239150
"3320",15738,2016-10-17 18:00:00,655,958,690,268,94,174,2016-10-17 18:00:00,655,787,1085,531,1616,2403,2016-10-17 18:00:00,655,233475,232587
"3321",15739,2016-10-17 19:00:00,655,1023,714,309,107,202,2016-10-17 19:00:00,655,806,1215,528,1743,2549,2016-10-17 19:00:00,655,216218,215329
"3322",15740,2016-10-17 20:00:00,655,992,664,328,99,229,2016-10-17 20:00:00,655,781,1481,597,2078,2859,2016-10-17 20:00:00,655,194696,193948
"3323",15741,2016-10-17 21:00:00,655,996,645,351,116,235,2016-10-17 21:00:00,655,695,1535,660,2195,2890,2016-10-17 21:00:00,655,159980,159357
"3324",15742,2016-10-17 22:00:00,655,996,624,372,128,244,2016-10-17 22:00:00,655,622,1547,642,2189,2811,2016-10-17 22:00:00,655,128933,128381
"3325",15743,2016-10-17 23:00:00,655,968,622,346,103,243,2016-10-17 23:00:00,655,563,1604,648,2252,2815,2016-10-17 23:00:00,655,116223,115718
"3326",15744,2016-10-18 00:00:00,656,965,581,384,87,297,2016-10-18 00:00:00,656,508,1499,555,2054,2562,2016-10-18 00:00:00,656,110591,110086
"3327",15745,2016-10-18 01:00:00,656,1013,580,433,147,286,2016-10-18 01:00:00,656,381,1252,464,1716,2097,2016-10-18 01:00:00,656,109522,108990
"3328",15746,2016-10-18 02:00:00,656,829,468,361,123,238,2016-10-18 02:00:00,656,325,895,312,1207,1532,2016-10-18 02:00:00,656,102942,102481
"3329",15747,2016-10-18 03:00:00,656,675,392,283,92,191,2016-10-18 03:00:00,656,234,569,219,788,1022,2016-10-18 03:00:00,656,94340,93937
"3330",15748,2016-10-18 04:00:00,656,527,324,203,57,146,2016-10-18 04:00:00,656,144,437,173,610,754,2016-10-18 04:00:00,656,86174,85811
"3331",15749,2016-10-18 05:00:00,656,462,259,203,61,142,2016-10-18 05:00:00,656,129,224,92,316,445,2016-10-18 05:00:00,656,85305,84969
"3332",15750,2016-10-18 06:00:00,656,405,246,159,51,108,2016-10-18 06:00:00,656,78,106,47,153,231,2016-10-18 06:00:00,656,92829,92422
"3333",15751,2016-10-18 07:00:00,656,305,193,112,54,58,2016-10-18 07:00:00,656,40,52,22,74,114,2016-10-18 07:00:00,656,96366,95880
"3334",15752,2016-10-18 08:00:00,656,233,179,54,16,38,2016-10-18 08:00:00,656,41,37,14,51,92,2016-10-18 08:00:00,656,98859,98359
"3335",15753,2016-10-18 09:00:00,656,273,196,77,39,38,2016-10-18 09:00:00,656,40,32,18,50,90,2016-10-18 09:00:00,656,100112,99654
"3336",15754,2016-10-18 10:00:00,656,264,209,55,25,30,2016-10-18 10:00:00,656,54,72,34,106,160,2016-10-18 10:00:00,656,106607,106157
"3337",15755,2016-10-18 11:00:00,656,352,269,83,42,41,2016-10-18 11:00:00,656,96,147,70,217,313,2016-10-18 11:00:00,656,140824,140302
"3338",15756,2016-10-18 12:00:00,656,460,345,115,46,69,2016-10-18 12:00:00,656,237,340,184,524,761,2016-10-18 12:00:00,656,201131,200514
"3339",15757,2016-10-18 13:00:00,656,541,409,132,60,72,2016-10-18 13:00:00,656,410,522,279,801,1211,2016-10-18 13:00:00,656,239517,238688
"3340",15758,2016-10-18 14:00:00,656,663,517,146,69,77,2016-10-18 14:00:00,656,582,668,334,1002,1584,2016-10-18 14:00:00,656,240486,239625
"3341",15759,2016-10-18 15:00:00,656,824,601,223,72,151,2016-10-18 15:00:00,656,708,804,390,1194,1902,2016-10-18 15:00:00,656,236302,235365
"3342",15760,2016-10-18 16:00:00,656,851,624,227,77,150,2016-10-18 16:00:00,656,726,827,391,1218,1944,2016-10-18 16:00:00,656,214201,213304
"3343",15761,2016-10-18 17:00:00,656,879,622,257,91,166,2016-10-18 17:00:00,656,692,976,437,1413,2105,2016-10-18 17:00:00,656,209304,208427
"3344",15762,2016-10-18 18:00:00,656,902,613,289,99,190,2016-10-18 18:00:00,656,747,1067,477,1544,2291,2016-10-18 18:00:00,656,208274,207356
"3345",15763,2016-10-18 19:00:00,656,914,652,262,67,195,2016-10-18 19:00:00,656,710,1230,560,1790,2500,2016-10-18 19:00:00,656,194777,193940
"3346",15764,2016-10-18 20:00:00,656,861,590,271,90,181,2016-10-18 20:00:00,656,814,1376,562,1938,2752,2016-10-18 20:00:00,656,176670,175886
"3347",15765,2016-10-18 21:00:00,656,969,611,358,110,248,2016-10-18 21:00:00,656,676,1549,664,2213,2889,2016-10-18 21:00:00,656,145704,145073
"3348",15766,2016-10-18 22:00:00,656,953,579,374,124,250,2016-10-18 22:00:00,656,595,1569,655,2224,2819,2016-10-18 22:00:00,656,120149,119610
"3349",15767,2016-10-18 23:00:00,656,927,552,375,128,247,2016-10-18 23:00:00,656,590,1503,588,2091,2681,2016-10-18 23:00:00,656,110263,109829
"3350",15768,2016-10-19 00:00:00,657,925,533,392,120,272,2016-10-19 00:00:00,657,489,1317,482,1799,2288,2016-10-19 00:00:00,657,106201,105764
"3351",15769,2016-10-19 01:00:00,657,849,511,338,89,249,2016-10-19 01:00:00,657,363,1006,399,1405,1768,2016-10-19 01:00:00,657,104720,104260
"3352",15770,2016-10-19 02:00:00,657,731,421,310,99,211,2016-10-19 02:00:00,657,318,773,283,1056,1374,2016-10-19 02:00:00,657,97956,97480
"3353",15771,2016-10-19 03:00:00,657,606,391,215,67,148,2016-10-19 03:00:00,657,206,504,197,701,907,2016-10-19 03:00:00,657,91510,91125
"3354",15772,2016-10-19 04:00:00,657,526,332,194,76,118,2016-10-19 04:00:00,657,140,318,125,443,583,2016-10-19 04:00:00,657,86869,86455
"3355",15773,2016-10-19 05:00:00,657,421,279,142,43,99,2016-10-19 05:00:00,657,85,136,58,194,279,2016-10-19 05:00:00,657,84150,83798
"3356",15774,2016-10-19 06:00:00,657,333,220,113,32,81,2016-10-19 06:00:00,657,53,86,44,130,183,2016-10-19 06:00:00,657,91556,91136
"3357",15775,2016-10-19 07:00:00,657,307,222,85,30,55,2016-10-19 07:00:00,657,52,56,23,79,131,2016-10-19 07:00:00,657,95933,95406
"3358",15776,2016-10-19 08:00:00,657,263,208,55,15,40,2016-10-19 08:00:00,657,66,39,19,58,124,2016-10-19 08:00:00,657,96934,96451
"3359",15777,2016-10-19 09:00:00,657,234,178,56,18,38,2016-10-19 09:00:00,657,54,44,19,63,117,2016-10-19 09:00:00,657,98530,98046
"3360",15778,2016-10-19 10:00:00,657,328,276,52,17,35,2016-10-19 10:00:00,657,57,58,35,93,150,2016-10-19 10:00:00,657,101570,101113
"3361",15779,2016-10-19 11:00:00,657,344,259,85,34,51,2016-10-19 11:00:00,657,108,105,56,161,269,2016-10-19 11:00:00,657,125419,124914
"3362",15780,2016-10-19 12:00:00,657,422,347,75,29,46,2016-10-19 12:00:00,657,234,325,185,510,744,2016-10-19 12:00:00,657,169262,168595
"3363",15781,2016-10-19 13:00:00,657,571,439,132,45,87,2016-10-19 13:00:00,657,454,483,257,740,1194,2016-10-19 13:00:00,657,206739,205887
"3364",15782,2016-10-19 14:00:00,657,656,520,136,51,85,2016-10-19 14:00:00,657,531,517,245,762,1293,2016-10-19 14:00:00,657,217950,217032
"3365",15783,2016-10-19 15:00:00,657,760,605,155,71,84,2016-10-19 15:00:00,657,656,670,338,1008,1664,2016-10-19 15:00:00,657,217188,216286
"3366",15784,2016-10-19 16:00:00,657,813,636,177,64,113,2016-10-19 16:00:00,657,691,765,346,1111,1802,2016-10-19 16:00:00,657,201357,200486
"3367",15785,2016-10-19 17:00:00,657,768,583,185,71,114,2016-10-19 17:00:00,657,691,804,347,1151,1842,2016-10-19 17:00:00,657,196634,195806
"3368",15786,2016-10-19 18:00:00,657,884,674,210,69,141,2016-10-19 18:00:00,657,772,816,367,1183,1955,2016-10-19 18:00:00,657,195373,194549
"3369",15787,2016-10-19 19:00:00,657,900,650,250,94,156,2016-10-19 19:00:00,657,759,1101,508,1609,2368,2016-10-19 19:00:00,657,183665,182814
"3370",15788,2016-10-19 20:00:00,657,849,605,244,90,154,2016-10-19 20:00:00,657,736,1214,522,1736,2472,2016-10-19 20:00:00,657,166237,165509
"3371",15789,2016-10-19 21:00:00,657,845,546,299,110,189,2016-10-19 21:00:00,657,622,1252,525,1777,2399,2016-10-19 21:00:00,657,140508,139935
"3372",15790,2016-10-19 22:00:00,657,877,563,314,96,218,2016-10-19 22:00:00,657,580,1333,529,1862,2442,2016-10-19 22:00:00,657,118006,117481
"3373",15791,2016-10-19 23:00:00,657,875,553,322,102,220,2016-10-19 23:00:00,657,541,1294,512,1806,2347,2016-10-19 23:00:00,657,107893,107438
"3374",15792,2016-10-20 00:00:00,658,838,499,339,125,214,2016-10-20 00:00:00,658,412,1205,452,1657,2069,2016-10-20 00:00:00,658,105149,104712
"3375",15793,2016-10-20 01:00:00,658,751,459,292,91,201,2016-10-20 01:00:00,658,333,946,377,1323,1656,2016-10-20 01:00:00,658,96945,96527
"3376",15794,2016-10-20 02:00:00,658,643,398,245,88,157,2016-10-20 02:00:00,658,244,665,251,916,1160,2016-10-20 02:00:00,658,92410,92035
"3377",15795,2016-10-20 03:00:00,658,580,378,202,74,128,2016-10-20 03:00:00,658,212,513,203,716,928,2016-10-20 03:00:00,658,91852,91495
"3378",15796,2016-10-20 04:00:00,658,530,331,199,62,137,2016-10-20 04:00:00,658,142,346,126,472,614,2016-10-20 04:00:00,658,87253,86908
"3379",15797,2016-10-20 05:00:00,658,431,251,180,49,131,2016-10-20 05:00:00,658,92,200,79,279,371,2016-10-20 05:00:00,658,86623,86291
"3380",15798,2016-10-20 06:00:00,658,294,193,101,26,75,2016-10-20 06:00:00,658,56,103,41,144,200,2016-10-20 06:00:00,658,93854,93441
"3381",15799,2016-10-20 07:00:00,658,295,202,93,27,66,2016-10-20 07:00:00,658,44,81,29,110,154,2016-10-20 07:00:00,658,97801,97348
"3382",15800,2016-10-20 08:00:00,658,225,180,45,15,30,2016-10-20 08:00:00,658,41,38,17,55,96,2016-10-20 08:00:00,658,98414,97944
"3383",15801,2016-10-20 09:00:00,658,211,170,41,16,25,2016-10-20 09:00:00,658,37,31,16,47,84,2016-10-20 09:00:00,658,99399,98965
"3384",15802,2016-10-20 10:00:00,658,324,260,64,22,42,2016-10-20 10:00:00,658,60,49,27,76,136,2016-10-20 10:00:00,658,107126,106653
"3385",15803,2016-10-20 11:00:00,658,327,266,61,19,42,2016-10-20 11:00:00,658,91,124,58,182,273,2016-10-20 11:00:00,658,145876,145406
"3386",15804,2016-10-20 12:00:00,658,356,277,79,24,55,2016-10-20 12:00:00,658,201,253,133,386,587,2016-10-20 12:00:00,658,216700,216095
"3387",15805,2016-10-20 13:00:00,658,529,407,122,45,77,2016-10-20 13:00:00,658,421,400,207,607,1028,2016-10-20 13:00:00,658,257720,256921
"3388",15806,2016-10-20 14:00:00,658,644,508,136,52,84,2016-10-20 14:00:00,658,485,544,267,811,1296,2016-10-20 14:00:00,658,260894,259987
"3389",15807,2016-10-20 15:00:00,658,712,569,143,40,103,2016-10-20 15:00:00,658,626,766,346,1112,1738,2016-10-20 15:00:00,658,256368,255459
"3390",15808,2016-10-20 16:00:00,658,795,579,216,59,157,2016-10-20 16:00:00,658,592,922,379,1301,1893,2016-10-20 16:00:00,658,232765,231919
"3391",15809,2016-10-20 17:00:00,658,801,590,211,55,156,2016-10-20 17:00:00,658,666,809,369,1178,1844,2016-10-20 17:00:00,658,225657,224816
"3392",15810,2016-10-20 18:00:00,658,816,607,209,72,137,2016-10-20 18:00:00,658,697,929,437,1366,2063,2016-10-20 18:00:00,658,221987,221126
"3393",15811,2016-10-20 19:00:00,658,873,619,254,87,167,2016-10-20 19:00:00,658,718,1081,479,1560,2278,2016-10-20 19:00:00,658,205674,204888
"3394",15812,2016-10-20 20:00:00,658,884,608,276,107,169,2016-10-20 20:00:00,658,776,1350,523,1873,2649,2016-10-20 20:00:00,658,187849,187150
"3395",15813,2016-10-20 21:00:00,658,853,522,331,140,191,2016-10-20 21:00:00,658,647,1422,582,2004,2651,2016-10-20 21:00:00,658,154415,153820
"3396",15814,2016-10-20 22:00:00,658,646,416,230,62,168,2016-10-20 22:00:00,658,602,1406,553,1959,2561,2016-10-20 22:00:00,658,124982,124469
"3397",15815,2016-10-20 23:00:00,658,541,337,204,53,151,2016-10-20 23:00:00,658,488,1415,595,2010,2498,2016-10-20 23:00:00,658,111086,110616
"3398",15816,2016-10-21 00:00:00,659,904,509,395,160,235,2016-10-21 00:00:00,659,437,1333,505,1838,2275,2016-10-21 00:00:00,659,104816,104388
"3399",15817,2016-10-21 01:00:00,659,867,511,356,117,239,2016-10-21 01:00:00,659,365,1057,393,1450,1815,2016-10-21 01:00:00,659,101175,100746
"3400",15818,2016-10-21 02:00:00,659,687,393,294,94,200,2016-10-21 02:00:00,659,259,805,298,1103,1362,2016-10-21 02:00:00,659,95141,94741
"3401",15819,2016-10-21 03:00:00,659,574,359,215,74,141,2016-10-21 03:00:00,659,224,565,192,757,981,2016-10-21 03:00:00,659,87013,86628
"3402",15820,2016-10-21 04:00:00,659,520,300,220,91,129,2016-10-21 04:00:00,659,130,379,145,524,654,2016-10-21 04:00:00,659,81818,81487
"3403",15821,2016-10-21 05:00:00,659,397,233,164,52,112,2016-10-21 05:00:00,659,86,211,85,296,382,2016-10-21 05:00:00,659,78929,78608
"3404",15822,2016-10-21 06:00:00,659,334,207,127,37,90,2016-10-21 06:00:00,659,54,134,54,188,242,2016-10-21 06:00:00,659,85423,85082
"3405",15823,2016-10-21 07:00:00,659,257,177,80,37,43,2016-10-21 07:00:00,659,58,70,31,101,159,2016-10-21 07:00:00,659,88119,87683
"3406",15824,2016-10-21 08:00:00,659,250,182,68,26,42,2016-10-21 08:00:00,659,59,34,11,45,104,2016-10-21 08:00:00,659,88117,87714
"3407",15825,2016-10-21 09:00:00,659,255,192,63,23,40,2016-10-21 09:00:00,659,51,50,21,71,122,2016-10-21 09:00:00,659,89725,89339
"3408",15826,2016-10-21 10:00:00,659,268,204,64,19,45,2016-10-21 10:00:00,659,53,68,37,105,158,2016-10-21 10:00:00,659,98296,97877
"3409",15827,2016-10-21 11:00:00,659,310,234,76,23,53,2016-10-21 11:00:00,659,107,122,61,183,290,2016-10-21 11:00:00,659,137166,136737
"3410",15828,2016-10-21 12:00:00,659,423,327,96,35,61,2016-10-21 12:00:00,659,293,324,151,475,768,2016-10-21 12:00:00,659,201794,201220
"3411",15829,2016-10-21 13:00:00,659,608,458,150,60,90,2016-10-21 13:00:00,659,398,542,257,799,1197,2016-10-21 13:00:00,659,230750,230031
"3412",15830,2016-10-21 14:00:00,659,704,522,182,62,120,2016-10-21 14:00:00,659,496,741,350,1091,1587,2016-10-21 14:00:00,659,230337,229492
"3413",15831,2016-10-21 15:00:00,659,730,537,193,62,131,2016-10-21 15:00:00,659,610,812,360,1172,1782,2016-10-21 15:00:00,659,223790,222982
"3414",15832,2016-10-21 16:00:00,659,822,587,235,85,150,2016-10-21 16:00:00,659,723,963,437,1400,2123,2016-10-21 16:00:00,659,203055,202277
"3415",15833,2016-10-21 17:00:00,659,800,536,264,89,175,2016-10-21 17:00:00,659,764,1105,477,1582,2346,2016-10-21 17:00:00,659,196094,195283
"3416",15834,2016-10-21 18:00:00,659,756,505,251,58,193,2016-10-21 18:00:00,659,797,1425,598,2023,2820,2016-10-21 18:00:00,659,32662,32633
"3417",15835,2016-10-21 19:00:00,659,719,438,281,75,206,2016-10-21 19:00:00,659,846,1573,610,2183,3029,2016-10-21 19:00:00,659,6232,6221
"3418",15836,2016-10-21 20:00:00,659,820,533,287,61,226,2016-10-21 20:00:00,659,773,1565,631,2196,2969,2016-10-21 20:00:00,659,5407,5401
"3419",15837,2016-10-21 21:00:00,659,838,493,345,111,234,2016-10-21 21:00:00,659,553,1663,683,2346,2899,2016-10-21 21:00:00,659,4769,4755
"3420",15838,2016-10-21 22:00:00,659,883,503,380,107,273,2016-10-21 22:00:00,659,538,1671,671,2342,2880,2016-10-21 22:00:00,659,4690,4682
"3421",15839,2016-10-21 23:00:00,659,821,459,362,118,244,2016-10-21 23:00:00,659,421,1558,562,2120,2541,2016-10-21 23:00:00,659,31633,31626
"3422",15840,2016-10-22 00:00:00,660,913,501,412,120,292,2016-10-22 00:00:00,660,338,1487,539,2026,2364,2016-10-22 00:00:00,660,84589,84200
"3423",15841,2016-10-22 01:00:00,660,876,455,421,130,291,2016-10-22 01:00:00,660,303,1429,510,1939,2242,2016-10-22 01:00:00,660,81488,81103
"3424",15842,2016-10-22 02:00:00,660,698,378,320,105,215,2016-10-22 02:00:00,660,230,1125,429,1554,1784,2016-10-22 02:00:00,660,83811,83435
"3425",15843,2016-10-22 03:00:00,660,635,350,285,64,221,2016-10-22 03:00:00,660,185,847,300,1147,1332,2016-10-22 03:00:00,660,75058,74726
"3426",15844,2016-10-22 04:00:00,660,537,288,249,70,179,2016-10-22 04:00:00,660,151,593,221,814,965,2016-10-22 04:00:00,660,69510,69208
"3427",15845,2016-10-22 05:00:00,660,461,238,223,80,142,2016-10-22 05:00:00,660,70,292,102,394,464,2016-10-22 05:00:00,660,64894,64608
"3428",15846,2016-10-22 06:00:00,660,315,185,130,41,89,2016-10-22 06:00:00,660,67,150,46,196,263,2016-10-22 06:00:00,660,62049,61759
"3429",15847,2016-10-22 07:00:00,660,267,194,73,27,46,2016-10-22 07:00:00,660,62,88,36,124,186,2016-10-22 07:00:00,660,61821,61539
"3430",15848,2016-10-22 08:00:00,660,253,196,57,15,42,2016-10-22 08:00:00,660,49,36,15,51,100,2016-10-22 08:00:00,660,60940,60667
"3431",15849,2016-10-22 09:00:00,660,258,178,80,26,54,2016-10-22 09:00:00,660,51,45,22,67,118,2016-10-22 09:00:00,660,62505,62227
"3432",15850,2016-10-22 10:00:00,660,232,172,60,19,41,2016-10-22 10:00:00,660,26,42,17,59,85,2016-10-22 10:00:00,660,66895,66590
"3433",15851,2016-10-22 11:00:00,660,290,207,83,25,58,2016-10-22 11:00:00,660,91,118,53,171,262,2016-10-22 11:00:00,660,75565,75251
"3434",15852,2016-10-22 12:00:00,660,380,248,132,43,89,2016-10-22 12:00:00,660,143,320,138,458,601,2016-10-22 12:00:00,660,88218,87858
"3435",15853,2016-10-22 13:00:00,660,507,328,179,39,140,2016-10-22 13:00:00,660,251,647,280,927,1178,2016-10-22 13:00:00,660,101414,100977
"3436",15854,2016-10-22 14:00:00,660,675,434,241,69,172,2016-10-22 14:00:00,660,341,977,413,1390,1731,2016-10-22 14:00:00,660,109415,108933
"3437",15855,2016-10-22 15:00:00,660,784,478,306,87,219,2016-10-22 15:00:00,660,428,1071,455,1526,1954,2016-10-22 15:00:00,660,112243,111726
"3438",15856,2016-10-22 16:00:00,660,720,413,307,82,225,2016-10-22 16:00:00,660,465,1357,514,1871,2336,2016-10-22 16:00:00,660,110449,109929
"3439",15857,2016-10-22 17:00:00,660,651,375,276,66,210,2016-10-22 17:00:00,660,539,1432,613,2045,2584,2016-10-22 17:00:00,660,106850,106323
"3440",15858,2016-10-22 18:00:00,660,645,339,306,84,222,2016-10-22 18:00:00,660,511,1453,554,2007,2518,2016-10-22 18:00:00,660,103314,102771
"3441",15859,2016-10-22 19:00:00,660,839,449,390,169,221,2016-10-22 19:00:00,660,494,1416,542,1958,2452,2016-10-22 19:00:00,660,98862,98369
"3442",15860,2016-10-22 20:00:00,660,807,444,363,112,251,2016-10-22 20:00:00,660,480,1509,600,2109,2589,2016-10-22 20:00:00,660,92874,92402
"3443",15861,2016-10-22 21:00:00,660,860,458,402,115,287,2016-10-22 21:00:00,660,421,1504,587,2091,2512,2016-10-22 21:00:00,660,89198,88792
"3444",15862,2016-10-22 22:00:00,660,930,494,436,137,299,2016-10-22 22:00:00,660,403,1308,499,1807,2210,2016-10-22 22:00:00,660,78841,78476
"3445",15863,2016-10-22 23:00:00,660,772,434,338,78,260,2016-10-22 23:00:00,660,370,1257,476,1733,2103,2016-10-22 23:00:00,660,74724,74361
"3446",15864,2016-10-23 00:00:00,661,768,385,383,91,292,2016-10-23 00:00:00,661,329,1109,413,1522,1851,2016-10-23 00:00:00,661,72689,72330
"3447",15865,2016-10-23 01:00:00,661,851,454,397,129,268,2016-10-23 01:00:00,661,295,1005,402,1407,1702,2016-10-23 01:00:00,661,72412,72047
"3448",15866,2016-10-23 02:00:00,661,735,415,320,84,235,2016-10-23 02:00:00,661,182,756,297,1053,1235,2016-10-23 02:00:00,661,71483,71181
"3449",15867,2016-10-23 03:00:00,661,656,339,317,71,246,2016-10-23 03:00:00,661,174,612,247,859,1033,2016-10-23 03:00:00,661,70459,70171
"3450",15868,2016-10-23 04:00:00,661,530,287,243,71,172,2016-10-23 04:00:00,661,135,374,138,512,647,2016-10-23 04:00:00,661,69466,69135
"3451",15869,2016-10-23 05:00:00,661,440,246,194,59,135,2016-10-23 05:00:00,661,92,279,87,366,458,2016-10-23 05:00:00,661,64438,64169
"3452",15870,2016-10-23 06:00:00,661,348,205,143,65,78,2016-10-23 06:00:00,661,65,144,45,189,254,2016-10-23 06:00:00,661,61452,61191
"3453",15871,2016-10-23 07:00:00,661,253,155,98,33,65,2016-10-23 07:00:00,661,53,54,26,80,133,2016-10-23 07:00:00,661,60711,60436
"3454",15872,2016-10-23 08:00:00,661,246,162,84,29,55,2016-10-23 08:00:00,661,30,51,18,69,99,2016-10-23 08:00:00,661,63099,62829
"3455",15873,2016-10-23 09:00:00,661,224,161,63,20,43,2016-10-23 09:00:00,661,42,37,12,49,91,2016-10-23 09:00:00,661,64831,64547
"3456",15874,2016-10-23 10:00:00,661,236,175,61,18,43,2016-10-23 10:00:00,661,47,41,21,62,109,2016-10-23 10:00:00,661,63557,63256
"3457",15875,2016-10-23 11:00:00,661,236,168,68,17,51,2016-10-23 11:00:00,661,77,68,27,95,172,2016-10-23 11:00:00,661,70110,69801
"3458",15876,2016-10-23 12:00:00,661,349,229,120,41,79,2016-10-23 12:00:00,661,118,213,83,296,414,2016-10-23 12:00:00,661,79393,79082
"3459",15877,2016-10-23 13:00:00,661,467,322,145,39,106,2016-10-23 13:00:00,661,158,541,223,764,922,2016-10-23 13:00:00,661,88869,88454
"3460",15878,2016-10-23 14:00:00,661,671,403,268,97,171,2016-10-23 14:00:00,661,287,762,320,1082,1369,2016-10-23 14:00:00,661,97258,96838
"3461",15879,2016-10-23 15:00:00,661,764,469,295,92,203,2016-10-23 15:00:00,661,348,935,414,1349,1697,2016-10-23 15:00:00,661,107070,106617
"3462",15880,2016-10-23 16:00:00,661,757,477,280,103,177,2016-10-23 16:00:00,661,363,1057,427,1484,1847,2016-10-23 16:00:00,661,104438,103972
"3463",15881,2016-10-23 17:00:00,661,823,531,292,84,208,2016-10-23 17:00:00,661,389,1154,419,1573,1962,2016-10-23 17:00:00,661,103323,102841
"3464",15882,2016-10-23 18:00:00,661,910,542,368,118,250,2016-10-23 18:00:00,661,424,1200,499,1699,2123,2016-10-23 18:00:00,661,101961,101454
"3465",15883,2016-10-23 19:00:00,661,859,495,364,137,227,2016-10-23 19:00:00,661,407,1206,463,1669,2076,2016-10-23 19:00:00,661,99972,99516
"3466",15884,2016-10-23 20:00:00,661,849,517,332,94,238,2016-10-23 20:00:00,661,464,1257,507,1764,2228,2016-10-23 20:00:00,661,94690,94217
"3467",15885,2016-10-23 21:00:00,661,797,458,339,111,228,2016-10-23 21:00:00,661,405,1206,476,1682,2087,2016-10-23 21:00:00,661,89609,89177
"3468",15886,2016-10-23 22:00:00,661,774,458,316,98,218,2016-10-23 22:00:00,661,415,1145,438,1583,1998,2016-10-23 22:00:00,661,87129,86744
"3469",15887,2016-10-23 23:00:00,661,778,417,361,129,232,2016-10-23 23:00:00,661,334,1049,372,1421,1755,2016-10-23 23:00:00,661,88202,87814
"3470",15888,2016-10-24 00:00:00,662,819,476,343,107,236,2016-10-24 00:00:00,662,346,1021,402,1423,1769,2016-10-24 00:00:00,662,97488,97100
"3471",15889,2016-10-24 01:00:00,662,839,477,362,102,260,2016-10-24 01:00:00,662,276,688,270,958,1234,2016-10-24 01:00:00,662,101073,100652
"3472",15890,2016-10-24 02:00:00,662,697,410,287,73,214,2016-10-24 02:00:00,662,209,487,186,673,882,2016-10-24 02:00:00,662,95007,94612
"3473",15891,2016-10-24 03:00:00,662,599,350,249,79,170,2016-10-24 03:00:00,662,146,296,116,412,558,2016-10-24 03:00:00,662,89881,89552
"3474",15892,2016-10-24 04:00:00,662,487,297,190,57,133,2016-10-24 04:00:00,662,114,176,80,256,370,2016-10-24 04:00:00,662,86794,86459
"3475",15893,2016-10-24 05:00:00,662,360,241,119,27,92,2016-10-24 05:00:00,662,85,136,48,184,269,2016-10-24 05:00:00,662,88334,87983
"3476",15894,2016-10-24 06:00:00,662,260,179,81,36,45,2016-10-24 06:00:00,662,60,78,37,115,175,2016-10-24 06:00:00,662,94696,94319
"3477",15895,2016-10-24 07:00:00,662,242,181,61,23,38,2016-10-24 07:00:00,662,37,30,9,39,76,2016-10-24 07:00:00,662,97113,96697
"3478",15896,2016-10-24 08:00:00,662,222,188,34,9,25,2016-10-24 08:00:00,662,37,38,20,58,95,2016-10-24 08:00:00,662,97516,97051
"3479",15897,2016-10-24 09:00:00,662,237,200,37,9,28,2016-10-24 09:00:00,662,26,29,15,44,70,2016-10-24 09:00:00,662,101916,101448
"3480",15898,2016-10-24 10:00:00,662,290,241,49,10,39,2016-10-24 10:00:00,662,46,69,30,99,145,2016-10-24 10:00:00,662,120984,120496
"3481",15899,2016-10-24 11:00:00,662,334,269,65,18,47,2016-10-24 11:00:00,662,81,99,59,158,239,2016-10-24 11:00:00,662,196316,195762
"3482",15900,2016-10-24 12:00:00,662,415,303,112,46,66,2016-10-24 12:00:00,662,227,265,147,412,639,2016-10-24 12:00:00,662,308487,307745
"3483",15901,2016-10-24 13:00:00,662,599,475,124,45,79,2016-10-24 13:00:00,662,465,592,302,894,1359,2016-10-24 13:00:00,662,336226,335267
"3484",15902,2016-10-24 14:00:00,662,719,560,159,58,101,2016-10-24 14:00:00,662,523,703,347,1050,1573,2016-10-24 14:00:00,662,310175,309191
"3485",15903,2016-10-24 15:00:00,662,830,647,183,75,108,2016-10-24 15:00:00,662,712,866,418,1284,1996,2016-10-24 15:00:00,662,291592,290570
"3486",15904,2016-10-24 16:00:00,662,779,583,196,78,118,2016-10-24 16:00:00,662,711,879,430,1309,2020,2016-10-24 16:00:00,662,250674,249724
"3487",15905,2016-10-24 17:00:00,662,866,647,219,75,144,2016-10-24 17:00:00,662,707,994,512,1506,2213,2016-10-24 17:00:00,662,236911,235958
"3488",15906,2016-10-24 18:00:00,662,868,635,233,75,158,2016-10-24 18:00:00,662,801,999,439,1438,2239,2016-10-24 18:00:00,662,229528,228587
"3489",15907,2016-10-24 19:00:00,662,855,590,265,102,163,2016-10-24 19:00:00,662,790,1202,528,1730,2520,2016-10-24 19:00:00,662,211520,210634
"3490",15908,2016-10-24 20:00:00,662,873,577,296,93,203,2016-10-24 20:00:00,662,744,1423,593,2016,2760,2016-10-24 20:00:00,662,190996,190132
"3491",15909,2016-10-24 21:00:00,662,910,590,320,107,213,2016-10-24 21:00:00,662,712,1514,638,2152,2864,2016-10-24 21:00:00,662,157400,156703
"3492",15910,2016-10-24 22:00:00,662,869,536,333,113,220,2016-10-24 22:00:00,662,563,1470,626,2096,2659,2016-10-24 22:00:00,662,128591,127971
"3493",15911,2016-10-24 23:00:00,662,862,524,338,120,218,2016-10-24 23:00:00,662,607,1502,572,2074,2681,2016-10-24 23:00:00,662,116136,115561
"3494",15912,2016-10-25 00:00:00,663,878,483,395,106,289,2016-10-25 00:00:00,663,509,1292,504,1796,2305,2016-10-25 00:00:00,663,110915,110382
"3495",15913,2016-10-25 01:00:00,663,895,535,360,109,251,2016-10-25 01:00:00,663,344,988,360,1348,1692,2016-10-25 01:00:00,663,109834,109266
"3496",15914,2016-10-25 02:00:00,663,695,419,276,99,177,2016-10-25 02:00:00,663,293,718,327,1045,1338,2016-10-25 02:00:00,663,101888,101306
"3497",15915,2016-10-25 03:00:00,663,542,319,223,65,158,2016-10-25 03:00:00,663,206,435,186,621,827,2016-10-25 03:00:00,663,91854,91356
"3498",15916,2016-10-25 04:00:00,663,528,339,189,55,134,2016-10-25 04:00:00,663,147,351,157,508,655,2016-10-25 04:00:00,663,85090,84602
"3499",15917,2016-10-25 05:00:00,663,477,273,204,51,153,2016-10-25 05:00:00,663,84,672,138,810,894,2016-10-25 05:00:00,663,85340,84829
"3500",15918,2016-10-25 06:00:00,663,454,214,240,62,178,2016-10-25 06:00:00,663,78,763,126,889,967,2016-10-25 06:00:00,663,92914,92368
"3501",15919,2016-10-25 07:00:00,663,405,218,187,44,143,2016-10-25 07:00:00,663,53,99,34,133,186,2016-10-25 07:00:00,663,94163,93573
"3502",15920,2016-10-25 08:00:00,663,254,199,55,15,40,2016-10-25 08:00:00,663,73,43,16,59,132,2016-10-25 08:00:00,663,95337,94728
"3503",15921,2016-10-25 09:00:00,663,260,192,68,16,52,2016-10-25 09:00:00,663,29,44,22,66,95,2016-10-25 09:00:00,663,95679,95133
"3504",15922,2016-10-25 10:00:00,663,307,234,73,20,53,2016-10-25 10:00:00,663,60,53,30,83,143,2016-10-25 10:00:00,663,100614,100176
"3505",15923,2016-10-25 11:00:00,663,296,235,61,14,47,2016-10-25 11:00:00,663,146,140,71,211,357,2016-10-25 11:00:00,663,133691,133163
"3506",15924,2016-10-25 12:00:00,663,405,305,100,26,74,2016-10-25 12:00:00,663,241,330,153,483,724,2016-10-25 12:00:00,663,192442,191802
"3507",15925,2016-10-25 13:00:00,663,630,497,133,51,82,2016-10-25 13:00:00,663,390,498,247,745,1135,2016-10-25 13:00:00,663,228876,228040
"3508",15926,2016-10-25 14:00:00,663,651,467,184,60,124,2016-10-25 14:00:00,663,540,662,318,980,1520,2016-10-25 14:00:00,663,234068,233211
"3509",15927,2016-10-25 15:00:00,663,800,578,222,70,152,2016-10-25 15:00:00,663,619,778,378,1156,1775,2016-10-25 15:00:00,663,230021,229107
"3510",15928,2016-10-25 16:00:00,663,833,582,251,78,173,2016-10-25 16:00:00,663,605,965,434,1399,2004,2016-10-25 16:00:00,663,209127,208282
"3511",15929,2016-10-25 17:00:00,663,893,637,256,84,172,2016-10-25 17:00:00,663,755,937,403,1340,2095,2016-10-25 17:00:00,663,206017,205216
"3512",15930,2016-10-25 18:00:00,663,921,618,303,107,196,2016-10-25 18:00:00,663,765,1098,497,1595,2360,2016-10-25 18:00:00,663,204056,203215
"3513",15931,2016-10-25 19:00:00,663,938,606,332,112,220,2016-10-25 19:00:00,663,736,1086,422,1508,2244,2016-10-25 19:00:00,663,189762,188954
"3514",15932,2016-10-25 20:00:00,663,925,588,337,104,233,2016-10-25 20:00:00,663,749,1356,555,1911,2660,2016-10-25 20:00:00,663,171525,170778
"3515",15933,2016-10-25 21:00:00,663,923,565,358,127,231,2016-10-25 21:00:00,663,651,1473,566,2039,2690,2016-10-25 21:00:00,663,142706,142161
"3516",15934,2016-10-25 22:00:00,663,941,560,381,111,270,2016-10-25 22:00:00,663,544,1505,535,2040,2584,2016-10-25 22:00:00,663,118652,118133
"3517",15935,2016-10-25 23:00:00,663,996,547,449,137,312,2016-10-25 23:00:00,663,472,1497,573,2070,2542,2016-10-25 23:00:00,663,106607,106161
"3518",15936,2016-10-26 00:00:00,664,881,528,353,92,261,2016-10-26 00:00:00,664,475,1140,446,1586,2061,2016-10-26 00:00:00,664,100988,100530
"3519",15937,2016-10-26 01:00:00,664,841,497,344,105,239,2016-10-26 01:00:00,664,330,925,342,1267,1597,2016-10-26 01:00:00,664,99145,98730
"3520",15938,2016-10-26 02:00:00,664,678,381,297,104,193,2016-10-26 02:00:00,664,237,688,250,938,1175,2016-10-26 02:00:00,664,94196,93822
"3521",15939,2016-10-26 03:00:00,664,652,404,248,73,175,2016-10-26 03:00:00,664,211,459,192,651,862,2016-10-26 03:00:00,664,87836,87482
"3522",15940,2016-10-26 04:00:00,664,502,318,184,51,133,2016-10-26 04:00:00,664,121,311,137,448,569,2016-10-26 04:00:00,664,82289,81945
"3523",15941,2016-10-26 05:00:00,664,343,212,131,45,86,2016-10-26 05:00:00,664,98,160,64,224,322,2016-10-26 05:00:00,664,79666,79333
"3524",15942,2016-10-26 06:00:00,664,303,204,99,32,67,2016-10-26 06:00:00,664,73,78,27,105,178,2016-10-26 06:00:00,664,86724,86318
"3525",15943,2016-10-26 07:00:00,664,252,182,70,20,50,2016-10-26 07:00:00,664,42,35,16,51,93,2016-10-26 07:00:00,664,91321,90885
"3526",15944,2016-10-26 08:00:00,664,235,174,61,29,32,2016-10-26 08:00:00,664,35,30,15,45,80,2016-10-26 08:00:00,664,92239,91817
"3527",15945,2016-10-26 09:00:00,664,257,187,70,27,43,2016-10-26 09:00:00,664,39,35,14,49,88,2016-10-26 09:00:00,664,92846,92387
"3528",15946,2016-10-26 10:00:00,664,291,239,52,12,40,2016-10-26 10:00:00,664,66,63,27,90,156,2016-10-26 10:00:00,664,96324,95876
"3529",15947,2016-10-26 11:00:00,664,324,266,58,21,37,2016-10-26 11:00:00,664,86,121,71,192,278,2016-10-26 11:00:00,664,119010,118523
"3530",15948,2016-10-26 12:00:00,664,485,383,102,25,77,2016-10-26 12:00:00,664,222,296,143,439,661,2016-10-26 12:00:00,664,162310,161733
"3531",15949,2016-10-26 13:00:00,664,585,457,128,44,84,2016-10-26 13:00:00,664,431,516,261,777,1208,2016-10-26 13:00:00,664,199847,199086
"3532",15950,2016-10-26 14:00:00,664,670,522,148,61,87,2016-10-26 14:00:00,664,537,585,295,880,1417,2016-10-26 14:00:00,664,211653,210763
"3533",15951,2016-10-26 15:00:00,664,785,584,201,70,131,2016-10-26 15:00:00,664,643,753,339,1092,1735,2016-10-26 15:00:00,664,210378,209517
"3534",15952,2016-10-26 16:00:00,664,797,594,203,73,130,2016-10-26 16:00:00,664,641,833,384,1217,1858,2016-10-26 16:00:00,664,196261,195458
"3535",15953,2016-10-26 17:00:00,664,808,599,209,64,145,2016-10-26 17:00:00,664,705,931,423,1354,2059,2016-10-26 17:00:00,664,197299,196477
"3536",15954,2016-10-26 18:00:00,664,895,648,247,80,167,2016-10-26 18:00:00,664,793,862,405,1267,2060,2016-10-26 18:00:00,664,192596,191732
"3537",15955,2016-10-26 19:00:00,664,822,559,263,95,168,2016-10-26 19:00:00,664,767,1124,496,1620,2387,2016-10-26 19:00:00,664,180490,179709
"3538",15956,2016-10-26 20:00:00,664,887,611,276,87,189,2016-10-26 20:00:00,664,762,1270,508,1778,2540,2016-10-26 20:00:00,664,165274,164584
"3539",15957,2016-10-26 21:00:00,664,913,589,324,90,234,2016-10-26 21:00:00,664,575,1420,573,1993,2568,2016-10-26 21:00:00,664,138148,137554
"3540",15958,2016-10-26 22:00:00,664,875,551,324,110,214,2016-10-26 22:00:00,664,549,1450,541,1991,2540,2016-10-26 22:00:00,664,115958,115440
"3541",15959,2016-10-26 23:00:00,664,826,506,320,114,206,2016-10-26 23:00:00,664,507,1282,532,1814,2321,2016-10-26 23:00:00,664,105125,104642
"3542",15960,2016-10-27 00:00:00,665,831,508,323,107,216,2016-10-27 00:00:00,665,473,1193,454,1647,2120,2016-10-27 00:00:00,665,102788,102350
"3543",15961,2016-10-27 01:00:00,665,815,525,290,81,209,2016-10-27 01:00:00,665,412,998,386,1384,1796,2016-10-27 01:00:00,665,103095,102647
"3544",15962,2016-10-27 02:00:00,665,680,413,267,83,184,2016-10-27 02:00:00,665,300,733,282,1015,1315,2016-10-27 02:00:00,665,96755,96314
"3545",15963,2016-10-27 03:00:00,665,565,374,191,60,131,2016-10-27 03:00:00,665,209,507,187,694,903,2016-10-27 03:00:00,665,90250,89850
"3546",15964,2016-10-27 04:00:00,665,472,293,179,54,125,2016-10-27 04:00:00,665,155,309,102,411,566,2016-10-27 04:00:00,665,85460,85173
"3547",15965,2016-10-27 05:00:00,665,400,231,169,53,116,2016-10-27 05:00:00,665,107,187,56,243,350,2016-10-27 05:00:00,665,84006,83674
"3548",15966,2016-10-27 06:00:00,665,291,196,95,30,65,2016-10-27 06:00:00,665,72,93,33,126,198,2016-10-27 06:00:00,665,91335,90922
"3549",15967,2016-10-27 07:00:00,665,273,210,63,30,33,2016-10-27 07:00:00,665,54,54,17,71,125,2016-10-27 07:00:00,665,94961,94519
"3550",15968,2016-10-27 08:00:00,665,218,182,36,15,21,2016-10-27 08:00:00,665,41,27,7,34,75,2016-10-27 08:00:00,665,94943,94474
"3551",15969,2016-10-27 09:00:00,665,225,155,70,26,44,2016-10-27 09:00:00,665,49,31,9,40,89,2016-10-27 09:00:00,665,96306,95870
"3552",15970,2016-10-27 10:00:00,665,271,226,45,15,30,2016-10-27 10:00:00,665,61,68,28,96,157,2016-10-27 10:00:00,665,104204,103765
"3553",15971,2016-10-27 11:00:00,665,304,254,50,15,35,2016-10-27 11:00:00,665,106,108,60,168,274,2016-10-27 11:00:00,665,144273,143805
"3554",15972,2016-10-27 12:00:00,665,368,304,64,16,48,2016-10-27 12:00:00,665,221,240,123,363,584,2016-10-27 12:00:00,665,216705,216116
"3555",15973,2016-10-27 13:00:00,665,527,411,116,47,69,2016-10-27 13:00:00,665,377,500,268,768,1145,2016-10-27 13:00:00,665,259090,258292
"3556",15974,2016-10-27 14:00:00,665,604,465,139,56,83,2016-10-27 14:00:00,665,540,549,273,822,1362,2016-10-27 14:00:00,665,261545,260682
"3557",15975,2016-10-27 15:00:00,665,792,617,175,78,97,2016-10-27 15:00:00,665,623,613,289,902,1525,2016-10-27 15:00:00,665,256801,255861
"3558",15976,2016-10-27 16:00:00,665,770,562,208,68,140,2016-10-27 16:00:00,665,673,727,322,1049,1722,2016-10-27 16:00:00,665,231797,230978
"3559",15977,2016-10-27 17:00:00,665,781,600,181,73,108,2016-10-27 17:00:00,665,698,836,380,1216,1914,2016-10-27 17:00:00,665,223560,222713
"3560",15978,2016-10-27 18:00:00,665,841,625,216,85,131,2016-10-27 18:00:00,665,736,820,362,1182,1918,2016-10-27 18:00:00,665,221618,220732
"3561",15979,2016-10-27 19:00:00,665,827,589,238,79,159,2016-10-27 19:00:00,665,711,959,421,1380,2091,2016-10-27 19:00:00,665,207931,207032
"3562",15980,2016-10-27 20:00:00,665,794,552,242,86,156,2016-10-27 20:00:00,665,722,1057,448,1505,2227,2016-10-27 20:00:00,665,190163,189460
"3563",15981,2016-10-27 21:00:00,665,888,604,284,86,198,2016-10-27 21:00:00,665,575,1234,492,1726,2301,2016-10-27 21:00:00,665,158582,157935
"3564",15982,2016-10-27 22:00:00,665,857,528,329,98,231,2016-10-27 22:00:00,665,528,1242,500,1742,2270,2016-10-27 22:00:00,665,130483,129941
"3565",15983,2016-10-27 23:00:00,665,788,507,281,87,194,2016-10-27 23:00:00,665,462,1096,455,1551,2013,2016-10-27 23:00:00,665,114851,114380
"3566",15984,2016-10-28 00:00:00,666,786,474,312,102,210,2016-10-28 00:00:00,666,382,1197,479,1676,2058,2016-10-28 00:00:00,666,109174,108767
"3567",15985,2016-10-28 01:00:00,666,764,479,285,94,191,2016-10-28 01:00:00,666,365,1008,370,1378,1743,2016-10-28 01:00:00,666,108051,107586
"3568",15986,2016-10-28 02:00:00,666,677,399,278,94,184,2016-10-28 02:00:00,666,286,742,250,992,1278,2016-10-28 02:00:00,666,101361,100922
"3569",15987,2016-10-28 03:00:00,666,601,359,242,86,156,2016-10-28 03:00:00,666,213,485,152,637,850,2016-10-28 03:00:00,666,91902,91507
"3570",15988,2016-10-28 04:00:00,666,528,326,202,63,139,2016-10-28 04:00:00,666,123,408,145,553,676,2016-10-28 04:00:00,666,83166,82853
"3571",15989,2016-10-28 05:00:00,666,397,228,169,69,100,2016-10-28 05:00:00,666,92,182,85,267,359,2016-10-28 05:00:00,666,80583,80258
"3572",15990,2016-10-28 06:00:00,666,298,203,95,39,56,2016-10-28 06:00:00,666,83,74,34,108,191,2016-10-28 06:00:00,666,90634,90254
"3573",15991,2016-10-28 07:00:00,666,289,202,87,32,55,2016-10-28 07:00:00,666,38,84,38,122,160,2016-10-28 07:00:00,666,89344,88954
"3574",15992,2016-10-28 08:00:00,666,243,188,55,21,34,2016-10-28 08:00:00,666,38,36,17,53,91,2016-10-28 08:00:00,666,96877,96471
"3575",15993,2016-10-28 09:00:00,666,254,182,72,23,49,2016-10-28 09:00:00,666,38,45,20,65,103,2016-10-28 09:00:00,666,91782,91382
"3576",15994,2016-10-28 10:00:00,666,253,195,58,20,38,2016-10-28 10:00:00,666,63,86,40,126,189,2016-10-28 10:00:00,666,99236,98808
"3577",15995,2016-10-28 11:00:00,666,258,209,49,13,36,2016-10-28 11:00:00,666,100,140,59,199,299,2016-10-28 11:00:00,666,138621,138193
"3578",15996,2016-10-28 12:00:00,666,379,318,61,15,46,2016-10-28 12:00:00,666,230,303,159,462,692,2016-10-28 12:00:00,666,200882,200338
"3579",15997,2016-10-28 13:00:00,666,560,414,146,48,98,2016-10-28 13:00:00,666,390,488,257,745,1135,2016-10-28 13:00:00,666,233065,232346
"3580",15998,2016-10-28 14:00:00,666,626,487,139,51,88,2016-10-28 14:00:00,666,582,607,307,914,1496,2016-10-28 14:00:00,666,234560,233709
"3581",15999,2016-10-28 15:00:00,666,718,556,162,71,91,2016-10-28 15:00:00,666,632,754,367,1121,1753,2016-10-28 15:00:00,666,230838,229962
"3582",16000,2016-10-28 16:00:00,666,746,559,187,77,110,2016-10-28 16:00:00,666,669,787,362,1149,1818,2016-10-28 16:00:00,666,206906,206056
"3583",16001,2016-10-28 17:00:00,666,731,535,196,67,129,2016-10-28 17:00:00,666,660,895,382,1277,1937,2016-10-28 17:00:00,666,205098,204355
"3584",16002,2016-10-28 18:00:00,666,752,547,205,83,122,2016-10-28 18:00:00,666,721,895,406,1301,2022,2016-10-28 18:00:00,666,192671,191904
"3585",16003,2016-10-28 19:00:00,666,732,500,232,78,154,2016-10-28 19:00:00,666,679,1000,406,1406,2085,2016-10-28 19:00:00,666,177023,176239
"3586",16004,2016-10-28 20:00:00,666,786,527,259,74,185,2016-10-28 20:00:00,666,708,1148,478,1626,2334,2016-10-28 20:00:00,666,156864,156202
"3587",16005,2016-10-28 21:00:00,666,756,508,248,95,153,2016-10-28 21:00:00,666,638,1217,465,1682,2320,2016-10-28 21:00:00,666,134925,134320
"3588",16006,2016-10-28 22:00:00,666,741,490,251,85,166,2016-10-28 22:00:00,666,501,1206,456,1662,2163,2016-10-28 22:00:00,666,111566,111146
"3589",16007,2016-10-28 23:00:00,666,698,453,245,84,161,2016-10-28 23:00:00,666,457,1135,413,1548,2005,2016-10-28 23:00:00,666,97583,97186
"3590",16008,2016-10-29 00:00:00,667,665,431,234,73,161,2016-10-29 00:00:00,667,366,1005,389,1394,1760,2016-10-29 00:00:00,667,89841,89474
"3591",16009,2016-10-29 01:00:00,667,603,355,248,81,167,2016-10-29 01:00:00,667,326,844,296,1140,1466,2016-10-29 01:00:00,667,84649,84274
"3592",16010,2016-10-29 02:00:00,667,640,359,281,91,190,2016-10-29 02:00:00,667,256,705,246,951,1207,2016-10-29 02:00:00,667,80360,80046
"3593",16011,2016-10-29 03:00:00,667,578,348,230,65,165,2016-10-29 03:00:00,667,192,574,233,807,999,2016-10-29 03:00:00,667,76231,75931
"3594",16012,2016-10-29 04:00:00,667,539,310,229,65,164,2016-10-29 04:00:00,667,150,349,123,472,622,2016-10-29 04:00:00,667,75763,75474
"3595",16013,2016-10-29 05:00:00,667,405,241,164,63,101,2016-10-29 05:00:00,667,93,191,63,254,347,2016-10-29 05:00:00,667,65368,65097
"3596",16014,2016-10-29 06:00:00,667,333,218,115,38,77,2016-10-29 06:00:00,667,66,94,35,129,195,2016-10-29 06:00:00,667,62547,62285
"3597",16015,2016-10-29 07:00:00,667,280,206,74,30,44,2016-10-29 07:00:00,667,47,59,26,85,132,2016-10-29 07:00:00,667,61507,61235
"3598",16016,2016-10-29 08:00:00,667,224,151,73,28,45,2016-10-29 08:00:00,667,35,42,20,62,97,2016-10-29 08:00:00,667,59842,59555
"3599",16017,2016-10-29 09:00:00,667,255,176,79,27,52,2016-10-29 09:00:00,667,28,30,9,39,67,2016-10-29 09:00:00,667,61524,61284
"3600",16018,2016-10-29 10:00:00,667,276,206,70,23,47,2016-10-29 10:00:00,667,50,29,11,40,90,2016-10-29 10:00:00,667,64980,64692
"3601",16019,2016-10-29 11:00:00,667,278,211,67,21,46,2016-10-29 11:00:00,667,84,77,42,119,203,2016-10-29 11:00:00,667,74778,74488
"3602",16020,2016-10-29 12:00:00,667,391,284,107,37,70,2016-10-29 12:00:00,667,159,216,89,305,464,2016-10-29 12:00:00,667,87426,87083
"3603",16021,2016-10-29 13:00:00,667,528,354,174,62,112,2016-10-29 13:00:00,667,293,492,202,694,987,2016-10-29 13:00:00,667,99466,99035
"3604",16022,2016-10-29 14:00:00,667,591,376,215,74,141,2016-10-29 14:00:00,667,391,692,305,997,1388,2016-10-29 14:00:00,667,108681,108243
"3605",16023,2016-10-29 15:00:00,667,700,435,265,105,160,2016-10-29 15:00:00,667,435,850,338,1188,1623,2016-10-29 15:00:00,667,111079,110579
"3606",16024,2016-10-29 16:00:00,667,692,465,227,74,153,2016-10-29 16:00:00,667,477,975,382,1357,1834,2016-10-29 16:00:00,667,110023,109556
"3607",16025,2016-10-29 17:00:00,667,770,473,297,94,203,2016-10-29 17:00:00,667,446,985,395,1380,1826,2016-10-29 17:00:00,667,106505,105992
"3608",16026,2016-10-29 18:00:00,667,689,436,253,80,173,2016-10-29 18:00:00,667,508,1017,392,1409,1917,2016-10-29 18:00:00,667,102889,102397
"3609",16027,2016-10-29 19:00:00,667,656,380,276,97,179,2016-10-29 19:00:00,667,530,1030,387,1417,1947,2016-10-29 19:00:00,667,97808,97318
"3610",16028,2016-10-29 20:00:00,667,673,381,292,83,209,2016-10-29 20:00:00,667,451,1039,389,1428,1879,2016-10-29 20:00:00,667,92615,92210
"3611",16029,2016-10-29 21:00:00,667,715,394,321,102,219,2016-10-29 21:00:00,667,432,987,366,1353,1785,2016-10-29 21:00:00,667,87465,87068
"3612",16030,2016-10-29 22:00:00,667,742,360,382,119,263,2016-10-29 22:00:00,667,365,962,332,1294,1659,2016-10-29 22:00:00,667,81074,80709
"3613",16031,2016-10-29 23:00:00,667,706,359,347,114,233,2016-10-29 23:00:00,667,303,866,317,1183,1486,2016-10-29 23:00:00,667,74596,74275
"3614",16032,2016-10-30 00:00:00,668,766,399,367,94,273,2016-10-30 00:00:00,668,289,905,308,1213,1502,2016-10-30 00:00:00,668,72638,72325
"3615",16033,2016-10-30 01:00:00,668,825,494,331,98,233,2016-10-30 01:00:00,668,272,769,262,1031,1303,2016-10-30 01:00:00,668,73045,72715
"3616",16034,2016-10-30 02:00:00,668,695,395,300,88,212,2016-10-30 02:00:00,668,204,622,201,823,1027,2016-10-30 02:00:00,668,71593,71258
"3617",16035,2016-10-30 03:00:00,668,657,364,293,81,212,2016-10-30 03:00:00,668,167,467,150,617,784,2016-10-30 03:00:00,668,71256,70944
"3618",16036,2016-10-30 04:00:00,668,556,294,262,84,178,2016-10-30 04:00:00,668,150,321,111,432,582,2016-10-30 04:00:00,668,69471,69211
"3619",16037,2016-10-30 05:00:00,668,385,214,171,56,115,2016-10-30 05:00:00,668,107,205,64,269,376,2016-10-30 05:00:00,668,64628,64392
"3620",16038,2016-10-30 06:00:00,668,341,210,131,50,81,2016-10-30 06:00:00,668,58,94,32,126,184,2016-10-30 06:00:00,668,62291,62034
"3621",16039,2016-10-30 07:00:00,668,248,149,99,40,59,2016-10-30 07:00:00,668,66,56,14,70,136,2016-10-30 07:00:00,668,61516,61253
"3622",16040,2016-10-30 08:00:00,668,228,160,68,23,45,2016-10-30 08:00:00,668,35,23,5,28,63,2016-10-30 08:00:00,668,59451,59170
"3623",16041,2016-10-30 09:00:00,668,208,142,66,19,47,2016-10-30 09:00:00,668,42,32,12,44,86,2016-10-30 09:00:00,668,60569,60282
"3624",16042,2016-10-30 10:00:00,668,228,165,63,23,40,2016-10-30 10:00:00,668,47,31,10,41,88,2016-10-30 10:00:00,668,64639,64377
"3625",16043,2016-10-30 11:00:00,668,239,178,61,24,37,2016-10-30 11:00:00,668,66,57,25,82,148,2016-10-30 11:00:00,668,70217,69907
"3626",16044,2016-10-30 12:00:00,668,317,230,87,32,55,2016-10-30 12:00:00,668,95,152,59,211,306,2016-10-30 12:00:00,668,81225,80934
"3627",16045,2016-10-30 13:00:00,668,442,308,134,31,103,2016-10-30 13:00:00,668,220,321,125,446,666,2016-10-30 13:00:00,668,89174,88782
"3628",16046,2016-10-30 14:00:00,668,503,352,151,43,108,2016-10-30 14:00:00,668,281,647,249,896,1177,2016-10-30 14:00:00,668,96232,95817
"3629",16047,2016-10-30 15:00:00,668,621,411,210,76,134,2016-10-30 15:00:00,668,312,795,317,1112,1424,2016-10-30 15:00:00,668,102817,102350
"3630",16048,2016-10-30 16:00:00,668,701,449,252,77,175,2016-10-30 16:00:00,668,368,867,323,1190,1558,2016-10-30 16:00:00,668,107903,107418
"3631",16049,2016-10-30 17:00:00,668,746,480,266,74,192,2016-10-30 17:00:00,668,416,941,319,1260,1676,2016-10-30 17:00:00,668,105487,105071
"3632",16050,2016-10-30 18:00:00,668,780,509,271,88,183,2016-10-30 18:00:00,668,416,862,310,1172,1588,2016-10-30 18:00:00,668,105739,105257
"3633",16051,2016-10-30 19:00:00,668,882,559,323,104,219,2016-10-30 19:00:00,668,372,1066,403,1469,1841,2016-10-30 19:00:00,668,102889,102378
"3634",16052,2016-10-30 20:00:00,668,726,435,291,100,191,2016-10-30 20:00:00,668,374,1015,385,1400,1774,2016-10-30 20:00:00,668,100389,99943
"3635",16053,2016-10-30 21:00:00,668,743,462,281,85,196,2016-10-30 21:00:00,668,385,1058,385,1443,1828,2016-10-30 21:00:00,668,98744,98295
"3636",16054,2016-10-30 22:00:00,668,667,413,254,87,167,2016-10-30 22:00:00,668,345,1013,390,1403,1748,2016-10-30 22:00:00,668,94570,94153
"3637",16055,2016-10-30 23:00:00,668,637,339,298,117,181,2016-10-30 23:00:00,668,369,941,332,1273,1642,2016-10-30 23:00:00,668,92116,91701
"3638",16056,2016-10-31 00:00:00,669,707,433,274,105,169,2016-10-31 00:00:00,669,315,835,312,1147,1462,2016-10-31 00:00:00,669,99372,98950
"3639",16057,2016-10-31 01:00:00,669,739,460,279,79,200,2016-10-31 01:00:00,669,261,558,205,763,1024,2016-10-31 01:00:00,669,102236,101841
"3640",16058,2016-10-31 02:00:00,669,668,439,229,65,164,2016-10-31 02:00:00,669,206,364,128,492,698,2016-10-31 02:00:00,669,95101,94694
"3641",16059,2016-10-31 03:00:00,669,514,358,156,51,105,2016-10-31 03:00:00,669,163,241,96,337,500,2016-10-31 03:00:00,669,85799,85426
"3642",16060,2016-10-31 04:00:00,669,428,270,158,42,116,2016-10-31 04:00:00,669,120,166,62,228,348,2016-10-31 04:00:00,669,80526,80217
"3643",16061,2016-10-31 05:00:00,669,318,207,111,37,74,2016-10-31 05:00:00,669,80,105,42,147,227,2016-10-31 05:00:00,669,77341,77060
"3644",16062,2016-10-31 06:00:00,669,223,144,79,33,46,2016-10-31 06:00:00,669,56,40,13,53,109,2016-10-31 06:00:00,669,82231,81866
"3645",16063,2016-10-31 07:00:00,669,226,170,56,22,34,2016-10-31 07:00:00,669,39,49,22,71,110,2016-10-31 07:00:00,669,87523,87119
"3646",16064,2016-10-31 08:00:00,669,213,159,54,16,38,2016-10-31 08:00:00,669,24,40,18,58,82,2016-10-31 08:00:00,669,89150,88706
"3647",16065,2016-10-31 09:00:00,669,223,175,48,15,33,2016-10-31 09:00:00,669,26,22,8,30,56,2016-10-31 09:00:00,669,94650,94233
"3648",16066,2016-10-31 10:00:00,669,238,191,47,13,34,2016-10-31 10:00:00,669,58,54,29,83,141,2016-10-31 10:00:00,669,115530,115119
"3649",16067,2016-10-31 11:00:00,669,272,218,54,22,32,2016-10-31 11:00:00,669,98,96,40,136,234,2016-10-31 11:00:00,669,187900,187402
"3650",16068,2016-10-31 12:00:00,669,394,320,74,20,54,2016-10-31 12:00:00,669,237,261,123,384,621,2016-10-31 12:00:00,669,298324,297704
"3651",16069,2016-10-31 13:00:00,669,568,465,103,34,69,2016-10-31 13:00:00,669,456,411,206,617,1073,2016-10-31 13:00:00,669,327935,327165
"3652",16070,2016-10-31 14:00:00,669,643,508,135,53,82,2016-10-31 14:00:00,669,561,589,274,863,1424,2016-10-31 14:00:00,669,302661,301787
"3653",16071,2016-10-31 15:00:00,669,744,581,163,52,111,2016-10-31 15:00:00,669,667,730,337,1067,1734,2016-10-31 15:00:00,669,285491,284579
"3654",16072,2016-10-31 16:00:00,669,771,599,172,54,118,2016-10-31 16:00:00,669,678,810,396,1206,1884,2016-10-31 16:00:00,669,245944,245109
"3655",16073,2016-10-31 17:00:00,669,798,596,202,77,125,2016-10-31 17:00:00,669,715,866,381,1247,1962,2016-10-31 17:00:00,669,230585,229708
"3656",16074,2016-10-31 18:00:00,669,849,638,211,77,134,2016-10-31 18:00:00,669,769,957,417,1374,2143,2016-10-31 18:00:00,669,221163,220313
"3657",16075,2016-10-31 19:00:00,669,888,653,235,75,160,2016-10-31 19:00:00,669,744,1152,487,1639,2383,2016-10-31 19:00:00,669,204797,204016
"3658",16076,2016-10-31 20:00:00,669,839,602,237,76,161,2016-10-31 20:00:00,669,659,1142,481,1623,2282,2016-10-31 20:00:00,669,182882,182222
"3659",16077,2016-10-31 21:00:00,669,821,526,295,96,199,2016-10-31 21:00:00,669,596,1241,508,1749,2345,2016-10-31 21:00:00,669,148018,147404
"3660",16078,2016-10-31 22:00:00,669,835,528,307,88,219,2016-10-31 22:00:00,669,536,1164,434,1598,2134,2016-10-31 22:00:00,669,118899,118423
"3661",16079,2016-10-31 23:00:00,669,804,508,296,86,209,2016-10-31 23:00:00,669,485,995,388,1383,1868,2016-10-31 23:00:00,669,104701,104308
"3662",16080,2016-11-01 00:00:00,670,843,454,389,94,295,2016-11-01 00:00:00,670,412,1270,441,1711,2123,2016-11-01 00:00:00,670,96947,96534
"3663",16081,2016-11-01 01:00:00,670,831,446,385,122,263,2016-11-01 01:00:00,670,302,769,289,1058,1360,2016-11-01 01:00:00,670,96657,96271
"3664",16082,2016-11-01 02:00:00,670,595,353,242,87,155,2016-11-01 02:00:00,670,239,513,207,720,959,2016-11-01 02:00:00,670,91358,90968
"3665",16083,2016-11-01 03:00:00,670,485,309,176,58,118,2016-11-01 03:00:00,670,136,424,156,580,716,2016-11-01 03:00:00,670,84009,83693
"3666",16084,2016-11-01 04:00:00,670,420,273,147,37,110,2016-11-01 04:00:00,670,124,272,104,376,500,2016-11-01 04:00:00,670,76227,75918
"3667",16085,2016-11-01 05:00:00,670,368,225,143,59,84,2016-11-01 05:00:00,670,95,144,58,202,297,2016-11-01 05:00:00,670,72385,72075
"3668",16086,2016-11-01 06:00:00,670,265,174,91,27,64,2016-11-01 06:00:00,670,59,54,21,75,134,2016-11-01 06:00:00,670,76564,76225
"3669",16087,2016-11-01 07:00:00,670,248,191,57,27,30,2016-11-01 07:00:00,670,48,64,23,87,135,2016-11-01 07:00:00,670,79854,79433
"3670",16088,2016-11-01 08:00:00,670,261,197,64,21,43,2016-11-01 08:00:00,670,37,29,14,43,80,2016-11-01 08:00:00,670,83157,82759
"3671",16089,2016-11-01 09:00:00,670,250,194,56,22,34,2016-11-01 09:00:00,670,33,28,19,47,80,2016-11-01 09:00:00,670,88411,87988
"3672",16090,2016-11-01 10:00:00,670,258,190,68,23,45,2016-11-01 10:00:00,670,61,66,30,96,157,2016-11-01 10:00:00,670,99427,99034
"3673",16091,2016-11-01 11:00:00,670,281,229,52,19,33,2016-11-01 11:00:00,670,92,98,55,153,245,2016-11-01 11:00:00,670,132284,131819
"3674",16092,2016-11-01 12:00:00,670,447,343,104,35,69,2016-11-01 12:00:00,670,236,272,140,412,648,2016-11-01 12:00:00,670,193768,193206
"3675",16093,2016-11-01 13:00:00,670,470,376,94,33,61,2016-11-01 13:00:00,670,376,467,232,699,1075,2016-11-01 13:00:00,670,230223,229451
"3676",16094,2016-11-01 14:00:00,670,603,477,126,43,83,2016-11-01 14:00:00,670,558,553,259,812,1370,2016-11-01 14:00:00,670,237477,236531
"3677",16095,2016-11-01 15:00:00,670,669,522,147,68,79,2016-11-01 15:00:00,670,648,649,305,954,1602,2016-11-01 15:00:00,670,235706,234830
"3678",16096,2016-11-01 16:00:00,670,743,554,189,70,119,2016-11-01 16:00:00,670,658,757,357,1114,1772,2016-11-01 16:00:00,670,214691,213820
"3679",16097,2016-11-01 17:00:00,670,796,584,212,70,142,2016-11-01 17:00:00,670,703,840,375,1215,1918,2016-11-01 17:00:00,670,208406,207597
"3680",16098,2016-11-01 18:00:00,670,838,593,245,82,163,2016-11-01 18:00:00,670,732,928,395,1323,2055,2016-11-01 18:00:00,670,205870,205053
"3681",16099,2016-11-01 19:00:00,670,901,619,282,77,205,2016-11-01 19:00:00,670,728,1085,474,1559,2287,2016-11-01 19:00:00,670,193828,193013
"3682",16100,2016-11-01 20:00:00,670,914,607,307,107,200,2016-11-01 20:00:00,670,744,1315,542,1857,2601,2016-11-01 20:00:00,670,176547,175836
"3683",16101,2016-11-01 21:00:00,670,966,646,320,95,225,2016-11-01 21:00:00,670,698,1400,592,1992,2690,2016-11-01 21:00:00,670,149247,148616
"3684",16102,2016-11-01 22:00:00,670,941,591,350,110,240,2016-11-01 22:00:00,670,514,1378,545,1923,2437,2016-11-01 22:00:00,670,128967,128470
"3685",16103,2016-11-01 23:00:00,670,962,584,378,117,261,2016-11-01 23:00:00,670,513,1346,521,1867,2380,2016-11-01 23:00:00,670,113180,112714
"3686",16104,2016-11-02 00:00:00,671,910,553,357,120,237,2016-11-02 00:00:00,671,414,1231,485,1716,2130,2016-11-02 00:00:00,671,106031,105577
"3687",16105,2016-11-02 01:00:00,671,880,559,321,107,214,2016-11-02 01:00:00,671,352,1067,412,1479,1831,2016-11-02 01:00:00,671,103074,102648
"3688",16106,2016-11-02 02:00:00,671,650,420,230,84,146,2016-11-02 02:00:00,671,269,766,305,1071,1340,2016-11-02 02:00:00,671,97096,96686
"3689",16107,2016-11-02 03:00:00,671,661,457,204,71,133,2016-11-02 03:00:00,671,193,579,238,817,1010,2016-11-02 03:00:00,671,90730,90333
"3690",16108,2016-11-02 04:00:00,671,583,368,215,75,140,2016-11-02 04:00:00,671,156,406,157,563,719,2016-11-02 04:00:00,671,84238,83893
"3691",16109,2016-11-02 05:00:00,671,397,246,151,54,97,2016-11-02 05:00:00,671,123,168,58,226,349,2016-11-02 05:00:00,671,79343,79038
"3692",16110,2016-11-02 06:00:00,671,272,187,85,23,62,2016-11-02 06:00:00,671,52,98,38,136,188,2016-11-02 06:00:00,671,81707,81334
"3693",16111,2016-11-02 07:00:00,671,270,199,71,30,41,2016-11-02 07:00:00,671,50,33,18,51,101,2016-11-02 07:00:00,671,85750,85356
"3694",16112,2016-11-02 08:00:00,671,244,176,68,28,40,2016-11-02 08:00:00,671,43,27,8,35,78,2016-11-02 08:00:00,671,90142,89698
"3695",16113,2016-11-02 09:00:00,671,227,173,54,17,37,2016-11-02 09:00:00,671,40,43,14,57,97,2016-11-02 09:00:00,671,94909,94449
"3696",16114,2016-11-02 10:00:00,671,269,201,68,29,39,2016-11-02 10:00:00,671,45,60,36,96,141,2016-11-02 10:00:00,671,102553,102072
"3697",16115,2016-11-02 11:00:00,671,329,256,73,31,42,2016-11-02 11:00:00,671,104,161,67,228,332,2016-11-02 11:00:00,671,120727,120254
"3698",16116,2016-11-02 12:00:00,671,457,362,95,44,51,2016-11-02 12:00:00,671,201,333,178,511,712,2016-11-02 12:00:00,671,166950,166390
"3699",16117,2016-11-02 13:00:00,671,560,458,102,28,74,2016-11-02 13:00:00,671,384,536,267,803,1187,2016-11-02 13:00:00,671,201644,200922
"3700",16118,2016-11-02 14:00:00,671,730,540,190,75,115,2016-11-02 14:00:00,671,532,653,357,1010,1542,2016-11-02 14:00:00,671,215753,214884
"3701",16119,2016-11-02 15:00:00,671,753,616,137,45,92,2016-11-02 15:00:00,671,622,743,376,1119,1741,2016-11-02 15:00:00,671,217506,216575
"3702",16120,2016-11-02 16:00:00,671,757,580,177,61,116,2016-11-02 16:00:00,671,630,849,407,1256,1886,2016-11-02 16:00:00,671,201168,200305
"3703",16121,2016-11-02 17:00:00,671,796,602,194,57,137,2016-11-02 17:00:00,671,684,848,386,1234,1918,2016-11-02 17:00:00,671,196635,195826
"3704",16122,2016-11-02 18:00:00,671,884,658,226,79,147,2016-11-02 18:00:00,671,761,916,456,1372,2133,2016-11-02 18:00:00,671,193352,192559
"3705",16123,2016-11-02 19:00:00,671,928,659,269,95,174,2016-11-02 19:00:00,671,755,1163,537,1700,2455,2016-11-02 19:00:00,671,182877,182074
"3706",16124,2016-11-02 20:00:00,671,910,621,289,102,187,2016-11-02 20:00:00,671,685,1314,555,1869,2554,2016-11-02 20:00:00,671,169300,168562
"3707",16125,2016-11-02 21:00:00,671,963,620,343,116,227,2016-11-02 21:00:00,671,653,1363,588,1951,2604,2016-11-02 21:00:00,671,141385,140766
"3708",16126,2016-11-02 22:00:00,671,952,557,395,116,279,2016-11-02 22:00:00,671,584,1443,627,2070,2654,2016-11-02 22:00:00,671,120809,120311
"3709",16127,2016-11-02 23:00:00,671,973,605,368,123,245,2016-11-02 23:00:00,671,552,1389,575,1964,2516,2016-11-02 23:00:00,671,110166,109652
"3710",16128,2016-11-03 00:00:00,672,915,559,356,120,236,2016-11-03 00:00:00,672,367,1240,501,1741,2108,2016-11-03 00:00:00,672,101668,101241
"3711",16129,2016-11-03 01:00:00,672,827,523,304,134,170,2016-11-03 01:00:00,672,339,1009,428,1437,1776,2016-11-03 01:00:00,672,102567,102155
"3712",16130,2016-11-03 02:00:00,672,702,438,264,93,171,2016-11-03 02:00:00,672,242,732,311,1043,1285,2016-11-03 02:00:00,672,96308,95886
"3713",16131,2016-11-03 03:00:00,672,543,325,218,78,140,2016-11-03 03:00:00,672,176,425,192,617,793,2016-11-03 03:00:00,672,87011,86653
"3714",16132,2016-11-03 04:00:00,672,447,300,147,40,107,2016-11-03 04:00:00,672,140,290,124,414,554,2016-11-03 04:00:00,672,80869,80514
"3715",16133,2016-11-03 05:00:00,672,372,221,151,58,93,2016-11-03 05:00:00,672,98,198,82,280,378,2016-11-03 05:00:00,672,77932,77626
"3716",16134,2016-11-03 06:00:00,672,345,221,124,45,79,2016-11-03 06:00:00,672,69,105,48,153,222,2016-11-03 06:00:00,672,82870,82512
"3717",16135,2016-11-03 07:00:00,672,279,202,77,24,53,2016-11-03 07:00:00,672,51,47,22,69,120,2016-11-03 07:00:00,672,87839,87406
"3718",16136,2016-11-03 08:00:00,672,218,164,54,28,26,2016-11-03 08:00:00,672,46,31,14,45,91,2016-11-03 08:00:00,672,92927,92526
"3719",16137,2016-11-03 09:00:00,672,237,181,56,19,37,2016-11-03 09:00:00,672,52,42,21,63,115,2016-11-03 09:00:00,672,97020,96618
"3720",16138,2016-11-03 10:00:00,672,272,201,71,27,44,2016-11-03 10:00:00,672,64,74,44,118,182,2016-11-03 10:00:00,672,105764,105328
"3721",16139,2016-11-03 11:00:00,672,343,275,68,28,40,2016-11-03 11:00:00,672,101,136,75,211,312,2016-11-03 11:00:00,672,142997,142518
"3722",16140,2016-11-03 12:00:00,672,389,282,107,35,72,2016-11-03 12:00:00,672,196,315,165,480,676,2016-11-03 12:00:00,672,215636,215044
"3723",16141,2016-11-03 13:00:00,672,532,426,106,43,63,2016-11-03 13:00:00,672,401,531,291,822,1223,2016-11-03 13:00:00,672,258461,257679
"3724",16142,2016-11-03 14:00:00,672,650,492,158,63,95,2016-11-03 14:00:00,672,506,586,283,869,1375,2016-11-03 14:00:00,672,262122,261172
"3725",16143,2016-11-03 15:00:00,672,740,558,182,71,111,2016-11-03 15:00:00,672,562,789,353,1142,1704,2016-11-03 15:00:00,672,256155,255258
"3726",16144,2016-11-03 16:00:00,672,802,609,193,75,118,2016-11-03 16:00:00,672,614,843,393,1236,1850,2016-11-03 16:00:00,672,233706,232840
"3727",16145,2016-11-03 17:00:00,672,801,595,206,74,132,2016-11-03 17:00:00,672,688,903,433,1336,2024,2016-11-03 17:00:00,672,223951,223175
"3728",16146,2016-11-03 18:00:00,672,804,559,245,92,153,2016-11-03 18:00:00,672,755,944,440,1384,2139,2016-11-03 18:00:00,672,218007,217198
"3729",16147,2016-11-03 19:00:00,672,851,565,286,114,172,2016-11-03 19:00:00,672,767,1213,511,1724,2491,2016-11-03 19:00:00,672,204348,203527
"3730",16148,2016-11-03 20:00:00,672,883,591,292,106,186,2016-11-03 20:00:00,672,694,1316,573,1889,2583,2016-11-03 20:00:00,672,188484,187747
"3731",16149,2016-11-03 21:00:00,672,978,632,346,123,223,2016-11-03 21:00:00,672,616,1330,595,1925,2541,2016-11-03 21:00:00,672,156675,156090
"3732",16150,2016-11-03 22:00:00,672,895,526,369,133,236,2016-11-03 22:00:00,672,557,1515,625,2140,2697,2016-11-03 22:00:00,672,126890,126432
"3733",16151,2016-11-03 23:00:00,672,936,502,434,157,277,2016-11-03 23:00:00,672,500,1438,561,1999,2499,2016-11-03 23:00:00,672,112558,112107
"3734",16152,2016-11-04 00:00:00,673,886,486,400,128,272,2016-11-04 00:00:00,673,417,1392,564,1956,2373,2016-11-04 00:00:00,673,106962,106542
"3735",16153,2016-11-04 01:00:00,673,876,506,370,116,254,2016-11-04 01:00:00,673,310,1222,468,1690,2000,2016-11-04 01:00:00,673,106903,106470
"3736",16154,2016-11-04 02:00:00,673,824,473,351,118,233,2016-11-04 02:00:00,673,289,883,364,1247,1536,2016-11-04 02:00:00,673,96029,95580
"3737",16155,2016-11-04 03:00:00,673,627,371,256,84,172,2016-11-04 03:00:00,673,198,640,237,877,1075,2016-11-04 03:00:00,673,86009,85609
"3738",16156,2016-11-04 04:00:00,673,659,336,323,103,220,2016-11-04 04:00:00,673,129,705,242,947,1076,2016-11-04 04:00:00,673,77251,76924
"3739",16157,2016-11-04 05:00:00,673,529,297,232,76,156,2016-11-04 05:00:00,673,90,358,123,481,571,2016-11-04 05:00:00,673,71599,71311
"3740",16158,2016-11-04 06:00:00,673,441,254,187,70,117,2016-11-04 06:00:00,673,69,169,57,226,295,2016-11-04 06:00:00,673,73547,73204
"3741",16159,2016-11-04 07:00:00,673,304,194,110,35,75,2016-11-04 07:00:00,673,64,89,31,120,184,2016-11-04 07:00:00,673,78190,77812
"3742",16160,2016-11-04 08:00:00,673,292,204,88,28,60,2016-11-04 08:00:00,673,48,51,23,74,122,2016-11-04 08:00:00,673,80879,80516
"3743",16161,2016-11-04 09:00:00,673,289,210,79,32,47,2016-11-04 09:00:00,673,67,62,20,82,149,2016-11-04 09:00:00,673,87657,87233
"3744",16162,2016-11-04 10:00:00,673,316,227,89,38,51,2016-11-04 10:00:00,673,45,104,53,157,202,2016-11-04 10:00:00,673,98013,97596
"3745",16163,2016-11-04 11:00:00,673,320,240,80,26,54,2016-11-04 11:00:00,673,94,152,83,235,329,2016-11-04 11:00:00,673,133715,133277
"3746",16164,2016-11-04 12:00:00,673,372,301,71,16,54,2016-11-04 12:00:00,673,191,350,167,517,708,2016-11-04 12:00:00,673,195258,194710
"3747",16165,2016-11-04 13:00:00,673,551,381,170,63,107,2016-11-04 13:00:00,673,405,586,287,873,1278,2016-11-04 13:00:00,673,228212,227443
"3748",16166,2016-11-04 14:00:00,673,711,500,211,94,117,2016-11-04 14:00:00,673,484,761,333,1094,1578,2016-11-04 14:00:00,673,233032,232125
"3749",16167,2016-11-04 15:00:00,673,759,536,223,70,153,2016-11-04 15:00:00,673,602,916,411,1327,1929,2016-11-04 15:00:00,673,226885,226033
"3750",16168,2016-11-04 16:00:00,673,848,614,234,69,165,2016-11-04 16:00:00,673,665,958,386,1344,2009,2016-11-04 16:00:00,673,204131,203373
"3751",16169,2016-11-04 17:00:00,673,790,560,230,74,156,2016-11-04 17:00:00,673,681,1003,433,1436,2117,2016-11-04 17:00:00,673,207328,206557
"3752",16170,2016-11-04 18:00:00,673,745,507,238,79,159,2016-11-04 18:00:00,673,669,1161,500,1661,2330,2016-11-04 18:00:00,673,204926,204181
"3753",16171,2016-11-04 19:00:00,673,810,515,295,97,198,2016-11-04 19:00:00,673,729,1332,568,1900,2629,2016-11-04 19:00:00,673,190323,189570
"3754",16172,2016-11-04 20:00:00,673,867,545,322,97,225,2016-11-04 20:00:00,673,640,1566,585,2151,2791,2016-11-04 20:00:00,673,171159,170508
"3755",16173,2016-11-04 21:00:00,673,870,499,371,100,271,2016-11-04 21:00:00,673,571,1706,661,2367,2938,2016-11-04 21:00:00,673,143958,143454
"3756",16174,2016-11-04 22:00:00,673,928,531,397,124,273,2016-11-04 22:00:00,673,474,1756,647,2403,2877,2016-11-04 22:00:00,673,107570,107145
"3757",16175,2016-11-04 23:00:00,673,917,508,409,119,290,2016-11-04 23:00:00,673,419,1618,620,2238,2657,2016-11-04 23:00:00,673,91224,90815
"3758",16176,2016-11-05 00:00:00,674,845,441,404,102,302,2016-11-05 00:00:00,674,366,1457,530,1987,2353,2016-11-05 00:00:00,674,80914,80571
"3759",16177,2016-11-05 01:00:00,674,920,476,444,135,309,2016-11-05 01:00:00,674,255,1392,511,1903,2158,2016-11-05 01:00:00,674,77470,77110
"3760",16178,2016-11-05 02:00:00,674,771,426,345,94,251,2016-11-05 02:00:00,674,265,1112,408,1520,1785,2016-11-05 02:00:00,674,73470,73122
"3761",16179,2016-11-05 03:00:00,674,725,376,349,89,260,2016-11-05 03:00:00,674,153,917,343,1260,1413,2016-11-05 03:00:00,674,69426,69069
"3762",16180,2016-11-05 04:00:00,674,644,331,313,100,213,2016-11-05 04:00:00,674,169,617,240,857,1026,2016-11-05 04:00:00,674,64665,64405
"3763",16181,2016-11-05 05:00:00,674,473,242,231,71,160,2016-11-05 05:00:00,674,102,319,121,440,542,2016-11-05 05:00:00,674,60063,59802
"3764",16182,2016-11-05 06:00:00,674,420,237,183,72,111,2016-11-05 06:00:00,674,57,148,57,205,262,2016-11-05 06:00:00,674,57802,57532
"3765",16183,2016-11-05 07:00:00,674,274,170,104,27,77,2016-11-05 07:00:00,674,44,81,28,109,153,2016-11-05 07:00:00,674,56137,55848
"3766",16184,2016-11-05 08:00:00,674,270,179,91,38,53,2016-11-05 08:00:00,674,28,38,19,57,85,2016-11-05 08:00:00,674,56185,55918
"3767",16185,2016-11-05 09:00:00,674,236,166,70,19,51,2016-11-05 09:00:00,674,26,29,13,42,68,2016-11-05 09:00:00,674,58473,58205
"3768",16186,2016-11-05 10:00:00,674,273,204,69,20,49,2016-11-05 10:00:00,674,57,38,19,57,114,2016-11-05 10:00:00,674,63405,63138
"3769",16187,2016-11-05 11:00:00,674,258,185,73,27,46,2016-11-05 11:00:00,674,67,110,53,163,230,2016-11-05 11:00:00,674,71270,70955
"3770",16188,2016-11-05 12:00:00,674,400,262,138,37,101,2016-11-05 12:00:00,674,137,313,160,473,610,2016-11-05 12:00:00,674,82873,82524
"3771",16189,2016-11-05 13:00:00,674,578,361,217,63,154,2016-11-05 13:00:00,674,290,618,261,879,1169,2016-11-05 13:00:00,674,94399,94013
"3772",16190,2016-11-05 14:00:00,674,725,445,280,100,180,2016-11-05 14:00:00,674,346,993,421,1414,1760,2016-11-05 14:00:00,674,103436,102995
"3773",16191,2016-11-05 15:00:00,674,886,497,389,110,279,2016-11-05 15:00:00,674,402,1138,431,1569,1971,2016-11-05 15:00:00,674,107243,106727
"3774",16192,2016-11-05 16:00:00,674,870,469,401,101,300,2016-11-05 16:00:00,674,447,1235,511,1746,2193,2016-11-05 16:00:00,674,106834,106338
"3775",16193,2016-11-05 17:00:00,674,1010,591,419,150,269,2016-11-05 17:00:00,674,466,1269,493,1762,2228,2016-11-05 17:00:00,674,103199,102691
"3776",16194,2016-11-05 18:00:00,674,1043,578,465,145,320,2016-11-05 18:00:00,674,503,1244,503,1747,2250,2016-11-05 18:00:00,674,98499,98007
"3777",16195,2016-11-05 19:00:00,674,974,533,441,142,299,2016-11-05 19:00:00,674,445,1219,464,1683,2128,2016-11-05 19:00:00,674,94870,94406
"3778",16196,2016-11-05 20:00:00,674,899,470,429,122,307,2016-11-05 20:00:00,674,450,1148,461,1609,2059,2016-11-05 20:00:00,674,89673,89232
"3779",16197,2016-11-05 21:00:00,674,1063,554,509,136,373,2016-11-05 21:00:00,674,468,1499,594,2093,2561,2016-11-05 21:00:00,674,84091,83690
"3780",16198,2016-11-05 22:00:00,674,977,508,469,92,377,2016-11-05 22:00:00,674,376,1354,506,1860,2236,2016-11-05 22:00:00,674,78447,78038
"3781",16199,2016-11-05 23:00:00,674,840,389,451,124,327,2016-11-05 23:00:00,674,323,1249,488,1737,2060,2016-11-05 23:00:00,674,74185,73801
"3782",16200,2016-11-06 00:00:00,675,946,469,477,144,333,2016-11-06 00:00:00,675,312,1252,458,1710,2022,2016-11-06 00:00:00,675,71099,70750
"3783",16201,2016-11-06 01:00:00,675,911,488,423,95,328,2016-11-06 01:00:00,675,266,1135,440,1575,1841,2016-11-06 01:00:00,675,69646,69285
"3784",16202,2016-11-06 02:00:00,675,745,406,339,74,265,2016-11-06 02:00:00,675,235,849,329,1178,1413,2016-11-06 02:00:00,675,67588,67282
"3785",16203,2016-11-06 03:00:00,675,723,380,343,77,266,2016-11-06 03:00:00,675,171,618,241,859,1030,2016-11-06 03:00:00,675,66057,65750
"3786",16204,2016-11-06 04:00:00,675,615,318,297,83,214,2016-11-06 04:00:00,675,126,416,163,579,705,2016-11-06 04:00:00,675,63825,63542
"3787",16205,2016-11-06 05:00:00,675,548,282,266,86,180,2016-11-06 05:00:00,675,88,265,96,361,449,2016-11-06 05:00:00,675,58119,57855
"3788",16206,2016-11-06 06:00:00,675,381,215,166,51,115,2016-11-06 06:00:00,675,69,163,63,226,295,2016-11-06 06:00:00,675,55813,55578
"3789",16207,2016-11-06 07:00:00,675,304,193,111,41,70,2016-11-06 07:00:00,675,53,55,20,75,128,2016-11-06 07:00:00,675,53616,53370
"3790",16208,2016-11-06 08:00:00,675,254,170,84,39,45,2016-11-06 08:00:00,675,51,40,18,58,109,2016-11-06 08:00:00,675,54410,54132
"3791",16209,2016-11-06 09:00:00,675,194,155,39,12,27,2016-11-06 09:00:00,675,40,28,16,44,84,2016-11-06 09:00:00,675,57685,57408
"3792",16210,2016-11-06 10:00:00,675,199,155,44,12,32,2016-11-06 10:00:00,675,28,43,22,65,93,2016-11-06 10:00:00,675,60304,60012
"3793",16211,2016-11-06 11:00:00,675,245,181,64,18,46,2016-11-06 11:00:00,675,51,76,37,113,164,2016-11-06 11:00:00,675,64077,63810
"3794",16212,2016-11-06 12:00:00,675,293,221,72,21,51,2016-11-06 12:00:00,675,100,197,81,278,378,2016-11-06 12:00:00,675,74261,73921
"3795",16213,2016-11-06 13:00:00,675,362,267,95,23,72,2016-11-06 13:00:00,675,178,497,189,686,864,2016-11-06 13:00:00,675,86219,85819
"3796",16214,2016-11-06 14:00:00,675,504,350,154,31,123,2016-11-06 14:00:00,675,265,937,371,1308,1573,2016-11-06 14:00:00,675,95547,95097
"3797",16215,2016-11-06 15:00:00,675,590,413,177,40,137,2016-11-06 15:00:00,675,305,1247,489,1736,2041,2016-11-06 15:00:00,675,99517,99050
"3798",16216,2016-11-06 16:00:00,675,703,445,258,58,200,2016-11-06 16:00:00,675,402,1148,450,1598,2000,2016-11-06 16:00:00,675,102960,102476
"3799",16217,2016-11-06 17:00:00,675,846,497,349,89,260,2016-11-06 17:00:00,675,413,1229,492,1721,2134,2016-11-06 17:00:00,675,102113,101621
"3800",16218,2016-11-06 18:00:00,675,894,528,366,103,263,2016-11-06 18:00:00,675,382,1141,434,1575,1957,2016-11-06 18:00:00,675,98455,97955
"3801",16219,2016-11-06 19:00:00,675,962,559,403,126,277,2016-11-06 19:00:00,675,446,1199,448,1647,2093,2016-11-06 19:00:00,675,97910,97388
"3802",16220,2016-11-06 20:00:00,675,940,524,416,142,274,2016-11-06 20:00:00,675,444,1272,477,1749,2193,2016-11-06 20:00:00,675,93567,93180
"3803",16221,2016-11-06 21:00:00,675,927,501,426,148,278,2016-11-06 21:00:00,675,417,1308,531,1839,2256,2016-11-06 21:00:00,675,90295,89828
"3804",16222,2016-11-06 22:00:00,675,903,501,402,141,261,2016-11-06 22:00:00,675,406,1323,498,1821,2227,2016-11-06 22:00:00,675,90537,90149
"3805",16223,2016-11-06 23:00:00,675,908,492,416,140,276,2016-11-06 23:00:00,675,320,1280,453,1733,2053,2016-11-06 23:00:00,675,87227,86832
"3806",16224,2016-11-07 00:00:00,676,828,458,370,136,234,2016-11-07 00:00:00,676,307,1227,455,1682,1989,2016-11-07 00:00:00,676,91886,91475
"3807",16225,2016-11-07 01:00:00,676,887,478,409,115,294,2016-11-07 01:00:00,676,228,1024,384,1408,1636,2016-11-07 01:00:00,676,97026,96621
"3808",16226,2016-11-07 02:00:00,676,783,444,339,97,242,2016-11-07 02:00:00,676,235,717,268,985,1220,2016-11-07 02:00:00,676,92961,92528
"3809",16227,2016-11-07 03:00:00,676,743,404,339,90,249,2016-11-07 03:00:00,676,188,440,162,602,790,2016-11-07 03:00:00,676,89072,88696
"3810",16228,2016-11-07 04:00:00,676,589,346,243,67,176,2016-11-07 04:00:00,676,125,272,95,367,492,2016-11-07 04:00:00,676,84945,84614
"3811",16229,2016-11-07 05:00:00,676,428,241,187,54,133,2016-11-07 05:00:00,676,83,185,72,257,340,2016-11-07 05:00:00,676,80093,79727
"3812",16230,2016-11-07 06:00:00,676,343,221,122,36,86,2016-11-07 06:00:00,676,83,111,44,155,238,2016-11-07 06:00:00,676,83869,83506
"3813",16231,2016-11-07 07:00:00,676,13,7,6,1,5,2016-11-07 07:00:00,676,61,46,15,61,122,2016-11-07 07:00:00,676,87033,86631
"3814",16232,2016-11-07 08:00:00,676,238,159,79,24,55,2016-11-07 08:00:00,676,39,43,24,67,106,2016-11-07 08:00:00,676,89166,88762
"3815",16233,2016-11-07 09:00:00,676,232,186,46,14,32,2016-11-07 09:00:00,676,20,27,10,37,57,2016-11-07 09:00:00,676,92352,91863
"3816",16234,2016-11-07 10:00:00,676,230,179,51,18,33,2016-11-07 10:00:00,676,39,26,12,38,77,2016-11-07 10:00:00,676,94629,94223
"3817",16235,2016-11-07 11:00:00,676,265,204,61,29,32,2016-11-07 11:00:00,676,56,75,41,116,172,2016-11-07 11:00:00,676,111363,110926
"3818",16236,2016-11-07 12:00:00,676,344,248,96,34,62,2016-11-07 12:00:00,676,108,190,103,293,401,2016-11-07 12:00:00,676,174181,173673
"3819",16237,2016-11-07 13:00:00,676,509,368,141,49,92,2016-11-07 13:00:00,676,247,413,209,622,869,2016-11-07 13:00:00,676,261204,260594
"3820",16238,2016-11-07 14:00:00,676,596,451,145,51,94,2016-11-07 14:00:00,676,411,672,335,1007,1418,2016-11-07 14:00:00,676,280419,279664
"3821",16239,2016-11-07 15:00:00,676,732,561,171,58,113,2016-11-07 15:00:00,676,576,732,349,1081,1657,2016-11-07 15:00:00,676,262241,261335
"3822",16240,2016-11-07 16:00:00,676,766,557,209,72,137,2016-11-07 16:00:00,676,613,801,380,1181,1794,2016-11-07 16:00:00,676,245719,244814
"3823",16241,2016-11-07 17:00:00,676,849,646,203,82,121,2016-11-07 17:00:00,676,692,892,410,1302,1994,2016-11-07 17:00:00,676,214452,213643
"3824",16242,2016-11-07 18:00:00,676,867,628,239,81,158,2016-11-07 18:00:00,676,692,897,439,1336,2028,2016-11-07 18:00:00,676,201776,200920
"3825",16243,2016-11-07 19:00:00,676,821,569,252,92,160,2016-11-07 19:00:00,676,713,986,426,1412,2125,2016-11-07 19:00:00,676,200584,199778
"3826",16244,2016-11-07 20:00:00,676,882,588,294,79,215,2016-11-07 20:00:00,676,689,1034,433,1467,2156,2016-11-07 20:00:00,676,184493,183745
"3827",16245,2016-11-07 21:00:00,676,890,541,349,122,227,2016-11-07 21:00:00,676,695,1151,485,1636,2331,2016-11-07 21:00:00,676,165600,164869
"3828",16246,2016-11-07 22:00:00,676,996,618,378,126,252,2016-11-07 22:00:00,676,587,1343,559,1902,2489,2016-11-07 22:00:00,676,137945,137389
"3829",16247,2016-11-07 23:00:00,676,915,549,366,125,241,2016-11-07 23:00:00,676,584,1422,594,2016,2600,2016-11-07 23:00:00,676,115500,115037
"3830",16248,2016-11-08 00:00:00,677,917,559,358,111,247,2016-11-08 00:00:00,677,472,1372,554,1926,2398,2016-11-08 00:00:00,677,106468,106002
"3831",16249,2016-11-08 01:00:00,677,919,564,355,115,240,2016-11-08 01:00:00,677,348,1173,470,1643,1991,2016-11-08 01:00:00,677,102935,102483
"3832",16250,2016-11-08 02:00:00,677,795,423,372,116,256,2016-11-08 02:00:00,677,364,950,352,1302,1666,2016-11-08 02:00:00,677,96691,96262
"3833",16251,2016-11-08 03:00:00,677,679,401,278,80,198,2016-11-08 03:00:00,677,257,655,236,891,1148,2016-11-08 03:00:00,677,90490,90102
"3834",16252,2016-11-08 04:00:00,677,545,339,206,70,136,2016-11-08 04:00:00,677,164,424,164,588,752,2016-11-08 04:00:00,677,83152,82765
"3835",16253,2016-11-08 05:00:00,677,505,304,201,64,137,2016-11-08 05:00:00,677,92,277,97,374,466,2016-11-08 05:00:00,677,79938,79549
"3836",16254,2016-11-08 06:00:00,677,361,228,133,34,99,2016-11-08 06:00:00,677,92,140,60,200,292,2016-11-08 06:00:00,677,80929,80536
"3837",16255,2016-11-08 07:00:00,677,281,190,91,31,60,2016-11-08 07:00:00,677,41,67,29,96,137,2016-11-08 07:00:00,677,83062,82617
"3838",16256,2016-11-08 08:00:00,677,238,172,66,24,42,2016-11-08 08:00:00,677,36,37,16,53,89,2016-11-08 08:00:00,677,86343,85893
"3839",16257,2016-11-08 09:00:00,677,231,179,52,20,32,2016-11-08 09:00:00,677,27,31,16,47,74,2016-11-08 09:00:00,677,89304,88864
"3840",16258,2016-11-08 10:00:00,677,264,218,46,20,26,2016-11-08 10:00:00,677,38,27,10,37,75,2016-11-08 10:00:00,677,89261,88785
"3841",16259,2016-11-08 11:00:00,677,287,227,60,23,37,2016-11-08 11:00:00,677,53,70,37,107,160,2016-11-08 11:00:00,677,94613,94182
"3842",16260,2016-11-08 12:00:00,677,337,247,90,32,58,2016-11-08 12:00:00,677,104,147,72,219,323,2016-11-08 12:00:00,677,119182,118694
"3843",16261,2016-11-08 13:00:00,677,469,321,148,49,99,2016-11-08 13:00:00,677,211,306,142,448,659,2016-11-08 13:00:00,677,158973,158411
"3844",16262,2016-11-08 14:00:00,677,581,421,160,69,91,2016-11-08 14:00:00,677,380,577,279,856,1236,2016-11-08 14:00:00,677,188059,187327
"3845",16263,2016-11-08 15:00:00,677,642,450,192,84,108,2016-11-08 15:00:00,677,478,764,311,1075,1553,2016-11-08 15:00:00,677,195010,194238
"3846",16264,2016-11-08 16:00:00,677,752,504,248,94,154,2016-11-08 16:00:00,677,601,831,368,1199,1800,2016-11-08 16:00:00,677,189441,188630
"3847",16265,2016-11-08 17:00:00,677,807,551,256,85,171,2016-11-08 17:00:00,677,606,949,436,1385,1991,2016-11-08 17:00:00,677,174335,173565
"3848",16266,2016-11-08 18:00:00,677,880,577,303,84,219,2016-11-08 18:00:00,677,679,986,397,1383,2062,2016-11-08 18:00:00,677,171309,170589
"3849",16267,2016-11-08 19:00:00,677,838,556,282,98,184,2016-11-08 19:00:00,677,655,1013,423,1436,2091,2016-11-08 19:00:00,677,171052,170307
"3850",16268,2016-11-08 20:00:00,677,866,536,330,107,223,2016-11-08 20:00:00,677,591,1072,451,1523,2114,2016-11-08 20:00:00,677,163652,162870
"3851",16269,2016-11-08 21:00:00,677,869,553,316,98,218,2016-11-08 21:00:00,677,591,1093,474,1567,2158,2016-11-08 21:00:00,677,152162,151494
"3852",16270,2016-11-08 22:00:00,677,881,556,325,107,218,2016-11-08 22:00:00,677,524,1161,456,1617,2141,2016-11-08 22:00:00,677,127375,126846
"3853",16271,2016-11-08 23:00:00,677,865,492,373,88,285,2016-11-08 23:00:00,677,482,1187,471,1658,2140,2016-11-08 23:00:00,677,107761,107271
"3854",16272,2016-11-09 00:00:00,678,813,465,348,102,246,2016-11-09 00:00:00,678,364,1073,438,1511,1875,2016-11-09 00:00:00,678,98659,98226
"3855",16273,2016-11-09 01:00:00,678,733,425,308,99,208,2016-11-09 01:00:00,678,319,915,340,1255,1574,2016-11-09 01:00:00,678,93908,93475
"3856",16274,2016-11-09 02:00:00,678,640,375,265,80,185,2016-11-09 02:00:00,678,247,754,280,1034,1281,2016-11-09 02:00:00,678,86903,86440
"3857",16275,2016-11-09 03:00:00,678,524,319,205,55,150,2016-11-09 03:00:00,678,194,497,201,698,892,2016-11-09 03:00:00,678,82247,81888
"3858",16276,2016-11-09 04:00:00,678,425,272,153,50,103,2016-11-09 04:00:00,678,157,333,125,458,615,2016-11-09 04:00:00,678,76111,75796
"3859",16277,2016-11-09 05:00:00,678,341,202,139,36,103,2016-11-09 05:00:00,678,131,183,67,250,381,2016-11-09 05:00:00,678,73245,72937
"3860",16278,2016-11-09 06:00:00,678,266,167,99,39,60,2016-11-09 06:00:00,678,89,97,35,132,221,2016-11-09 06:00:00,678,76915,76560
"3861",16279,2016-11-09 07:00:00,678,250,168,82,26,56,2016-11-09 07:00:00,678,61,56,20,76,137,2016-11-09 07:00:00,678,77727,77381
"3862",16280,2016-11-09 08:00:00,678,206,148,58,24,34,2016-11-09 08:00:00,678,41,34,13,47,88,2016-11-09 08:00:00,678,83928,83504
"3863",16281,2016-11-09 09:00:00,678,197,152,45,8,37,2016-11-09 09:00:00,678,41,25,7,32,73,2016-11-09 09:00:00,678,89049,88637
"3864",16282,2016-11-09 10:00:00,678,207,164,43,11,32,2016-11-09 10:00:00,678,29,31,15,46,75,2016-11-09 10:00:00,678,89260,88819
"3865",16283,2016-11-09 11:00:00,678,264,204,60,25,35,2016-11-09 11:00:00,678,59,54,27,81,140,2016-11-09 11:00:00,678,92706,92272
"3866",16284,2016-11-09 12:00:00,678,268,199,69,20,49,2016-11-09 12:00:00,678,122,129,65,194,316,2016-11-09 12:00:00,678,113843,113347
"3867",16285,2016-11-09 13:00:00,678,369,282,87,29,58,2016-11-09 13:00:00,678,235,249,141,390,625,2016-11-09 13:00:00,678,149820,149220
"3868",16286,2016-11-09 14:00:00,678,466,345,121,49,72,2016-11-09 14:00:00,678,372,437,221,658,1030,2016-11-09 14:00:00,678,180462,179773
"3869",16287,2016-11-09 15:00:00,678,546,414,132,44,88,2016-11-09 15:00:00,678,501,505,253,758,1259,2016-11-09 15:00:00,678,189939,189166
"3870",16288,2016-11-09 16:00:00,678,580,444,136,46,90,2016-11-09 16:00:00,678,427,606,288,894,1321,2016-11-09 16:00:00,678,186254,185478
"3871",16289,2016-11-09 17:00:00,678,710,502,208,72,136,2016-11-09 17:00:00,678,611,680,286,966,1577,2016-11-09 17:00:00,678,175799,175051
"3872",16290,2016-11-09 18:00:00,678,739,550,189,52,137,2016-11-09 18:00:00,678,609,725,315,1040,1649,2016-11-09 18:00:00,678,174317,173610
"3873",16291,2016-11-09 19:00:00,678,738,540,198,61,137,2016-11-09 19:00:00,678,755,834,370,1204,1959,2016-11-09 19:00:00,678,176560,175793
"3874",16292,2016-11-09 20:00:00,678,799,563,236,74,162,2016-11-09 20:00:00,678,701,976,404,1380,2081,2016-11-09 20:00:00,678,166358,165605
"3875",16293,2016-11-09 21:00:00,678,874,582,292,104,188,2016-11-09 21:00:00,678,701,1126,451,1577,2278,2016-11-09 21:00:00,678,152279,151608
"3876",16294,2016-11-09 22:00:00,678,856,557,299,103,196,2016-11-09 22:00:00,678,598,1134,497,1631,2229,2016-11-09 22:00:00,678,134652,134049
"3877",16295,2016-11-09 23:00:00,678,876,531,345,112,233,2016-11-09 23:00:00,678,522,1194,478,1672,2194,2016-11-09 23:00:00,678,116891,116453
"3878",16296,2016-11-10 00:00:00,679,808,491,317,109,208,2016-11-10 00:00:00,679,412,1150,487,1637,2049,2016-11-10 00:00:00,679,110541,110055
"3879",16297,2016-11-10 01:00:00,679,797,450,347,100,247,2016-11-10 01:00:00,679,389,1073,413,1486,1875,2016-11-10 01:00:00,679,109395,108950
"3880",16298,2016-11-10 02:00:00,679,714,439,275,62,213,2016-11-10 02:00:00,679,282,765,294,1059,1341,2016-11-10 02:00:00,679,103547,103084
"3881",16299,2016-11-10 03:00:00,679,660,391,269,83,186,2016-11-10 03:00:00,679,225,557,225,782,1007,2016-11-10 03:00:00,679,96363,95977
"3882",16300,2016-11-10 04:00:00,679,519,322,197,63,134,2016-11-10 04:00:00,679,171,391,139,530,701,2016-11-10 04:00:00,679,87604,87241
"3883",16301,2016-11-10 05:00:00,679,437,279,158,50,108,2016-11-10 05:00:00,679,133,284,99,383,516,2016-11-10 05:00:00,679,83582,83243
"3884",16302,2016-11-10 06:00:00,679,365,236,129,39,90,2016-11-10 06:00:00,679,82,160,65,225,307,2016-11-10 06:00:00,679,85288,84922
"3885",16303,2016-11-10 07:00:00,679,283,194,89,25,64,2016-11-10 07:00:00,679,64,75,23,98,162,2016-11-10 07:00:00,679,87702,87269
"3886",16304,2016-11-10 08:00:00,679,235,162,73,24,49,2016-11-10 08:00:00,679,46,40,19,59,105,2016-11-10 08:00:00,679,90302,89868
"3887",16305,2016-11-10 09:00:00,679,191,146,45,9,36,2016-11-10 09:00:00,679,39,32,16,48,87,2016-11-10 09:00:00,679,92649,92193
"3888",16306,2016-11-10 10:00:00,679,231,184,47,18,29,2016-11-10 10:00:00,679,27,27,12,39,66,2016-11-10 10:00:00,679,93280,92844
"3889",16307,2016-11-10 11:00:00,679,257,199,58,16,42,2016-11-10 11:00:00,679,63,70,31,101,164,2016-11-10 11:00:00,679,101762,101301
"3890",16308,2016-11-10 12:00:00,679,321,246,75,20,55,2016-11-10 12:00:00,679,126,147,77,224,350,2016-11-10 12:00:00,679,140338,139823
"3891",16309,2016-11-10 13:00:00,679,478,375,103,35,68,2016-11-10 13:00:00,679,298,280,135,415,713,2016-11-10 13:00:00,679,201800,201161
"3892",16310,2016-11-10 14:00:00,679,579,434,145,50,95,2016-11-10 14:00:00,679,473,529,249,778,1251,2016-11-10 14:00:00,679,236483,235668
"3893",16311,2016-11-10 15:00:00,679,592,464,128,41,87,2016-11-10 15:00:00,679,520,601,291,892,1412,2016-11-10 15:00:00,679,233562,232672
"3894",16312,2016-11-10 16:00:00,679,660,538,122,33,89,2016-11-10 16:00:00,679,642,684,301,985,1627,2016-11-10 16:00:00,679,225625,224787
"3895",16313,2016-11-10 17:00:00,679,756,566,190,65,125,2016-11-10 17:00:00,679,606,835,374,1209,1815,2016-11-10 17:00:00,679,202064,201223
"3896",16314,2016-11-10 18:00:00,679,739,569,170,57,113,2016-11-10 18:00:00,679,626,824,387,1211,1837,2016-11-10 18:00:00,679,196536,195697
"3897",16315,2016-11-10 19:00:00,679,758,539,219,56,163,2016-11-10 19:00:00,679,669,899,398,1297,1966,2016-11-10 19:00:00,679,193281,192439
"3898",16316,2016-11-10 20:00:00,679,892,629,263,93,169,2016-11-10 20:00:00,679,668,962,401,1363,2031,2016-11-10 20:00:00,679,179343,178603
"3899",16317,2016-11-10 21:00:00,679,838,581,257,79,178,2016-11-10 21:00:00,679,635,1145,464,1609,2244,2016-11-10 21:00:00,679,162061,161352
"3900",16318,2016-11-10 22:00:00,679,887,593,294,91,203,2016-11-10 22:00:00,679,546,1230,502,1732,2278,2016-11-10 22:00:00,679,137649,137121
"3901",16319,2016-11-10 23:00:00,679,841,522,319,89,230,2016-11-10 23:00:00,679,515,1220,465,1685,2200,2016-11-10 23:00:00,679,115051,114578
"3902",16320,2016-11-11 00:00:00,680,873,541,332,101,231,2016-11-11 00:00:00,680,485,1273,447,1720,2205,2016-11-11 00:00:00,680,106359,105924
"3903",16321,2016-11-11 01:00:00,680,848,517,331,89,242,2016-11-11 01:00:00,680,401,1107,420,1527,1928,2016-11-11 01:00:00,680,103704,103242
"3904",16322,2016-11-11 02:00:00,680,781,452,329,98,231,2016-11-11 02:00:00,680,326,1068,364,1432,1758,2016-11-11 02:00:00,680,95673,95194
"3905",16323,2016-11-11 03:00:00,680,723,408,315,99,216,2016-11-11 03:00:00,680,253,766,293,1059,1312,2016-11-11 03:00:00,680,89405,88979
"3906",16324,2016-11-11 04:00:00,680,590,353,237,56,181,2016-11-11 04:00:00,680,178,535,194,729,907,2016-11-11 04:00:00,680,80008,79677
"3907",16325,2016-11-11 05:00:00,680,514,286,228,69,159,2016-11-11 05:00:00,680,139,348,117,465,604,2016-11-11 05:00:00,680,74361,74024
"3908",16326,2016-11-11 06:00:00,680,419,246,173,47,126,2016-11-11 06:00:00,680,105,142,57,199,304,2016-11-11 06:00:00,680,76285,75965
"3909",16327,2016-11-11 07:00:00,680,313,183,130,41,89,2016-11-11 07:00:00,680,45,86,35,121,166,2016-11-11 07:00:00,680,76379,76018
"3910",16328,2016-11-11 08:00:00,680,278,185,93,30,63,2016-11-11 08:00:00,680,42,60,27,87,129,2016-11-11 08:00:00,680,77082,76707
"3911",16329,2016-11-11 09:00:00,680,227,164,63,22,41,2016-11-11 09:00:00,680,37,25,13,38,75,2016-11-11 09:00:00,680,80455,80069
"3912",16330,2016-11-11 10:00:00,680,242,186,56,19,37,2016-11-11 10:00:00,680,30,29,14,43,73,2016-11-11 10:00:00,680,79192,78822
"3913",16331,2016-11-11 11:00:00,680,264,201,63,21,42,2016-11-11 11:00:00,680,52,49,31,80,132,2016-11-11 11:00:00,680,86493,86087
"3914",16332,2016-11-11 12:00:00,680,320,234,86,19,65,2016-11-11 12:00:00,680,114,149,69,218,332,2016-11-11 12:00:00,680,111813,111380
"3915",16333,2016-11-11 13:00:00,680,478,346,132,53,78,2016-11-11 13:00:00,680,277,357,161,518,795,2016-11-11 13:00:00,680,150877,150348
"3916",16334,2016-11-11 14:00:00,680,630,444,186,75,111,2016-11-11 14:00:00,680,416,600,264,864,1280,2016-11-11 14:00:00,680,173021,172385
"3917",16335,2016-11-11 15:00:00,680,783,565,218,73,145,2016-11-11 15:00:00,680,561,806,347,1153,1714,2016-11-11 15:00:00,680,176304,175579
"3918",16336,2016-11-11 16:00:00,680,868,572,296,74,222,2016-11-11 16:00:00,680,635,879,361,1240,1875,2016-11-11 16:00:00,680,172530,171783
"3919",16337,2016-11-11 17:00:00,680,931,604,327,95,232,2016-11-11 17:00:00,680,610,1015,393,1408,2018,2016-11-11 17:00:00,680,157552,156902
"3920",16338,2016-11-11 18:00:00,680,914,626,288,99,189,2016-11-11 18:00:00,680,652,1043,425,1468,2120,2016-11-11 18:00:00,680,151941,151247
"3921",16339,2016-11-11 19:00:00,680,913,576,337,107,230,2016-11-11 19:00:00,680,657,990,406,1396,2053,2016-11-11 19:00:00,680,149999,149334
"3922",16340,2016-11-11 20:00:00,680,918,548,370,122,248,2016-11-11 20:00:00,680,650,1174,459,1633,2283,2016-11-11 20:00:00,680,139601,138956
"3923",16341,2016-11-11 21:00:00,680,951,573,378,112,266,2016-11-11 21:00:00,680,656,1205,438,1643,2299,2016-11-11 21:00:00,680,126351,125783
"3924",16342,2016-11-11 22:00:00,680,904,545,359,110,249,2016-11-11 22:00:00,680,489,1339,499,1838,2327,2016-11-11 22:00:00,680,108743,108258
"3925",16343,2016-11-11 23:00:00,680,877,532,345,103,242,2016-11-11 23:00:00,680,469,1304,498,1802,2271,2016-11-11 23:00:00,680,93150,92726
"3926",16344,2016-11-12 00:00:00,681,802,478,324,109,215,2016-11-12 00:00:00,681,415,1189,440,1629,2044,2016-11-12 00:00:00,681,84044,83713
"3927",16345,2016-11-12 01:00:00,681,794,455,339,121,218,2016-11-12 01:00:00,681,310,1122,401,1523,1833,2016-11-12 01:00:00,681,78779,78408
"3928",16346,2016-11-12 02:00:00,681,684,382,302,99,203,2016-11-12 02:00:00,681,277,1019,391,1410,1687,2016-11-12 02:00:00,681,74740,74391
"3929",16347,2016-11-12 03:00:00,681,617,409,208,69,139,2016-11-12 03:00:00,681,182,857,315,1172,1354,2016-11-12 03:00:00,681,73104,72764
"3930",16348,2016-11-12 04:00:00,681,443,360,83,27,56,2016-11-12 04:00:00,681,159,809,283,1092,1251,2016-11-12 04:00:00,681,70558,70217
"3931",16349,2016-11-12 05:00:00,681,348,341,7,2,5,2016-11-12 05:00:00,681,128,564,182,746,874,2016-11-12 05:00:00,681,64909,64623
"3932",16350,2016-11-12 06:00:00,681,322,286,36,17,19,2016-11-12 06:00:00,681,76,254,93,347,423,2016-11-12 06:00:00,681,61226,60947
"3933",16351,2016-11-12 07:00:00,681,287,212,75,23,52,2016-11-12 07:00:00,681,42,129,54,183,225,2016-11-12 07:00:00,681,58234,57952
"3934",16352,2016-11-12 08:00:00,681,294,191,103,43,60,2016-11-12 08:00:00,681,34,61,27,88,122,2016-11-12 08:00:00,681,56806,56548
"3935",16353,2016-11-12 09:00:00,681,272,162,110,32,78,2016-11-12 09:00:00,681,30,132,41,173,203,2016-11-12 09:00:00,681,58004,57725
"3936",16354,2016-11-12 10:00:00,681,228,158,70,13,57,2016-11-12 10:00:00,681,51,347,62,409,460,2016-11-12 10:00:00,681,60198,59925
"3937",16355,2016-11-12 11:00:00,681,321,207,114,26,88,2016-11-12 11:00:00,681,50,68,28,96,146,2016-11-12 11:00:00,681,64150,63841
"3938",16356,2016-11-12 12:00:00,681,284,205,79,22,57,2016-11-12 12:00:00,681,112,139,56,195,307,2016-11-12 12:00:00,681,73992,73685
"3939",16357,2016-11-12 13:00:00,681,427,294,133,37,96,2016-11-12 13:00:00,681,169,330,131,461,630,2016-11-12 13:00:00,681,86753,86384
"3940",16358,2016-11-12 14:00:00,681,606,367,239,61,178,2016-11-12 14:00:00,681,316,728,314,1042,1358,2016-11-12 14:00:00,681,98213,97795
"3941",16359,2016-11-12 15:00:00,681,809,491,318,98,219,2016-11-12 15:00:00,681,388,1024,414,1438,1826,2016-11-12 15:00:00,681,104655,104133
"3942",16360,2016-11-12 16:00:00,681,877,546,331,88,243,2016-11-12 16:00:00,681,432,1095,450,1545,1977,2016-11-12 16:00:00,681,106821,106287
"3943",16384,2016-11-13 16:00:00,682,833,471,362,116,246,2016-11-13 16:00:00,682,22,86,41,127,149,2016-11-13 16:00:00,682,98302,97840
"3944",16385,2016-11-13 17:00:00,682,936,521,415,124,291,2016-11-13 17:00:00,682,386,1168,454,1622,2008,2016-11-13 17:00:00,682,99478,99012
"3945",16386,2016-11-13 18:00:00,682,938,554,384,132,252,2016-11-13 18:00:00,682,360,1168,437,1605,1965,2016-11-13 18:00:00,682,97424,96940
"3946",16387,2016-11-13 19:00:00,682,984,539,445,140,305,2016-11-13 19:00:00,682,385,1135,440,1575,1960,2016-11-13 19:00:00,682,97791,97291
"3947",16388,2016-11-13 20:00:00,682,1051,567,484,143,341,2016-11-13 20:00:00,682,401,1104,424,1528,1929,2016-11-13 20:00:00,682,94392,93925
"3948",16389,2016-11-13 21:00:00,682,1005,549,456,156,300,2016-11-13 21:00:00,682,384,1080,434,1514,1898,2016-11-13 21:00:00,682,90521,90084
"3949",16390,2016-11-13 22:00:00,682,914,508,406,113,293,2016-11-13 22:00:00,682,339,1142,414,1556,1895,2016-11-13 22:00:00,682,87708,87279
"3950",16391,2016-11-13 23:00:00,682,877,505,372,115,257,2016-11-13 23:00:00,682,282,1052,388,1440,1722,2016-11-13 23:00:00,682,86646,86229
"3951",16392,2016-11-14 00:00:00,683,829,449,380,114,266,2016-11-14 00:00:00,683,282,1037,388,1425,1707,2016-11-14 00:00:00,683,89613,89233
"3952",16393,2016-11-14 01:00:00,683,990,553,437,148,289,2016-11-14 01:00:00,683,221,852,329,1181,1402,2016-11-14 01:00:00,683,96877,96478
"3953",16394,2016-11-14 02:00:00,683,906,501,405,114,291,2016-11-14 02:00:00,683,221,599,231,830,1051,2016-11-14 02:00:00,683,92765,92356
"3954",16395,2016-11-14 03:00:00,683,815,460,355,93,262,2016-11-14 03:00:00,683,187,426,160,586,773,2016-11-14 03:00:00,683,88623,88229
"3955",16396,2016-11-14 04:00:00,683,584,353,231,68,163,2016-11-14 04:00:00,683,152,341,136,477,629,2016-11-14 04:00:00,683,82669,82346
"3956",16397,2016-11-14 05:00:00,683,544,309,235,67,168,2016-11-14 05:00:00,683,98,205,83,288,386,2016-11-14 05:00:00,683,80158,79788
"3957",16398,2016-11-14 06:00:00,683,401,234,167,52,115,2016-11-14 06:00:00,683,70,105,42,147,217,2016-11-14 06:00:00,683,81923,81549
"3958",16399,2016-11-14 07:00:00,683,303,197,106,42,64,2016-11-14 07:00:00,683,37,55,28,83,120,2016-11-14 07:00:00,683,84987,84564
"3959",16400,2016-11-14 08:00:00,683,262,194,68,24,44,2016-11-14 08:00:00,683,41,33,15,48,89,2016-11-14 08:00:00,683,87044,86624
"3960",16401,2016-11-14 09:00:00,683,232,172,60,20,40,2016-11-14 09:00:00,683,39,24,11,35,74,2016-11-14 09:00:00,683,89662,89212
"3961",16402,2016-11-14 10:00:00,683,255,193,62,32,30,2016-11-14 10:00:00,683,42,30,10,40,82,2016-11-14 10:00:00,683,90722,90305
"3962",16403,2016-11-14 11:00:00,683,261,201,60,26,34,2016-11-14 11:00:00,683,39,70,35,105,144,2016-11-14 11:00:00,683,104271,103818
"3963",16404,2016-11-14 12:00:00,683,343,259,84,27,57,2016-11-14 12:00:00,683,127,132,63,195,322,2016-11-14 12:00:00,683,163793,163304
"3964",16405,2016-11-14 13:00:00,683,488,364,124,53,71,2016-11-14 13:00:00,683,275,367,191,558,833,2016-11-14 13:00:00,683,247903,247291
"3965",16406,2016-11-14 14:00:00,683,616,487,129,38,91,2016-11-14 14:00:00,683,406,595,301,896,1302,2016-11-14 14:00:00,683,272839,271964
"3966",16407,2016-11-14 15:00:00,683,696,525,171,61,110,2016-11-14 15:00:00,683,581,683,322,1005,1586,2016-11-14 15:00:00,683,255895,255021
"3967",16408,2016-11-14 16:00:00,683,800,585,215,67,148,2016-11-14 16:00:00,683,657,823,359,1182,1839,2016-11-14 16:00:00,683,242066,241182
"3968",16409,2016-11-14 17:00:00,683,853,636,217,62,155,2016-11-14 17:00:00,683,697,929,437,1366,2063,2016-11-14 17:00:00,683,211773,210914
"3969",16410,2016-11-14 18:00:00,683,879,642,237,80,157,2016-11-14 18:00:00,683,694,912,403,1315,2009,2016-11-14 18:00:00,683,199774,198930
"3970",16411,2016-11-14 19:00:00,683,816,570,246,76,169,2016-11-14 19:00:00,683,748,971,424,1395,2143,2016-11-14 19:00:00,683,194567,193754
"3971",16412,2016-11-14 20:00:00,683,857,616,241,79,162,2016-11-14 20:00:00,683,717,1111,480,1591,2308,2016-11-14 20:00:00,683,181294,180529
"3972",16413,2016-11-14 21:00:00,683,865,556,309,109,200,2016-11-14 21:00:00,683,682,1272,518,1790,2472,2016-11-14 21:00:00,683,163406,162731
"3973",16414,2016-11-14 22:00:00,683,876,535,341,110,231,2016-11-14 22:00:00,683,552,1481,650,2131,2683,2016-11-14 22:00:00,683,136475,135901
"3974",16415,2016-11-14 23:00:00,683,921,551,370,91,278,2016-11-14 23:00:00,683,554,1459,583,2042,2596,2016-11-14 23:00:00,683,109702,109247
"3975",16416,2016-11-15 00:00:00,684,928,551,377,109,268,2016-11-15 00:00:00,684,501,1316,484,1800,2301,2016-11-15 00:00:00,684,105952,105510
"3976",16417,2016-11-15 01:00:00,684,956,584,372,110,262,2016-11-15 01:00:00,684,403,1148,458,1606,2009,2016-11-15 01:00:00,684,101788,101313
"3977",16418,2016-11-15 02:00:00,684,801,483,318,69,249,2016-11-15 02:00:00,684,324,870,345,1215,1539,2016-11-15 02:00:00,684,96541,96083
"3978",16419,2016-11-15 03:00:00,684,715,446,269,73,196,2016-11-15 03:00:00,684,284,613,240,853,1137,2016-11-15 03:00:00,684,90750,90324
"3979",16420,2016-11-15 04:00:00,684,561,347,214,61,153,2016-11-15 04:00:00,684,190,387,148,535,725,2016-11-15 04:00:00,684,84095,83759
"3980",16421,2016-11-15 05:00:00,684,528,296,232,68,164,2016-11-15 05:00:00,684,119,295,101,396,515,2016-11-15 05:00:00,684,76758,76388
"3981",16422,2016-11-15 06:00:00,684,405,261,144,46,98,2016-11-15 06:00:00,684,84,152,46,198,282,2016-11-15 06:00:00,684,74847,74494
"3982",16423,2016-11-15 07:00:00,684,293,189,104,28,76,2016-11-15 07:00:00,684,53,87,39,126,179,2016-11-15 07:00:00,684,77103,76745
"3983",16424,2016-11-15 08:00:00,684,249,178,71,24,47,2016-11-15 08:00:00,684,57,48,11,59,116,2016-11-15 08:00:00,684,80932,80496
"3984",16425,2016-11-15 09:00:00,684,282,210,72,13,59,2016-11-15 09:00:00,684,26,30,14,44,70,2016-11-15 09:00:00,684,83124,82720
"3985",16426,2016-11-15 10:00:00,684,265,205,60,23,37,2016-11-15 10:00:00,684,26,23,8,31,57,2016-11-15 10:00:00,684,82314,81899
"3986",16427,2016-11-15 11:00:00,684,253,202,51,21,30,2016-11-15 11:00:00,684,54,42,20,62,116,2016-11-15 11:00:00,684,86586,86201
"3987",16428,2016-11-15 12:00:00,684,336,246,90,19,71,2016-11-15 12:00:00,684,88,137,68,205,293,2016-11-15 12:00:00,684,110064,109613
"3988",16429,2016-11-15 13:00:00,684,473,345,128,48,80,2016-11-15 13:00:00,684,240,340,178,518,758,2016-11-15 13:00:00,684,153127,152518
"3989",16430,2016-11-15 14:00:00,684,553,425,128,44,84,2016-11-15 14:00:00,684,451,528,244,772,1223,2016-11-15 14:00:00,684,183532,182808
"3990",16431,2016-11-15 15:00:00,684,680,527,153,45,108,2016-11-15 15:00:00,684,583,632,314,946,1529,2016-11-15 15:00:00,684,189939,189173
"3991",16432,2016-11-15 16:00:00,684,713,534,179,56,123,2016-11-15 16:00:00,684,599,709,304,1013,1612,2016-11-15 16:00:00,684,177651,176885
"3992",16433,2016-11-15 17:00:00,684,737,531,206,66,140,2016-11-15 17:00:00,684,669,802,384,1186,1855,2016-11-15 17:00:00,684,177232,176515
"3993",16434,2016-11-15 18:00:00,684,824,559,265,53,212,2016-11-15 18:00:00,684,667,828,348,1176,1843,2016-11-15 18:00:00,684,179252,178472
"3994",16435,2016-11-15 19:00:00,684,817,587,230,70,160,2016-11-15 19:00:00,684,659,902,399,1301,1960,2016-11-15 19:00:00,684,178776,178012
"3995",16436,2016-11-15 20:00:00,684,843,567,276,77,199,2016-11-15 20:00:00,684,668,1023,417,1440,2108,2016-11-15 20:00:00,684,167190,166401
"3996",16437,2016-11-15 21:00:00,684,952,603,349,95,254,2016-11-15 21:00:00,684,697,1270,520,1790,2487,2016-11-15 21:00:00,684,152646,151940
"3997",16438,2016-11-15 22:00:00,684,957,577,380,112,268,2016-11-15 22:00:00,684,559,1365,495,1860,2419,2016-11-15 22:00:00,684,128951,128393
"3998",16439,2016-11-15 23:00:00,684,931,590,341,93,248,2016-11-15 23:00:00,684,541,1402,523,1925,2466,2016-11-15 23:00:00,684,108868,108389
"3999",16440,2016-11-16 00:00:00,685,851,496,355,92,263,2016-11-16 00:00:00,685,454,1338,517,1855,2309,2016-11-16 00:00:00,685,100032,99644
"4000",16441,2016-11-16 01:00:00,685,1029,624,405,100,305,2016-11-16 01:00:00,685,376,1432,575,2007,2383,2016-11-16 01:00:00,685,98901,98465
"4001",16442,2016-11-16 02:00:00,685,851,505,346,107,239,2016-11-16 02:00:00,685,309,1012,393,1405,1714,2016-11-16 02:00:00,685,98349,97937
"4002",16443,2016-11-16 03:00:00,685,736,467,269,82,187,2016-11-16 03:00:00,685,240,719,262,981,1221,2016-11-16 03:00:00,685,94539,94092
"4003",16444,2016-11-16 04:00:00,685,576,355,221,73,148,2016-11-16 04:00:00,685,185,504,168,672,857,2016-11-16 04:00:00,685,88958,88589
"4004",16445,2016-11-16 05:00:00,685,489,292,197,51,146,2016-11-16 05:00:00,685,153,279,104,383,536,2016-11-16 05:00:00,685,83198,82857
"4005",16446,2016-11-16 06:00:00,685,372,229,143,38,105,2016-11-16 06:00:00,685,77,174,67,241,318,2016-11-16 06:00:00,685,84970,84600
"4006",16447,2016-11-16 07:00:00,685,309,211,98,30,68,2016-11-16 07:00:00,685,61,71,26,97,158,2016-11-16 07:00:00,685,86311,85863
"4007",16448,2016-11-16 08:00:00,685,289,213,76,22,54,2016-11-16 08:00:00,685,38,35,16,51,89,2016-11-16 08:00:00,685,89275,88857
"4008",16449,2016-11-16 09:00:00,685,271,209,62,21,41,2016-11-16 09:00:00,685,35,34,8,42,77,2016-11-16 09:00:00,685,92606,92161
"4009",16450,2016-11-16 10:00:00,685,280,220,60,16,44,2016-11-16 10:00:00,685,38,39,11,50,88,2016-11-16 10:00:00,685,92713,92260
"4010",16451,2016-11-16 11:00:00,685,283,220,63,23,40,2016-11-16 11:00:00,685,57,57,26,83,140,2016-11-16 11:00:00,685,96894,96482
"4011",16452,2016-11-16 12:00:00,685,306,234,72,21,51,2016-11-16 12:00:00,685,122,152,80,232,354,2016-11-16 12:00:00,685,120918,120450
"4012",16453,2016-11-16 13:00:00,685,467,356,111,38,73,2016-11-16 13:00:00,685,271,294,143,437,708,2016-11-16 13:00:00,685,162723,162146
"4013",16454,2016-11-16 14:00:00,685,560,437,123,35,88,2016-11-16 14:00:00,685,430,533,263,796,1226,2016-11-16 14:00:00,685,194962,194218
"4014",16455,2016-11-16 15:00:00,685,681,538,143,45,98,2016-11-16 15:00:00,685,514,578,283,861,1375,2016-11-16 15:00:00,685,204385,203550
"4015",16456,2016-11-16 16:00:00,685,784,608,176,53,123,2016-11-16 16:00:00,685,586,686,320,1006,1592,2016-11-16 16:00:00,685,202211,201336
"4016",16457,2016-11-16 17:00:00,685,818,630,188,51,137,2016-11-16 17:00:00,685,708,831,359,1190,1898,2016-11-16 17:00:00,685,186131,185326
"4017",16458,2016-11-16 18:00:00,685,789,560,229,63,166,2016-11-16 18:00:00,685,682,795,344,1139,1821,2016-11-16 18:00:00,685,180775,180021
"4018",16459,2016-11-16 19:00:00,685,804,561,243,79,164,2016-11-16 19:00:00,685,662,887,387,1274,1936,2016-11-16 19:00:00,685,181633,180839
"4019",16460,2016-11-16 20:00:00,685,904,603,301,75,226,2016-11-16 20:00:00,685,667,1000,401,1401,2068,2016-11-16 20:00:00,685,171915,171175
"4020",16461,2016-11-16 21:00:00,685,930,610,320,89,231,2016-11-16 21:00:00,685,719,1192,452,1644,2363,2016-11-16 21:00:00,685,156183,155553
"4021",16462,2016-11-16 22:00:00,685,992,575,417,102,315,2016-11-16 22:00:00,685,664,1291,509,1800,2464,2016-11-16 22:00:00,685,132889,132325
"4022",16463,2016-11-16 23:00:00,685,1017,620,397,101,296,2016-11-16 23:00:00,685,460,1375,514,1889,2349,2016-11-16 23:00:00,685,115003,114486
"4023",16464,2016-11-17 00:00:00,686,957,558,399,82,317,2016-11-17 00:00:00,686,429,1215,467,1682,2111,2016-11-17 00:00:00,686,109123,108652
"4024",16465,2016-11-17 01:00:00,686,909,542,367,91,276,2016-11-17 01:00:00,686,383,1167,407,1574,1957,2016-11-17 01:00:00,686,108161,107707
"4025",16466,2016-11-17 02:00:00,686,879,518,361,104,257,2016-11-17 02:00:00,686,314,962,331,1293,1607,2016-11-17 02:00:00,686,101981,101518
"4026",16467,2016-11-17 03:00:00,686,721,432,289,93,196,2016-11-17 03:00:00,686,240,638,224,862,1102,2016-11-17 03:00:00,686,96131,95712
"4027",16468,2016-11-17 04:00:00,686,604,349,255,65,190,2016-11-17 04:00:00,686,220,368,125,493,713,2016-11-17 04:00:00,686,90665,90274
"4028",16469,2016-11-17 05:00:00,686,510,291,219,37,182,2016-11-17 05:00:00,686,122,265,80,345,467,2016-11-17 05:00:00,686,85480,85114
"4029",16470,2016-11-17 06:00:00,686,353,208,145,32,113,2016-11-17 06:00:00,686,111,141,53,194,305,2016-11-17 06:00:00,686,86796,86410
"4030",16471,2016-11-17 07:00:00,686,300,207,93,29,64,2016-11-17 07:00:00,686,61,73,35,108,169,2016-11-17 07:00:00,686,89840,89392
"4031",16472,2016-11-17 08:00:00,686,280,197,83,17,66,2016-11-17 08:00:00,686,30,47,15,62,92,2016-11-17 08:00:00,686,91012,90578
"4032",16473,2016-11-17 09:00:00,686,257,183,74,22,52,2016-11-17 09:00:00,686,44,29,12,41,85,2016-11-17 09:00:00,686,94040,93584
"4033",16474,2016-11-17 10:00:00,686,263,197,66,21,45,2016-11-17 10:00:00,686,42,38,19,57,99,2016-11-17 10:00:00,686,94316,93877
"4034",16475,2016-11-17 11:00:00,686,315,235,80,26,54,2016-11-17 11:00:00,686,59,51,30,81,140,2016-11-17 11:00:00,686,103625,103158
"4035",16476,2016-11-17 12:00:00,686,350,281,69,19,50,2016-11-17 12:00:00,686,104,166,93,259,363,2016-11-17 12:00:00,686,147579,147109
"4036",16477,2016-11-17 13:00:00,686,452,354,98,41,57,2016-11-17 13:00:00,686,259,250,125,375,634,2016-11-17 13:00:00,686,219507,218881
"4037",16478,2016-11-17 14:00:00,686,558,456,102,35,67,2016-11-17 14:00:00,686,407,489,238,727,1134,2016-11-17 14:00:00,686,255671,254889
"4038",16479,2016-11-17 15:00:00,686,630,487,143,42,101,2016-11-17 15:00:00,686,499,559,272,831,1330,2016-11-17 15:00:00,686,253165,252338
"4039",16480,2016-11-17 16:00:00,686,758,587,171,71,100,2016-11-17 16:00:00,686,622,678,310,988,1610,2016-11-17 16:00:00,686,244640,243795
"4040",16481,2016-11-17 17:00:00,686,794,588,206,64,142,2016-11-17 17:00:00,686,559,749,370,1119,1678,2016-11-17 17:00:00,686,218881,218153
"4041",16482,2016-11-17 18:00:00,686,857,642,215,65,150,2016-11-17 18:00:00,686,685,674,325,999,1684,2016-11-17 18:00:00,686,209763,208989
"4042",16483,2016-11-17 19:00:00,686,816,604,212,65,147,2016-11-17 19:00:00,686,666,820,340,1160,1826,2016-11-17 19:00:00,686,207958,207184
"4043",16484,2016-11-17 20:00:00,686,909,649,260,71,189,2016-11-17 20:00:00,686,642,963,436,1399,2041,2016-11-17 20:00:00,686,193338,192611
"4044",16485,2016-11-17 21:00:00,686,811,553,258,96,162,2016-11-17 21:00:00,686,664,1089,482,1571,2235,2016-11-17 21:00:00,686,174659,173974
"4045",16486,2016-11-17 22:00:00,686,849,546,303,79,224,2016-11-17 22:00:00,686,572,1163,502,1665,2237,2016-11-17 22:00:00,686,143078,142555
"4046",16487,2016-11-17 23:00:00,686,796,498,298,99,199,2016-11-17 23:00:00,686,499,1189,445,1634,2133,2016-11-17 23:00:00,686,118149,117714
"4047",16488,2016-11-18 00:00:00,687,782,464,318,119,199,2016-11-18 00:00:00,687,476,1140,460,1600,2076,2016-11-18 00:00:00,687,109616,109189
"4048",16489,2016-11-18 01:00:00,687,859,520,339,104,235,2016-11-18 01:00:00,687,371,1057,426,1483,1854,2016-11-18 01:00:00,687,105394,104958
"4049",16490,2016-11-18 02:00:00,687,815,512,303,88,215,2016-11-18 02:00:00,687,281,814,327,1141,1422,2016-11-18 02:00:00,687,97538,97114
"4050",16491,2016-11-18 03:00:00,687,734,489,245,75,170,2016-11-18 03:00:00,687,211,565,209,774,985,2016-11-18 03:00:00,687,92463,92058
"4051",16492,2016-11-18 04:00:00,687,590,379,211,69,142,2016-11-18 04:00:00,687,181,443,192,635,816,2016-11-18 04:00:00,687,83704,83397
"4052",16493,2016-11-18 05:00:00,687,519,301,218,64,154,2016-11-18 05:00:00,687,132,267,93,360,492,2016-11-18 05:00:00,687,77405,77090
"4053",16494,2016-11-18 06:00:00,687,391,245,146,39,107,2016-11-18 06:00:00,687,71,126,46,172,243,2016-11-18 06:00:00,687,78796,78438
"4054",16495,2016-11-18 07:00:00,687,300,206,94,31,63,2016-11-18 07:00:00,687,44,76,31,107,151,2016-11-18 07:00:00,687,80412,80030
"4055",16496,2016-11-18 08:00:00,687,295,205,90,29,61,2016-11-18 08:00:00,687,35,57,24,81,116,2016-11-18 08:00:00,687,80318,79935
"4056",16497,2016-11-18 09:00:00,687,258,182,76,28,48,2016-11-18 09:00:00,687,31,21,9,30,61,2016-11-18 09:00:00,687,83804,83409
"4057",16498,2016-11-18 10:00:00,687,298,227,71,30,41,2016-11-18 10:00:00,687,39,35,16,51,90,2016-11-18 10:00:00,687,85520,85075
"4058",16499,2016-11-18 11:00:00,687,322,246,76,32,43,2016-11-18 11:00:00,687,62,48,24,72,134,2016-11-18 11:00:00,687,93831,93433
"4059",16500,2016-11-18 12:00:00,687,329,252,77,32,45,2016-11-18 12:00:00,687,121,152,88,240,361,2016-11-18 12:00:00,687,131651,131244
"4060",16501,2016-11-18 13:00:00,687,484,344,140,49,91,2016-11-18 13:00:00,687,236,332,174,506,742,2016-11-18 13:00:00,687,188298,187742
"4061",16502,2016-11-18 14:00:00,687,574,432,142,49,93,2016-11-18 14:00:00,687,366,522,277,799,1165,2016-11-18 14:00:00,687,216029,215305
"4062",16503,2016-11-18 15:00:00,687,662,485,177,64,113,2016-11-18 15:00:00,687,458,626,343,969,1427,2016-11-18 15:00:00,687,214917,214102
"4063",16504,2016-11-18 16:00:00,687,700,510,190,74,116,2016-11-18 16:00:00,687,573,738,364,1102,1675,2016-11-18 16:00:00,687,209006,208234
"4064",16505,2016-11-18 17:00:00,687,831,584,247,83,164,2016-11-18 17:00:00,687,572,782,345,1127,1699,2016-11-18 17:00:00,687,186215,185509
"4065",16506,2016-11-18 18:00:00,687,819,603,216,74,142,2016-11-18 18:00:00,687,624,826,382,1208,1832,2016-11-18 18:00:00,687,178570,177848
"4066",16507,2016-11-18 19:00:00,687,782,571,211,84,127,2016-11-18 19:00:00,687,620,895,386,1281,1901,2016-11-18 19:00:00,687,175499,174785
"4067",16508,2016-11-18 20:00:00,687,816,535,281,102,179,2016-11-18 20:00:00,687,626,1006,458,1464,2090,2016-11-18 20:00:00,687,165782,165120
"4068",16509,2016-11-18 21:00:00,687,858,559,299,103,196,2016-11-18 21:00:00,687,627,1197,466,1663,2290,2016-11-18 21:00:00,687,145585,145008
"4069",16510,2016-11-18 22:00:00,687,868,562,306,101,205,2016-11-18 22:00:00,687,515,1278,478,1756,2271,2016-11-18 22:00:00,687,114707,114265
"4070",16511,2016-11-18 23:00:00,687,845,535,310,95,215,2016-11-18 23:00:00,687,454,1346,530,1876,2330,2016-11-18 23:00:00,687,60921,60896
"4071",16512,2016-11-19 00:00:00,688,881,524,357,125,232,2016-11-19 00:00:00,688,352,1263,508,1771,2123,2016-11-19 00:00:00,688,44808,44806
"4072",16513,2016-11-19 01:00:00,688,806,433,373,107,266,2016-11-19 01:00:00,688,322,1233,460,1693,2015,2016-11-19 01:00:00,688,81962,81594
"4073",16514,2016-11-19 02:00:00,688,784,442,342,92,250,2016-11-19 02:00:00,688,291,1062,401,1463,1754,2016-11-19 02:00:00,688,78311,77939
"4074",16515,2016-11-19 03:00:00,688,779,415,364,112,252,2016-11-19 03:00:00,688,195,823,324,1147,1342,2016-11-19 03:00:00,688,75734,75415
"4075",16516,2016-11-19 04:00:00,688,680,380,300,106,194,2016-11-19 04:00:00,688,164,653,244,897,1061,2016-11-19 04:00:00,688,72907,72590
"4076",16517,2016-11-19 05:00:00,688,619,342,277,93,184,2016-11-19 05:00:00,688,127,420,146,566,693,2016-11-19 05:00:00,688,68064,67752
"4077",16518,2016-11-19 06:00:00,688,461,270,191,64,127,2016-11-19 06:00:00,688,83,241,88,329,412,2016-11-19 06:00:00,688,64227,63921
"4078",16519,2016-11-19 07:00:00,688,353,207,146,47,99,2016-11-19 07:00:00,688,69,132,39,171,240,2016-11-19 07:00:00,688,61386,61097
"4079",16520,2016-11-19 08:00:00,688,280,177,103,32,71,2016-11-19 08:00:00,688,42,65,25,90,132,2016-11-19 08:00:00,688,59054,58772
"4080",16521,2016-11-19 09:00:00,688,254,188,66,19,47,2016-11-19 09:00:00,688,29,46,22,68,97,2016-11-19 09:00:00,688,60042,59785
"4081",16522,2016-11-19 10:00:00,688,248,186,62,18,44,2016-11-19 10:00:00,688,38,40,18,58,96,2016-11-19 10:00:00,688,61779,61536
"4082",16523,2016-11-19 11:00:00,688,265,184,81,31,50,2016-11-19 11:00:00,688,37,47,17,64,101,2016-11-19 11:00:00,688,65884,65639
"4083",16524,2016-11-19 12:00:00,688,325,239,86,27,59,2016-11-19 12:00:00,688,91,162,65,227,318,2016-11-19 12:00:00,688,75786,75485
"4084",16525,2016-11-19 13:00:00,688,485,328,157,52,105,2016-11-19 13:00:00,688,183,296,136,432,615,2016-11-19 13:00:00,688,88039,87696
"4085",16526,2016-11-19 14:00:00,688,683,439,244,75,169,2016-11-19 14:00:00,688,228,683,317,1000,1228,2016-11-19 14:00:00,688,99241,98866
"4086",16527,2016-11-19 15:00:00,688,717,445,272,105,167,2016-11-19 15:00:00,688,336,978,390,1368,1704,2016-11-19 15:00:00,688,106653,106194
"4087",16528,2016-11-19 16:00:00,688,832,523,309,109,200,2016-11-19 16:00:00,688,377,992,401,1393,1770,2016-11-19 16:00:00,688,108393,107918
"4088",16529,2016-11-19 17:00:00,688,932,576,356,131,225,2016-11-19 17:00:00,688,413,1064,420,1484,1897,2016-11-19 17:00:00,688,104733,104267
"4089",16530,2016-11-19 18:00:00,688,943,580,363,125,238,2016-11-19 18:00:00,688,468,1108,444,1552,2020,2016-11-19 18:00:00,688,100977,100497
"4090",16531,2016-11-19 19:00:00,688,953,555,398,136,262,2016-11-19 19:00:00,688,497,1143,462,1605,2102,2016-11-19 19:00:00,688,98098,97606
"4091",16532,2016-11-19 20:00:00,688,930,496,434,122,312,2016-11-19 20:00:00,688,440,1115,428,1543,1983,2016-11-19 20:00:00,688,93194,92766
"4092",16533,2016-11-19 21:00:00,688,955,493,462,133,329,2016-11-19 21:00:00,688,413,1137,446,1583,1996,2016-11-19 21:00:00,688,87800,87371
"4093",16534,2016-11-19 22:00:00,688,1063,559,504,159,345,2016-11-19 22:00:00,688,409,1210,493,1703,2112,2016-11-19 22:00:00,688,82217,81825
"4094",16535,2016-11-19 23:00:00,688,1031,522,509,152,357,2016-11-19 23:00:00,688,347,1143,436,1579,1926,2016-11-19 23:00:00,688,76090,75716
"4095",16536,2016-11-20 00:00:00,689,991,516,475,143,332,2016-11-20 00:00:00,689,339,1135,455,1590,1929,2016-11-20 00:00:00,689,73560,73227
"4096",16537,2016-11-20 01:00:00,689,973,549,424,123,301,2016-11-20 01:00:00,689,262,1024,368,1392,1654,2016-11-20 01:00:00,689,72936,72618
"4097",16538,2016-11-20 02:00:00,689,897,507,390,93,297,2016-11-20 02:00:00,689,251,936,361,1297,1548,2016-11-20 02:00:00,689,71871,71539
"4098",16539,2016-11-20 03:00:00,689,763,429,334,93,241,2016-11-20 03:00:00,689,167,690,252,942,1109,2016-11-20 03:00:00,689,73298,72985
"4099",16540,2016-11-20 04:00:00,689,703,365,338,104,234,2016-11-20 04:00:00,689,166,491,191,682,848,2016-11-20 04:00:00,689,73079,72783
"4100",16541,2016-11-20 05:00:00,689,584,302,282,89,193,2016-11-20 05:00:00,689,95,322,112,434,529,2016-11-20 05:00:00,689,68727,68406
"4101",16542,2016-11-20 06:00:00,689,473,274,199,70,129,2016-11-20 06:00:00,689,87,181,55,236,323,2016-11-20 06:00:00,689,64004,63737
"4102",16543,2016-11-20 07:00:00,689,359,225,134,51,83,2016-11-20 07:00:00,689,70,118,51,169,239,2016-11-20 07:00:00,689,60559,60308
"4103",16544,2016-11-20 08:00:00,689,317,190,127,40,87,2016-11-20 08:00:00,689,39,80,32,112,151,2016-11-20 08:00:00,689,59887,59638
"4104",16545,2016-11-20 09:00:00,689,248,179,69,29,40,2016-11-20 09:00:00,689,25,47,26,73,98,2016-11-20 09:00:00,689,59740,59467
"4105",16546,2016-11-20 10:00:00,689,283,205,78,28,50,2016-11-20 10:00:00,689,33,33,11,44,77,2016-11-20 10:00:00,689,60811,60557
"4106",16547,2016-11-20 11:00:00,689,268,176,92,30,62,2016-11-20 11:00:00,689,34,32,16,48,82,2016-11-20 11:00:00,689,66003,65707
"4107",16548,2016-11-20 12:00:00,689,307,215,92,29,63,2016-11-20 12:00:00,689,64,118,57,175,239,2016-11-20 12:00:00,689,73711,73391
"4108",16549,2016-11-20 13:00:00,689,506,352,154,45,109,2016-11-20 13:00:00,689,142,246,118,364,506,2016-11-20 13:00:00,689,84995,84650
"4109",16550,2016-11-20 14:00:00,689,675,414,261,81,180,2016-11-20 14:00:00,689,220,558,226,784,1004,2016-11-20 14:00:00,689,93104,92693
"4110",16551,2016-11-20 15:00:00,689,689,453,236,88,148,2016-11-20 15:00:00,689,263,761,321,1082,1345,2016-11-20 15:00:00,689,99556,99098
"4111",16552,2016-11-20 16:00:00,689,816,528,288,96,192,2016-11-20 16:00:00,689,311,993,408,1401,1712,2016-11-20 16:00:00,689,103499,103031
"4112",16553,2016-11-20 17:00:00,689,939,596,343,113,230,2016-11-20 17:00:00,689,335,1029,391,1420,1755,2016-11-20 17:00:00,689,104148,103674
"4113",16554,2016-11-20 18:00:00,689,935,585,350,115,235,2016-11-20 18:00:00,689,389,1068,422,1490,1879,2016-11-20 18:00:00,689,102470,102016
"4114",16555,2016-11-20 19:00:00,689,918,575,343,104,239,2016-11-20 19:00:00,689,377,1218,479,1697,2074,2016-11-20 19:00:00,689,100703,100266
"4115",16556,2016-11-20 20:00:00,689,895,551,344,121,223,2016-11-20 20:00:00,689,402,1141,405,1546,1948,2016-11-20 20:00:00,689,97988,97530
"4116",16557,2016-11-20 21:00:00,689,879,546,333,100,233,2016-11-20 21:00:00,689,367,1250,455,1705,2072,2016-11-20 21:00:00,689,94834,94397
"4117",16558,2016-11-20 22:00:00,689,875,557,318,130,188,2016-11-20 22:00:00,689,329,1234,430,1664,1993,2016-11-20 22:00:00,689,92429,92001
"4118",16559,2016-11-20 23:00:00,689,839,496,343,120,223,2016-11-20 23:00:00,689,314,1112,416,1528,1842,2016-11-20 23:00:00,689,88397,88011
"4119",16560,2016-11-21 00:00:00,690,850,476,374,137,237,2016-11-21 00:00:00,690,294,1060,396,1456,1750,2016-11-21 00:00:00,690,96837,96435
"4120",16561,2016-11-21 01:00:00,690,1128,638,490,149,341,2016-11-21 01:00:00,690,298,935,340,1275,1573,2016-11-21 01:00:00,690,106358,105971
"4121",16562,2016-11-21 02:00:00,690,929,541,388,124,264,2016-11-21 02:00:00,690,235,746,276,1022,1257,2016-11-21 02:00:00,690,99621,99186
"4122",16563,2016-11-21 03:00:00,690,837,484,353,99,254,2016-11-21 03:00:00,690,172,538,200,738,910,2016-11-21 03:00:00,690,96772,96376
"4123",16564,2016-11-21 04:00:00,690,741,432,309,103,206,2016-11-21 04:00:00,690,129,357,145,502,631,2016-11-21 04:00:00,690,93503,93140
"4124",16565,2016-11-21 05:00:00,690,584,337,247,75,172,2016-11-21 05:00:00,690,105,193,74,267,372,2016-11-21 05:00:00,690,90150,89816
"4125",16566,2016-11-21 06:00:00,690,414,274,140,45,95,2016-11-21 06:00:00,690,82,120,46,166,248,2016-11-21 06:00:00,690,93504,93110
"4126",16567,2016-11-21 07:00:00,690,371,247,124,38,86,2016-11-21 07:00:00,690,48,52,22,74,122,2016-11-21 07:00:00,690,95126,94722
"4127",16568,2016-11-21 08:00:00,690,261,186,75,23,52,2016-11-21 08:00:00,690,36,34,15,49,85,2016-11-21 08:00:00,690,96314,95875
"4128",16569,2016-11-21 09:00:00,690,272,206,66,29,37,2016-11-21 09:00:00,690,38,30,17,47,85,2016-11-21 09:00:00,690,99405,98960
"4129",16570,2016-11-21 10:00:00,690,290,222,68,32,36,2016-11-21 10:00:00,690,43,33,11,44,87,2016-11-21 10:00:00,690,101570,101148
"4130",16571,2016-11-21 11:00:00,690,331,257,74,28,46,2016-11-21 11:00:00,690,57,50,24,74,131,2016-11-21 11:00:00,690,120842,120420
"4131",16572,2016-11-21 12:00:00,690,394,323,71,29,42,2016-11-21 12:00:00,690,100,141,67,208,308,2016-11-21 12:00:00,690,195386,194912
"4132",16573,2016-11-21 13:00:00,690,529,421,108,48,60,2016-11-21 13:00:00,690,237,320,175,495,732,2016-11-21 13:00:00,690,294126,293487
"4133",16574,2016-11-21 14:00:00,690,625,487,138,48,90,2016-11-21 14:00:00,690,481,584,290,874,1355,2016-11-21 14:00:00,690,314279,313494
"4134",16575,2016-11-21 15:00:00,690,795,595,200,62,138,2016-11-21 15:00:00,690,524,735,353,1088,1612,2016-11-21 15:00:00,690,286096,285233
"4135",16576,2016-11-21 16:00:00,690,877,652,225,77,148,2016-11-21 16:00:00,690,699,844,373,1217,1916,2016-11-21 16:00:00,690,262542,261674
"4136",16577,2016-11-21 17:00:00,690,924,656,268,94,174,2016-11-21 17:00:00,690,619,1028,452,1480,2099,2016-11-21 17:00:00,690,227512,226692
"4137",16578,2016-11-21 18:00:00,690,941,660,281,92,189,2016-11-21 18:00:00,690,716,1076,472,1548,2264,2016-11-21 18:00:00,690,212056,211247
"4138",16579,2016-11-21 19:00:00,690,944,672,272,96,176,2016-11-21 19:00:00,690,784,1167,499,1666,2450,2016-11-21 19:00:00,690,206204,205366
"4139",16580,2016-11-21 20:00:00,690,896,614,282,101,181,2016-11-21 20:00:00,690,762,1235,532,1767,2529,2016-11-21 20:00:00,690,192202,191448
"4140",16581,2016-11-21 21:00:00,690,964,610,354,114,240,2016-11-21 21:00:00,690,695,1428,614,2042,2737,2016-11-21 21:00:00,690,173652,172975
"4141",16582,2016-11-21 22:00:00,690,964,634,330,97,233,2016-11-21 22:00:00,690,585,1436,591,2027,2612,2016-11-21 22:00:00,690,144346,143762
"4142",16583,2016-11-21 23:00:00,690,973,597,376,115,261,2016-11-21 23:00:00,690,597,1349,553,1902,2499,2016-11-21 23:00:00,690,120384,119882
"4143",16584,2016-11-22 00:00:00,691,949,560,389,137,252,2016-11-22 00:00:00,691,508,1332,535,1867,2375,2016-11-22 00:00:00,691,112338,111885
"4144",16585,2016-11-22 01:00:00,691,968,616,352,109,243,2016-11-22 01:00:00,691,433,1219,473,1692,2125,2016-11-22 01:00:00,691,109760,109303
"4145",16586,2016-11-22 02:00:00,691,843,533,310,90,220,2016-11-22 02:00:00,691,325,1010,394,1404,1729,2016-11-22 02:00:00,691,103758,103301
"4146",16587,2016-11-22 03:00:00,691,803,533,270,95,175,2016-11-22 03:00:00,691,215,690,278,968,1183,2016-11-22 03:00:00,691,98217,97784
"4147",16588,2016-11-22 04:00:00,691,700,484,216,78,138,2016-11-22 04:00:00,691,182,466,175,641,823,2016-11-22 04:00:00,691,91811,91434
"4148",16589,2016-11-22 05:00:00,691,564,375,189,66,123,2016-11-22 05:00:00,691,127,346,124,470,597,2016-11-22 05:00:00,691,86734,86366
"4149",16590,2016-11-22 06:00:00,691,503,344,159,44,115,2016-11-22 06:00:00,691,84,158,66,224,308,2016-11-22 06:00:00,691,89224,88811
"4150",16591,2016-11-22 07:00:00,691,359,258,101,46,55,2016-11-22 07:00:00,691,68,77,40,117,185,2016-11-22 07:00:00,691,90194,89788
"4151",16592,2016-11-22 08:00:00,691,446,316,130,74,56,2016-11-22 08:00:00,691,40,62,27,89,129,2016-11-22 08:00:00,691,92599,92171
"4152",16593,2016-11-22 09:00:00,691,314,236,78,19,59,2016-11-22 09:00:00,691,50,28,8,36,86,2016-11-22 09:00:00,691,95065,94634
"4153",16594,2016-11-22 10:00:00,691,331,272,59,20,39,2016-11-22 10:00:00,691,48,22,10,32,80,2016-11-22 10:00:00,691,94991,94546
"4154",16595,2016-11-22 11:00:00,691,314,263,51,20,31,2016-11-22 11:00:00,691,58,42,27,69,127,2016-11-22 11:00:00,691,101645,101220
"4155",16596,2016-11-22 12:00:00,691,384,310,74,36,38,2016-11-22 12:00:00,691,101,115,62,177,278,2016-11-22 12:00:00,691,134013,133526
"4156",16597,2016-11-22 13:00:00,691,567,461,106,43,63,2016-11-22 13:00:00,691,223,279,141,420,643,2016-11-22 13:00:00,691,183855,183268
"4157",16598,2016-11-22 14:00:00,691,627,499,128,51,77,2016-11-22 14:00:00,691,389,469,236,705,1094,2016-11-22 14:00:00,691,212848,212102
"4158",16599,2016-11-22 15:00:00,691,804,618,186,67,119,2016-11-22 15:00:00,691,542,660,297,957,1499,2016-11-22 15:00:00,691,213454,212662
"4159",16600,2016-11-22 16:00:00,691,772,594,178,65,113,2016-11-22 16:00:00,691,595,797,360,1157,1752,2016-11-22 16:00:00,691,206916,206116
"4160",16601,2016-11-22 17:00:00,691,911,655,256,87,169,2016-11-22 17:00:00,691,591,856,353,1209,1800,2016-11-22 17:00:00,691,187827,187087
"4161",16602,2016-11-22 18:00:00,691,902,641,261,78,183,2016-11-22 18:00:00,691,648,1057,430,1487,2135,2016-11-22 18:00:00,691,181306,180549
"4162",16603,2016-11-22 19:00:00,691,916,621,295,106,189,2016-11-22 19:00:00,691,615,1103,447,1550,2165,2016-11-22 19:00:00,691,179288,178551
"4163",16604,2016-11-22 20:00:00,691,982,659,323,99,224,2016-11-22 20:00:00,691,649,1188,444,1632,2281,2016-11-22 20:00:00,691,167803,167082
"4164",16605,2016-11-22 21:00:00,691,961,616,345,105,240,2016-11-22 21:00:00,691,681,1308,509,1817,2498,2016-11-22 21:00:00,691,152409,151756
"4165",16606,2016-11-22 22:00:00,691,1060,675,385,131,254,2016-11-22 22:00:00,691,533,1328,527,1855,2388,2016-11-22 22:00:00,691,129247,128730
"4166",16607,2016-11-22 23:00:00,691,1004,644,360,111,249,2016-11-22 23:00:00,691,498,1352,512,1864,2362,2016-11-22 23:00:00,691,109381,108930
"4167",16608,2016-11-23 00:00:00,692,1002,596,406,121,285,2016-11-23 00:00:00,692,413,1315,496,1811,2224,2016-11-23 00:00:00,692,101917,101494
"4168",16609,2016-11-23 01:00:00,692,1017,604,413,118,295,2016-11-23 01:00:00,692,359,1197,456,1653,2012,2016-11-23 01:00:00,692,99322,98880
"4169",16610,2016-11-23 02:00:00,692,916,552,364,122,242,2016-11-23 02:00:00,692,321,1018,369,1387,1708,2016-11-23 02:00:00,692,94729,94283
"4170",16611,2016-11-23 03:00:00,692,876,537,339,119,220,2016-11-23 03:00:00,692,258,818,315,1133,1391,2016-11-23 03:00:00,692,92768,92395
"4171",16612,2016-11-23 04:00:00,692,749,444,305,103,202,2016-11-23 04:00:00,692,195,653,255,908,1103,2016-11-23 04:00:00,692,89367,89015
"4172",16613,2016-11-23 05:00:00,692,676,391,285,98,187,2016-11-23 05:00:00,692,114,451,176,627,741,2016-11-23 05:00:00,692,85832,85433
"4173",16614,2016-11-23 06:00:00,692,495,307,188,71,117,2016-11-23 06:00:00,692,103,200,72,272,375,2016-11-23 06:00:00,692,86816,86432
"4174",16615,2016-11-23 07:00:00,692,370,253,117,33,84,2016-11-23 07:00:00,692,66,101,36,137,203,2016-11-23 07:00:00,692,88483,88045
"4175",16616,2016-11-23 08:00:00,692,297,202,95,38,57,2016-11-23 08:00:00,692,46,51,12,63,109,2016-11-23 08:00:00,692,90071,89649
"4176",16617,2016-11-23 09:00:00,692,255,190,65,21,44,2016-11-23 09:00:00,692,57,39,12,51,108,2016-11-23 09:00:00,692,92217,91778
"4177",16618,2016-11-23 10:00:00,692,353,286,67,19,48,2016-11-23 10:00:00,692,29,31,13,44,73,2016-11-23 10:00:00,692,90930,90469
"4178",16619,2016-11-23 11:00:00,692,287,232,55,21,33,2016-11-23 11:00:00,692,50,60,34,94,144,2016-11-23 11:00:00,692,95736,95291
"4179",16620,2016-11-23 12:00:00,692,334,258,76,28,48,2016-11-23 12:00:00,692,100,128,60,188,288,2016-11-23 12:00:00,692,115346,114882
"4180",16621,2016-11-23 13:00:00,692,516,403,113,37,76,2016-11-23 13:00:00,692,221,344,160,504,725,2016-11-23 13:00:00,692,146438,145907
"4181",16622,2016-11-23 14:00:00,692,606,434,172,47,125,2016-11-23 14:00:00,692,334,637,269,906,1240,2016-11-23 14:00:00,692,168223,167525
"4182",16623,2016-11-23 15:00:00,692,736,527,209,78,131,2016-11-23 15:00:00,692,487,809,337,1146,1633,2016-11-23 15:00:00,692,173204,172467
"4183",16624,2016-11-23 16:00:00,692,845,578,267,93,174,2016-11-23 16:00:00,692,540,1011,427,1438,1978,2016-11-23 16:00:00,692,171426,170684
"4184",16625,2016-11-23 17:00:00,692,900,589,311,103,208,2016-11-23 17:00:00,692,589,1059,412,1471,2060,2016-11-23 17:00:00,692,157695,157048
"4185",16626,2016-11-23 18:00:00,692,967,651,316,112,204,2016-11-23 18:00:00,692,573,1170,495,1665,2238,2016-11-23 18:00:00,692,150430,149746
"4186",16627,2016-11-23 19:00:00,692,962,632,330,89,241,2016-11-23 19:00:00,692,558,1274,504,1778,2336,2016-11-23 19:00:00,692,145839,145198
"4187",16628,2016-11-23 20:00:00,692,850,538,312,123,189,2016-11-23 20:00:00,692,557,1359,487,1846,2403,2016-11-23 20:00:00,692,135024,134458
"4188",16629,2016-11-23 21:00:00,692,934,566,368,123,245,2016-11-23 21:00:00,692,473,1352,522,1874,2347,2016-11-23 21:00:00,692,121548,120991
"4189",16630,2016-11-23 22:00:00,692,918,534,384,127,257,2016-11-23 22:00:00,692,469,1295,506,1801,2270,2016-11-23 22:00:00,692,106313,105878
"4190",16631,2016-11-23 23:00:00,692,811,483,328,107,221,2016-11-23 23:00:00,692,388,1226,438,1664,2052,2016-11-23 23:00:00,692,90916,90529
"4191",16632,2016-11-24 00:00:00,693,815,457,358,95,263,2016-11-24 00:00:00,693,328,1257,451,1708,2036,2016-11-24 00:00:00,693,90019,89644
"4192",16633,2016-11-24 01:00:00,693,765,454,311,87,224,2016-11-24 01:00:00,693,282,1153,375,1528,1810,2016-11-24 01:00:00,693,92326,91965
"4193",16634,2016-11-24 02:00:00,693,764,445,319,107,212,2016-11-24 02:00:00,693,251,973,346,1319,1570,2016-11-24 02:00:00,693,89624,89259
"4194",16635,2016-11-24 03:00:00,693,745,409,336,106,230,2016-11-24 03:00:00,693,196,878,323,1201,1397,2016-11-24 03:00:00,693,89247,88862
"4195",16636,2016-11-24 04:00:00,693,695,381,314,99,215,2016-11-24 04:00:00,693,166,752,271,1023,1189,2016-11-24 04:00:00,693,88455,88052
"4196",16637,2016-11-24 05:00:00,693,645,360,285,91,194,2016-11-24 05:00:00,693,124,513,195,708,832,2016-11-24 05:00:00,693,85938,85545
"4197",16638,2016-11-24 06:00:00,693,519,317,202,59,143,2016-11-24 06:00:00,693,85,374,137,511,596,2016-11-24 06:00:00,693,89653,89296
"4198",16639,2016-11-24 07:00:00,693,378,235,143,41,102,2016-11-24 07:00:00,693,77,144,44,188,265,2016-11-24 07:00:00,693,91651,91258
"4199",16640,2016-11-24 08:00:00,693,313,221,92,32,60,2016-11-24 08:00:00,693,44,75,30,105,149,2016-11-24 08:00:00,693,92422,92018
"4200",16641,2016-11-24 09:00:00,693,256,167,89,37,52,2016-11-24 09:00:00,693,27,52,16,68,95,2016-11-24 09:00:00,693,94009,93570
"4201",16642,2016-11-24 10:00:00,693,273,209,64,28,36,2016-11-24 10:00:00,693,27,45,12,57,84,2016-11-24 10:00:00,693,90388,89966
"4202",16643,2016-11-24 11:00:00,693,298,245,53,18,35,2016-11-24 11:00:00,693,28,52,21,73,101,2016-11-24 11:00:00,693,90579,90141
"4203",16644,2016-11-24 12:00:00,693,309,236,73,26,47,2016-11-24 12:00:00,693,69,110,43,153,222,2016-11-24 12:00:00,693,98355,97953
"4204",16645,2016-11-24 13:00:00,693,439,335,104,39,65,2016-11-24 13:00:00,693,112,211,81,292,404,2016-11-24 13:00:00,693,109606,109165
"4205",16646,2016-11-24 14:00:00,693,526,363,163,56,107,2016-11-24 14:00:00,693,142,377,152,529,671,2016-11-24 14:00:00,693,115826,115349
"4206",16647,2016-11-24 15:00:00,693,676,479,197,76,121,2016-11-24 15:00:00,693,206,579,213,792,998,2016-11-24 15:00:00,693,116441,115950
"4207",16648,2016-11-24 16:00:00,693,659,438,221,70,151,2016-11-24 16:00:00,693,241,752,254,1006,1247,2016-11-24 16:00:00,693,113045,112516
"4208",16649,2016-11-24 17:00:00,693,716,450,266,79,187,2016-11-24 17:00:00,693,234,731,277,1008,1242,2016-11-24 17:00:00,693,103418,102947
"4209",16650,2016-11-24 18:00:00,693,667,388,279,108,171,2016-11-24 18:00:00,693,207,740,280,1020,1227,2016-11-24 18:00:00,693,95595,95171
"4210",16651,2016-11-24 19:00:00,693,658,397,261,85,176,2016-11-24 19:00:00,693,231,622,229,851,1082,2016-11-24 19:00:00,693,90215,89829
"4211",16652,2016-11-24 20:00:00,693,659,404,255,95,160,2016-11-24 20:00:00,693,198,607,219,826,1024,2016-11-24 20:00:00,693,83821,83459
"4212",16653,2016-11-24 21:00:00,693,627,361,266,104,162,2016-11-24 21:00:00,693,213,588,220,808,1021,2016-11-24 21:00:00,693,75597,75229
"4213",16654,2016-11-24 22:00:00,693,595,345,250,104,146,2016-11-24 22:00:00,693,164,621,210,831,995,2016-11-24 22:00:00,693,70275,69987
"4214",16655,2016-11-24 23:00:00,693,576,338,238,96,142,2016-11-24 23:00:00,693,170,575,223,798,968,2016-11-24 23:00:00,693,66753,66441
"4215",16656,2016-11-25 00:00:00,694,569,334,235,82,153,2016-11-25 00:00:00,694,193,636,241,877,1070,2016-11-25 00:00:00,694,70921,70622
"4216",16657,2016-11-25 01:00:00,694,673,368,305,110,195,2016-11-25 01:00:00,694,138,795,270,1065,1203,2016-11-25 01:00:00,694,77837,77534
"4217",16658,2016-11-25 02:00:00,694,722,405,317,102,215,2016-11-25 02:00:00,694,162,815,305,1120,1282,2016-11-25 02:00:00,694,78723,78383
"4218",16659,2016-11-25 03:00:00,694,723,395,328,121,207,2016-11-25 03:00:00,694,142,794,293,1087,1229,2016-11-25 03:00:00,694,78998,78647
"4219",16660,2016-11-25 04:00:00,694,630,350,280,100,180,2016-11-25 04:00:00,694,141,748,259,1007,1148,2016-11-25 04:00:00,694,77218,76909
"4220",16661,2016-11-25 05:00:00,694,578,291,287,99,188,2016-11-25 05:00:00,694,93,503,178,681,774,2016-11-25 05:00:00,694,75254,74981
"4221",16662,2016-11-25 06:00:00,694,446,252,194,65,129,2016-11-25 06:00:00,694,62,334,135,469,531,2016-11-25 06:00:00,694,78857,78515
"4222",16663,2016-11-25 07:00:00,694,395,232,163,55,108,2016-11-25 07:00:00,694,67,197,69,266,333,2016-11-25 07:00:00,694,80691,80339
"4223",16664,2016-11-25 08:00:00,694,319,192,127,51,76,2016-11-25 08:00:00,694,25,121,38,159,184,2016-11-25 08:00:00,694,82248,81912
"4224",16665,2016-11-25 09:00:00,694,264,193,71,24,47,2016-11-25 09:00:00,694,34,71,27,98,132,2016-11-25 09:00:00,694,84479,84079
"4225",16666,2016-11-25 10:00:00,694,306,210,96,26,70,2016-11-25 10:00:00,694,40,42,19,61,101,2016-11-25 10:00:00,694,82828,82455
"4226",16667,2016-11-25 11:00:00,694,310,226,84,41,43,2016-11-25 11:00:00,694,26,83,36,119,145,2016-11-25 11:00:00,694,89185,88847
"4227",16668,2016-11-25 12:00:00,694,356,277,79,26,53,2016-11-25 12:00:00,694,64,156,92,248,312,2016-11-25 12:00:00,694,114551,114192
"4228",16669,2016-11-25 13:00:00,694,614,460,154,65,89,2016-11-25 13:00:00,694,136,367,157,524,660,2016-11-25 13:00:00,694,141798,141329
"4229",16670,2016-11-25 14:00:00,694,599,411,188,67,121,2016-11-25 14:00:00,694,241,742,303,1045,1286,2016-11-25 14:00:00,694,148962,148475
"4230",16671,2016-11-25 15:00:00,694,751,496,255,83,172,2016-11-25 15:00:00,694,335,971,396,1367,1702,2016-11-25 15:00:00,694,144565,143992
"4231",16672,2016-11-25 16:00:00,694,808,533,275,96,179,2016-11-25 16:00:00,694,434,1291,533,1824,2258,2016-11-25 16:00:00,694,138922,138333
"4232",16673,2016-11-25 17:00:00,694,1036,643,393,130,263,2016-11-25 17:00:00,694,413,1501,619,2120,2533,2016-11-25 17:00:00,694,128558,128016
"4233",16674,2016-11-25 18:00:00,694,1033,592,441,144,297,2016-11-25 18:00:00,694,463,1625,632,2257,2720,2016-11-25 18:00:00,694,121885,121355
"4234",16675,2016-11-25 19:00:00,694,1058,636,422,136,286,2016-11-25 19:00:00,694,515,1746,679,2425,2940,2016-11-25 19:00:00,694,116588,116060
"4235",16676,2016-11-25 20:00:00,694,896,541,355,93,262,2016-11-25 20:00:00,694,530,1869,762,2631,3161,2016-11-25 20:00:00,694,110672,110157
"4236",16677,2016-11-25 21:00:00,694,966,535,431,146,285,2016-11-25 21:00:00,694,476,1864,698,2562,3038,2016-11-25 21:00:00,694,104250,103770
"4237",16678,2016-11-25 22:00:00,694,1098,594,504,167,337,2016-11-25 22:00:00,694,450,1813,675,2488,2938,2016-11-25 22:00:00,694,94208,93790
"4238",16679,2016-11-25 23:00:00,694,1095,594,501,162,339,2016-11-25 23:00:00,694,352,1802,636,2438,2790,2016-11-25 23:00:00,694,85497,85038
"4239",16680,2016-11-26 00:00:00,695,1025,543,482,156,326,2016-11-26 00:00:00,695,348,1726,618,2344,2692,2016-11-26 00:00:00,695,82149,81749
"4240",16681,2016-11-26 01:00:00,695,1055,542,513,178,335,2016-11-26 01:00:00,695,342,1642,590,2232,2574,2016-11-26 01:00:00,695,80705,80350
"4241",16682,2016-11-26 02:00:00,695,969,516,453,137,316,2016-11-26 02:00:00,695,290,1477,503,1980,2270,2016-11-26 02:00:00,695,79159,78794
"4242",16683,2016-11-26 03:00:00,695,902,472,430,138,292,2016-11-26 03:00:00,695,226,1332,490,1822,2048,2016-11-26 03:00:00,695,78614,78260
"4243",16684,2016-11-26 04:00:00,695,716,377,339,103,236,2016-11-26 04:00:00,695,186,999,364,1363,1549,2016-11-26 04:00:00,695,76792,76463
"4244",16685,2016-11-26 05:00:00,695,767,481,286,109,177,2016-11-26 05:00:00,695,137,759,233,992,1129,2016-11-26 05:00:00,695,71529,71243
"4245",16686,2016-11-26 06:00:00,695,505,282,223,54,169,2016-11-26 06:00:00,695,115,406,145,551,666,2016-11-26 06:00:00,695,66789,66516
"4246",16687,2016-11-26 07:00:00,695,406,242,164,44,120,2016-11-26 07:00:00,695,68,212,81,293,361,2016-11-26 07:00:00,695,62400,62132
"4247",16688,2016-11-26 08:00:00,695,357,219,138,37,101,2016-11-26 08:00:00,695,63,84,33,117,180,2016-11-26 08:00:00,695,60455,60170
"4248",16689,2016-11-26 09:00:00,695,235,150,85,28,57,2016-11-26 09:00:00,695,70,71,25,96,166,2016-11-26 09:00:00,695,59209,58956
"4249",16690,2016-11-26 10:00:00,695,266,183,83,21,62,2016-11-26 10:00:00,695,29,52,23,75,104,2016-11-26 10:00:00,695,61185,60933
"4250",16691,2016-11-26 11:00:00,695,284,190,94,36,58,2016-11-26 11:00:00,695,22,58,25,83,105,2016-11-26 11:00:00,695,65033,64766
"4251",16692,2016-11-26 12:00:00,695,265,199,66,20,46,2016-11-26 12:00:00,695,58,144,63,207,265,2016-11-26 12:00:00,695,74384,74065
"4252",16693,2016-11-26 13:00:00,695,482,308,174,69,105,2016-11-26 13:00:00,695,113,318,132,450,563,2016-11-26 13:00:00,695,86809,86446
"4253",16694,2016-11-26 14:00:00,695,632,384,248,85,163,2016-11-26 14:00:00,695,256,710,303,1013,1269,2016-11-26 14:00:00,695,97325,96900
"4254",16695,2016-11-26 15:00:00,695,788,494,294,102,192,2016-11-26 15:00:00,695,279,1036,432,1468,1747,2016-11-26 15:00:00,695,104505,104071
"4255",16696,2016-11-26 16:00:00,695,862,513,349,124,225,2016-11-26 16:00:00,695,370,1314,502,1816,2186,2016-11-26 16:00:00,695,106240,105728
"4256",16697,2016-11-26 17:00:00,695,944,561,383,131,251,2016-11-26 17:00:00,695,402,1386,543,1929,2331,2016-11-26 17:00:00,695,103818,103351
"4257",16698,2016-11-26 18:00:00,695,1015,596,419,169,250,2016-11-26 18:00:00,695,488,1542,573,2115,2603,2016-11-26 18:00:00,695,100925,100456
"4258",16699,2016-11-26 19:00:00,695,947,550,397,128,269,2016-11-26 19:00:00,695,417,1611,582,2193,2610,2016-11-26 19:00:00,695,97120,96638
"4259",16700,2016-11-26 20:00:00,695,895,518,377,123,254,2016-11-26 20:00:00,695,410,1531,553,2084,2494,2016-11-26 20:00:00,695,91902,91481
"4260",16701,2016-11-26 21:00:00,695,980,539,441,161,280,2016-11-26 21:00:00,695,438,1505,542,2047,2485,2016-11-26 21:00:00,695,88411,87976
"4261",16702,2016-11-26 22:00:00,695,1198,623,575,157,418,2016-11-26 22:00:00,695,410,1598,581,2179,2589,2016-11-26 22:00:00,695,83535,83152
"4262",16703,2016-11-26 23:00:00,695,1036,537,499,156,343,2016-11-26 23:00:00,695,311,1513,572,2085,2396,2016-11-26 23:00:00,695,77980,77624
"4263",16704,2016-11-27 00:00:00,696,1043,506,537,141,396,2016-11-27 00:00:00,696,296,1351,454,1805,2101,2016-11-27 00:00:00,696,76249,75866
"4264",16705,2016-11-27 01:00:00,696,986,540,446,107,339,2016-11-27 01:00:00,696,270,1276,477,1753,2023,2016-11-27 01:00:00,696,75484,75143
"4265",16706,2016-11-27 02:00:00,696,983,518,465,113,352,2016-11-27 02:00:00,696,288,1200,421,1621,1909,2016-11-27 02:00:00,696,75202,74835
"4266",16707,2016-11-27 03:00:00,696,878,471,407,117,290,2016-11-27 03:00:00,696,205,912,293,1205,1410,2016-11-27 03:00:00,696,76389,76045
"4267",16708,2016-11-27 04:00:00,696,801,409,392,92,300,2016-11-27 04:00:00,696,154,735,257,992,1146,2016-11-27 04:00:00,696,76490,76181
"4268",16709,2016-11-27 05:00:00,696,779,393,386,125,261,2016-11-27 05:00:00,696,123,510,168,678,801,2016-11-27 05:00:00,696,71547,71259
"4269",16710,2016-11-27 06:00:00,696,585,306,279,98,181,2016-11-27 06:00:00,696,96,311,105,416,512,2016-11-27 06:00:00,696,66270,66035
"4270",16711,2016-11-27 07:00:00,696,420,236,184,51,133,2016-11-27 07:00:00,696,55,164,72,236,291,2016-11-27 07:00:00,696,61575,61301
"4271",16712,2016-11-27 08:00:00,696,375,219,156,62,94,2016-11-27 08:00:00,696,68,83,38,121,189,2016-11-27 08:00:00,696,60263,59976
"4272",16713,2016-11-27 09:00:00,696,296,177,119,38,81,2016-11-27 09:00:00,696,24,62,30,92,116,2016-11-27 09:00:00,696,59691,59445
"4273",16714,2016-11-27 10:00:00,696,282,185,97,42,55,2016-11-27 10:00:00,696,33,40,18,58,91,2016-11-27 10:00:00,696,60626,60364
"4274",16715,2016-11-27 11:00:00,696,287,204,83,34,49,2016-11-27 11:00:00,696,28,48,23,71,99,2016-11-27 11:00:00,696,63488,63224
"4275",16716,2016-11-27 12:00:00,696,306,214,92,31,61,2016-11-27 12:00:00,696,55,126,51,177,232,2016-11-27 12:00:00,696,72287,71993
"4276",16717,2016-11-27 13:00:00,696,411,279,132,40,92,2016-11-27 13:00:00,696,110,276,106,382,492,2016-11-27 13:00:00,696,80976,80607
"4277",16718,2016-11-27 14:00:00,696,664,437,227,68,159,2016-11-27 14:00:00,696,158,584,219,803,961,2016-11-27 14:00:00,696,89018,88658
"4278",16719,2016-11-27 15:00:00,696,717,448,269,95,174,2016-11-27 15:00:00,696,238,862,359,1221,1459,2016-11-27 15:00:00,696,95702,95276
"4279",16720,2016-11-27 16:00:00,696,840,513,327,117,210,2016-11-27 16:00:00,696,282,1020,388,1408,1690,2016-11-27 16:00:00,696,100331,99872
"4280",16721,2016-11-27 17:00:00,696,972,586,386,135,251,2016-11-27 17:00:00,696,355,1271,501,1772,2127,2016-11-27 17:00:00,696,101801,101340
"4281",16722,2016-11-27 18:00:00,696,996,594,402,112,290,2016-11-27 18:00:00,696,381,1343,500,1843,2224,2016-11-27 18:00:00,696,101139,100669
"4282",16723,2016-11-27 19:00:00,696,1037,630,407,138,269,2016-11-27 19:00:00,696,394,1413,580,1993,2387,2016-11-27 19:00:00,696,101616,101144
"4283",16724,2016-11-27 20:00:00,696,1061,627,434,164,270,2016-11-27 20:00:00,696,422,1585,560,2145,2567,2016-11-27 20:00:00,696,98890,98417
"4284",16725,2016-11-27 21:00:00,696,1045,571,474,167,307,2016-11-27 21:00:00,696,401,1498,536,2034,2435,2016-11-27 21:00:00,696,96289,95827
"4285",16726,2016-11-27 22:00:00,696,1045,603,442,120,322,2016-11-27 22:00:00,696,417,1585,584,2169,2586,2016-11-27 22:00:00,696,93560,93142
"4286",16727,2016-11-27 23:00:00,696,1040,569,471,151,320,2016-11-27 23:00:00,696,341,1258,465,1723,2064,2016-11-27 23:00:00,696,91075,90675
"4287",16728,2016-11-28 00:00:00,697,988,507,481,144,337,2016-11-28 00:00:00,697,314,1188,442,1630,1944,2016-11-28 00:00:00,697,99854,99441
"4288",16729,2016-11-28 01:00:00,697,1056,607,449,129,320,2016-11-28 01:00:00,697,310,1044,360,1404,1714,2016-11-28 01:00:00,697,107474,107034
"4289",16730,2016-11-28 02:00:00,697,949,526,423,115,308,2016-11-28 02:00:00,697,270,873,322,1195,1465,2016-11-28 02:00:00,697,101070,100655
"4290",16731,2016-11-28 03:00:00,697,949,534,415,143,272,2016-11-28 03:00:00,697,182,813,261,1074,1256,2016-11-28 03:00:00,697,98433,98004
"4291",16732,2016-11-28 04:00:00,697,845,470,375,95,280,2016-11-28 04:00:00,697,145,708,190,898,1043,2016-11-28 04:00:00,697,95375,94988
"4292",16733,2016-11-28 05:00:00,697,704,387,317,101,216,2016-11-28 05:00:00,697,90,335,110,445,535,2016-11-28 05:00:00,697,90205,89849
"4293",16734,2016-11-28 06:00:00,697,505,313,192,66,126,2016-11-28 06:00:00,697,78,145,51,196,274,2016-11-28 06:00:00,697,91981,91621
"4294",16735,2016-11-28 07:00:00,697,398,290,108,34,74,2016-11-28 07:00:00,697,63,98,41,139,202,2016-11-28 07:00:00,697,93146,92731
"4295",16736,2016-11-28 08:00:00,697,309,228,81,34,47,2016-11-28 08:00:00,697,59,34,16,50,109,2016-11-28 08:00:00,697,94441,94033
"4296",16737,2016-11-28 09:00:00,697,288,217,71,31,40,2016-11-28 09:00:00,697,29,34,12,46,75,2016-11-28 09:00:00,697,96195,95750
"4297",16738,2016-11-28 10:00:00,697,288,234,54,24,30,2016-11-28 10:00:00,697,33,29,13,42,75,2016-11-28 10:00:00,697,97673,97256
"4298",16739,2016-11-28 11:00:00,697,289,220,69,22,47,2016-11-28 11:00:00,697,37,63,27,90,127,2016-11-28 11:00:00,697,118043,117613
"4299",16740,2016-11-28 12:00:00,697,338,260,78,23,55,2016-11-28 12:00:00,697,80,146,75,221,301,2016-11-28 12:00:00,697,197791,197346
"4300",16741,2016-11-28 13:00:00,697,506,371,135,53,82,2016-11-28 13:00:00,697,241,363,179,542,783,2016-11-28 13:00:00,697,308803,308190
"4301",16742,2016-11-28 14:00:00,697,596,425,171,74,97,2016-11-28 14:00:00,697,403,663,323,986,1389,2016-11-28 14:00:00,697,330962,330104
"4302",16743,2016-11-28 15:00:00,697,807,605,202,87,115,2016-11-28 15:00:00,697,522,831,414,1245,1767,2016-11-28 15:00:00,697,293463,292619
"4303",16744,2016-11-28 16:00:00,697,875,655,220,83,137,2016-11-28 16:00:00,697,633,1012,478,1490,2123,2016-11-28 16:00:00,697,273316,272449
"4304",16745,2016-11-28 17:00:00,697,1003,753,250,99,151,2016-11-28 17:00:00,697,720,1231,551,1782,2502,2016-11-28 17:00:00,697,237129,236326
"4305",16746,2016-11-28 18:00:00,697,987,689,298,89,209,2016-11-28 18:00:00,697,692,1136,522,1658,2350,2016-11-28 18:00:00,697,221431,220604
"4306",16747,2016-11-28 19:00:00,697,1001,694,307,101,205,2016-11-28 19:00:00,697,696,1104,497,1601,2297,2016-11-28 19:00:00,697,214550,213671
"4307",16748,2016-11-28 20:00:00,697,1054,698,356,122,234,2016-11-28 20:00:00,697,787,1309,548,1857,2644,2016-11-28 20:00:00,697,200753,199949
"4308",16749,2016-11-28 21:00:00,697,1102,731,371,129,242,2016-11-28 21:00:00,697,724,1573,641,2214,2938,2016-11-28 21:00:00,697,181704,180978
"4309",16750,2016-11-28 22:00:00,697,1100,678,422,141,281,2016-11-28 22:00:00,697,667,1766,681,2447,3114,2016-11-28 22:00:00,697,151003,150382
"4310",16751,2016-11-28 23:00:00,697,1043,635,408,126,282,2016-11-28 23:00:00,697,568,1766,706,2472,3040,2016-11-28 23:00:00,697,125965,125469
"4311",16752,2016-11-29 00:00:00,698,1107,654,453,153,300,2016-11-29 00:00:00,698,498,1746,662,2408,2906,2016-11-29 00:00:00,698,118911,118434
"4312",16753,2016-11-29 01:00:00,698,1098,652,446,129,317,2016-11-29 01:00:00,698,446,1639,646,2285,2731,2016-11-29 01:00:00,698,114683,114207
"4313",16754,2016-11-29 02:00:00,698,1146,705,441,136,305,2016-11-29 02:00:00,698,407,1265,482,1747,2154,2016-11-29 02:00:00,698,108021,107573
"4314",16755,2016-11-29 03:00:00,698,966,589,377,119,258,2016-11-29 03:00:00,698,328,921,341,1262,1590,2016-11-29 03:00:00,698,102385,101954
"4315",16756,2016-11-29 04:00:00,698,774,474,300,87,213,2016-11-29 04:00:00,698,249,609,240,849,1098,2016-11-29 04:00:00,698,95616,95174
"4316",16757,2016-11-29 05:00:00,698,699,445,254,83,171,2016-11-29 05:00:00,698,160,436,145,581,741,2016-11-29 05:00:00,698,89824,89418
"4317",16758,2016-11-29 06:00:00,698,578,362,216,77,139,2016-11-29 06:00:00,698,102,253,96,349,451,2016-11-29 06:00:00,698,89443,89044
"4318",16759,2016-11-29 07:00:00,698,406,292,114,42,72,2016-11-29 07:00:00,698,47,94,43,137,184,2016-11-29 07:00:00,698,89824,89397
"4319",16760,2016-11-29 08:00:00,698,363,253,110,41,69,2016-11-29 08:00:00,698,62,64,24,88,150,2016-11-29 08:00:00,698,90842,90383
"4320",16761,2016-11-29 09:00:00,698,271,202,69,24,45,2016-11-29 09:00:00,698,45,46,24,70,115,2016-11-29 09:00:00,698,93330,92867
"4321",16762,2016-11-29 10:00:00,698,303,253,50,24,26,2016-11-29 10:00:00,698,32,32,14,46,78,2016-11-29 10:00:00,698,91973,91558
"4322",16763,2016-11-29 11:00:00,698,300,242,58,21,37,2016-11-29 11:00:00,698,49,74,26,100,149,2016-11-29 11:00:00,698,100409,99941
"4323",16764,2016-11-29 12:00:00,698,337,252,85,23,62,2016-11-29 12:00:00,698,101,129,69,198,299,2016-11-29 12:00:00,698,133283,132825
"4324",16765,2016-11-29 13:00:00,698,523,409,114,45,69,2016-11-29 13:00:00,698,242,331,180,511,753,2016-11-29 13:00:00,698,186780,186188
"4325",16766,2016-11-29 14:00:00,698,610,478,132,40,92,2016-11-29 14:00:00,698,403,549,290,839,1242,2016-11-29 14:00:00,698,221317,220535
"4326",16767,2016-11-29 15:00:00,698,668,531,137,49,88,2016-11-29 15:00:00,698,500,689,326,1015,1515,2016-11-29 15:00:00,698,226409,225563
"4327",16768,2016-11-29 16:00:00,698,838,660,178,64,114,2016-11-29 16:00:00,698,608,833,418,1251,1859,2016-11-29 16:00:00,698,222217,221385
"4328",16769,2016-11-29 17:00:00,698,846,641,205,70,135,2016-11-29 17:00:00,698,574,885,440,1325,1899,2016-11-29 17:00:00,698,204423,203639
"4329",16770,2016-11-29 18:00:00,698,889,641,248,83,165,2016-11-29 18:00:00,698,638,1031,463,1494,2132,2016-11-29 18:00:00,698,198717,197885
"4330",16771,2016-11-29 19:00:00,698,875,644,231,88,143,2016-11-29 19:00:00,698,743,1080,481,1561,2304,2016-11-29 19:00:00,698,196395,195559
"4331",16772,2016-11-29 20:00:00,698,913,638,275,91,184,2016-11-29 20:00:00,698,713,1171,490,1661,2374,2016-11-29 20:00:00,698,185162,184396
"4332",16773,2016-11-29 21:00:00,698,994,678,316,104,212,2016-11-29 21:00:00,698,715,1356,515,1871,2586,2016-11-29 21:00:00,698,168102,167408
"4333",16774,2016-11-29 22:00:00,698,933,629,304,98,206,2016-11-29 22:00:00,698,674,1470,583,2053,2727,2016-11-29 22:00:00,698,142087,141477
"4334",16775,2016-11-29 23:00:00,698,1001,662,339,94,245,2016-11-29 23:00:00,698,551,1569,582,2151,2702,2016-11-29 23:00:00,698,117948,117463
"4335",16776,2016-11-30 00:00:00,699,990,622,368,87,281,2016-11-30 00:00:00,699,495,1478,528,2006,2501,2016-11-30 00:00:00,699,105852,105433
"4336",16777,2016-11-30 01:00:00,699,970,583,387,111,276,2016-11-30 01:00:00,699,432,1248,456,1704,2136,2016-11-30 01:00:00,699,104908,104491
"4337",16778,2016-11-30 02:00:00,699,900,560,340,96,244,2016-11-30 02:00:00,699,373,972,366,1338,1711,2016-11-30 02:00:00,699,104700,104257
"4338",16779,2016-11-30 03:00:00,699,811,470,341,101,240,2016-11-30 03:00:00,699,331,770,286,1056,1387,2016-11-30 03:00:00,699,99938,99497
"4339",16780,2016-11-30 04:00:00,699,642,395,247,71,176,2016-11-30 04:00:00,699,189,605,194,799,988,2016-11-30 04:00:00,699,94392,94002
"4340",16781,2016-11-30 05:00:00,699,509,303,206,52,154,2016-11-30 05:00:00,699,137,299,107,406,543,2016-11-30 05:00:00,699,87523,87145
"4341",16782,2016-11-30 06:00:00,699,474,295,179,54,125,2016-11-30 06:00:00,699,81,153,58,211,292,2016-11-30 06:00:00,699,87573,87158
"4342",16783,2016-11-30 07:00:00,699,328,218,110,41,69,2016-11-30 07:00:00,699,84,89,35,124,208,2016-11-30 07:00:00,699,87507,87103
"4343",16784,2016-11-30 08:00:00,699,285,223,62,21,41,2016-11-30 08:00:00,699,49,46,14,60,109,2016-11-30 08:00:00,699,89546,89132
"4344",16785,2016-11-30 09:00:00,699,316,228,88,15,73,2016-11-30 09:00:00,699,34,58,16,74,108,2016-11-30 09:00:00,699,92510,92070
"4345",16786,2016-11-30 10:00:00,699,335,231,104,16,88,2016-11-30 10:00:00,699,50,55,16,71,121,2016-11-30 10:00:00,699,92100,91656
"4346",16787,2016-11-30 11:00:00,699,318,252,66,10,56,2016-11-30 11:00:00,699,48,69,30,99,147,2016-11-30 11:00:00,699,97137,96744
"4347",16788,2016-11-30 12:00:00,699,336,260,76,29,47,2016-11-30 12:00:00,699,90,130,67,197,287,2016-11-30 12:00:00,699,119281,118819
"4348",16789,2016-11-30 13:00:00,699,473,376,97,36,61,2016-11-30 13:00:00,699,205,290,150,440,645,2016-11-30 13:00:00,699,161646,161013
"4349",16790,2016-11-30 14:00:00,699,557,427,130,49,81,2016-11-30 14:00:00,699,339,522,246,768,1107,2016-11-30 14:00:00,699,193458,192722
"4350",16791,2016-11-30 15:00:00,699,644,508,136,42,94,2016-11-30 15:00:00,699,525,617,296,913,1438,2016-11-30 15:00:00,699,205886,205042
"4351",16792,2016-11-30 16:00:00,699,720,560,160,53,107,2016-11-30 16:00:00,699,595,724,322,1046,1641,2016-11-30 16:00:00,699,204617,203758
"4352",16793,2016-11-30 17:00:00,699,779,570,209,69,140,2016-11-30 17:00:00,699,621,785,343,1128,1749,2016-11-30 17:00:00,699,189946,189174
"4353",16794,2016-11-30 18:00:00,699,727,545,182,64,118,2016-11-30 18:00:00,699,640,866,382,1248,1888,2016-11-30 18:00:00,699,186841,186086
"4354",16795,2016-11-30 19:00:00,699,719,513,206,50,156,2016-11-30 19:00:00,699,671,940,401,1341,2012,2016-11-30 19:00:00,699,185641,184811
"4355",16796,2016-11-30 20:00:00,699,890,622,268,86,182,2016-11-30 20:00:00,699,742,1059,417,1476,2218,2016-11-30 20:00:00,699,175248,174446
"4356",16797,2016-11-30 21:00:00,699,1014,697,317,89,228,2016-11-30 21:00:00,699,599,1181,473,1654,2253,2016-11-30 21:00:00,699,160666,159943
"4357",16798,2016-11-30 22:00:00,699,895,618,277,87,190,2016-11-30 22:00:00,699,582,1246,521,1767,2349,2016-11-30 22:00:00,699,137076,136486
"4358",16799,2016-11-30 23:00:00,699,948,542,406,120,286,2016-11-30 23:00:00,699,564,1344,504,1848,2412,2016-11-30 23:00:00,699,116492,115995
"4359",16800,2016-12-01 00:00:00,700,965,542,423,113,310,2016-12-01 00:00:00,700,486,1204,446,1650,2136,2016-12-01 00:00:00,700,111658,111145
"4360",16801,2016-12-01 01:00:00,700,895,546,349,98,251,2016-12-01 01:00:00,700,365,1152,413,1565,1930,2016-12-01 01:00:00,700,110346,109850
"4361",16802,2016-12-01 02:00:00,700,893,564,329,81,248,2016-12-01 02:00:00,700,364,929,350,1279,1643,2016-12-01 02:00:00,700,104877,104396
"4362",16803,2016-12-01 03:00:00,700,739,470,269,75,194,2016-12-01 03:00:00,700,289,719,260,979,1268,2016-12-01 03:00:00,700,99853,99451
"4363",16804,2016-12-01 04:00:00,700,644,398,246,86,160,2016-12-01 04:00:00,700,202,529,202,731,933,2016-12-01 04:00:00,700,93563,93172
"4364",16805,2016-12-01 05:00:00,700,630,394,236,66,170,2016-12-01 05:00:00,700,151,311,118,429,580,2016-12-01 05:00:00,700,87958,87629
"4365",16806,2016-12-01 06:00:00,700,433,285,148,52,96,2016-12-01 06:00:00,700,117,178,68,246,363,2016-12-01 06:00:00,700,88168,87820
"4366",16807,2016-12-01 07:00:00,700,351,252,99,38,61,2016-12-01 07:00:00,700,69,79,30,109,178,2016-12-01 07:00:00,700,88636,88220
"4367",16808,2016-12-01 08:00:00,700,267,185,82,25,57,2016-12-01 08:00:00,700,31,50,22,72,103,2016-12-01 08:00:00,700,89954,89556
"4368",16809,2016-12-01 09:00:00,700,233,169,64,16,48,2016-12-01 09:00:00,700,35,42,23,65,100,2016-12-01 09:00:00,700,91926,91470
"4369",16810,2016-12-01 10:00:00,700,226,173,53,19,34,2016-12-01 10:00:00,700,29,19,8,27,56,2016-12-01 10:00:00,700,92221,91778
"4370",16811,2016-12-01 11:00:00,700,279,233,46,21,25,2016-12-01 11:00:00,700,57,67,29,96,153,2016-12-01 11:00:00,700,100882,100490
"4371",16812,2016-12-01 12:00:00,700,322,269,53,10,43,2016-12-01 12:00:00,700,104,134,55,189,293,2016-12-01 12:00:00,700,144272,143846
"4372",16813,2016-12-01 13:00:00,700,500,410,90,38,52,2016-12-01 13:00:00,700,239,351,183,534,773,2016-12-01 13:00:00,700,215110,214514
"4373",16814,2016-12-01 14:00:00,700,569,442,127,52,75,2016-12-01 14:00:00,700,389,505,235,740,1129,2016-12-01 14:00:00,700,253836,253090
"4374",16815,2016-12-01 15:00:00,700,646,504,142,44,98,2016-12-01 15:00:00,700,510,554,253,807,1317,2016-12-01 15:00:00,700,255359,254490
"4375",16816,2016-12-01 16:00:00,700,712,543,169,62,106,2016-12-01 16:00:00,700,569,695,308,1003,1572,2016-12-01 16:00:00,700,247207,246390
"4376",16817,2016-12-01 17:00:00,700,789,589,200,61,139,2016-12-01 17:00:00,700,607,675,307,982,1589,2016-12-01 17:00:00,700,223078,222320
"4377",16818,2016-12-01 18:00:00,700,779,593,186,62,124,2016-12-01 18:00:00,700,681,874,376,1250,1931,2016-12-01 18:00:00,700,214864,214099
"4378",16819,2016-12-01 19:00:00,700,790,599,191,53,138,2016-12-01 19:00:00,700,677,880,359,1239,1916,2016-12-01 19:00:00,700,212023,211219
"4379",16820,2016-12-01 20:00:00,700,812,571,241,78,163,2016-12-01 20:00:00,700,636,1067,426,1493,2129,2016-12-01 20:00:00,700,198108,197327
"4380",16821,2016-12-01 21:00:00,700,912,612,300,75,225,2016-12-01 21:00:00,700,617,1127,460,1587,2204,2016-12-01 21:00:00,700,179419,178732
"4381",16822,2016-12-01 22:00:00,700,882,551,331,96,235,2016-12-01 22:00:00,700,569,1222,470,1692,2261,2016-12-01 22:00:00,700,148183,147608
"4382",16823,2016-12-01 23:00:00,700,886,550,336,99,237,2016-12-01 23:00:00,700,508,1301,495,1796,2304,2016-12-01 23:00:00,700,120475,119986
"4383",16824,2016-12-02 00:00:00,701,913,521,392,115,277,2016-12-02 00:00:00,701,428,1218,448,1666,2094,2016-12-02 00:00:00,701,112947,112472
"4384",16825,2016-12-02 01:00:00,701,852,494,358,97,261,2016-12-02 01:00:00,701,380,1062,415,1477,1857,2016-12-02 01:00:00,701,107744,107292
"4385",16826,2016-12-02 02:00:00,701,816,503,313,86,227,2016-12-02 02:00:00,701,321,968,350,1318,1639,2016-12-02 02:00:00,701,100897,100438
"4386",16827,2016-12-02 03:00:00,701,846,499,347,84,263,2016-12-02 03:00:00,701,278,812,282,1094,1372,2016-12-02 03:00:00,701,96026,95598
"4387",16828,2016-12-02 04:00:00,701,669,419,250,70,180,2016-12-02 04:00:00,701,197,693,260,953,1150,2016-12-02 04:00:00,701,88469,88107
"4388",16829,2016-12-02 05:00:00,701,535,327,208,63,145,2016-12-02 05:00:00,701,166,365,152,517,683,2016-12-02 05:00:00,701,81497,81150
"4389",16830,2016-12-02 06:00:00,701,442,305,137,31,106,2016-12-02 06:00:00,701,107,185,76,261,368,2016-12-02 06:00:00,701,81340,80974
"4390",16831,2016-12-02 07:00:00,701,347,245,102,43,59,2016-12-02 07:00:00,701,59,93,38,131,190,2016-12-02 07:00:00,701,82310,81937
"4391",16832,2016-12-02 08:00:00,701,305,232,73,24,49,2016-12-02 08:00:00,701,44,52,17,69,113,2016-12-02 08:00:00,701,82344,81946
"4392",16833,2016-12-02 09:00:00,701,299,214,85,30,55,2016-12-02 09:00:00,701,48,60,25,85,133,2016-12-02 09:00:00,701,85175,84783
"4393",16834,2016-12-02 10:00:00,701,288,221,67,20,47,2016-12-02 10:00:00,701,51,29,15,44,95,2016-12-02 10:00:00,701,85080,84687
"4394",16835,2016-12-02 11:00:00,701,294,239,55,24,31,2016-12-02 11:00:00,701,50,79,43,122,172,2016-12-02 11:00:00,701,93943,93555
"4395",16836,2016-12-02 12:00:00,701,350,268,82,31,51,2016-12-02 12:00:00,701,107,139,67,206,313,2016-12-02 12:00:00,701,132758,132349
"4396",16837,2016-12-02 13:00:00,701,480,378,102,39,63,2016-12-02 13:00:00,701,223,312,169,481,704,2016-12-02 13:00:00,701,190800,190214
"4397",16838,2016-12-02 14:00:00,701,561,441,120,45,75,2016-12-02 14:00:00,701,382,544,259,803,1185,2016-12-02 14:00:00,701,220889,220157
"4398",16839,2016-12-02 15:00:00,701,727,591,136,43,93,2016-12-02 15:00:00,701,453,647,304,951,1404,2016-12-02 15:00:00,701,219956,219177
"4399",16840,2016-12-02 16:00:00,701,721,547,174,53,121,2016-12-02 16:00:00,701,545,822,400,1222,1767,2016-12-02 16:00:00,701,213000,212229
"4400",16841,2016-12-02 17:00:00,701,780,568,212,64,148,2016-12-02 17:00:00,701,616,873,388,1261,1877,2016-12-02 17:00:00,701,194123,193364
"4401",16842,2016-12-02 18:00:00,701,745,544,201,72,129,2016-12-02 18:00:00,701,552,923,424,1347,1899,2016-12-02 18:00:00,701,184664,183948
"4402",16843,2016-12-02 19:00:00,701,799,573,226,70,156,2016-12-02 19:00:00,701,620,926,420,1346,1966,2016-12-02 19:00:00,701,181964,181225
"4403",16844,2016-12-02 20:00:00,701,804,533,271,92,179,2016-12-02 20:00:00,701,673,1105,473,1578,2251,2016-12-02 20:00:00,701,169099,168425
"4404",16845,2016-12-02 21:00:00,701,908,586,322,103,219,2016-12-02 21:00:00,701,634,1280,553,1833,2467,2016-12-02 21:00:00,701,150384,149775
"4405",16846,2016-12-02 22:00:00,701,829,524,305,95,210,2016-12-02 22:00:00,701,584,1441,525,1966,2550,2016-12-02 22:00:00,701,123873,123358
"4406",16847,2016-12-02 23:00:00,701,874,507,367,123,244,2016-12-02 23:00:00,701,490,1355,515,1870,2360,2016-12-02 23:00:00,701,102067,101656
"4407",16848,2016-12-03 00:00:00,702,862,492,370,118,252,2016-12-03 00:00:00,702,439,1302,473,1775,2214,2016-12-03 00:00:00,702,92168,91762
"4408",16849,2016-12-03 01:00:00,702,863,495,368,111,257,2016-12-03 01:00:00,702,345,1354,530,1884,2229,2016-12-03 01:00:00,702,84983,84636
"4409",16850,2016-12-03 02:00:00,702,814,458,356,115,241,2016-12-03 02:00:00,702,335,1156,430,1586,1921,2016-12-03 02:00:00,702,80650,80304
"4410",16851,2016-12-03 03:00:00,702,813,446,367,119,248,2016-12-03 03:00:00,702,254,972,378,1350,1604,2016-12-03 03:00:00,702,78406,78071
"4411",16852,2016-12-03 04:00:00,702,683,373,310,95,215,2016-12-03 04:00:00,702,200,817,291,1108,1308,2016-12-03 04:00:00,702,76155,75854
"4412",16853,2016-12-03 05:00:00,702,668,349,319,108,211,2016-12-03 05:00:00,702,159,493,191,684,843,2016-12-03 05:00:00,702,70847,70525
"4413",16854,2016-12-03 06:00:00,702,523,288,235,67,168,2016-12-03 06:00:00,702,108,297,121,418,526,2016-12-03 06:00:00,702,65763,65475
"4414",16855,2016-12-03 07:00:00,702,395,235,160,36,124,2016-12-03 07:00:00,702,73,157,67,224,297,2016-12-03 07:00:00,702,61261,60989
"4415",16856,2016-12-03 08:00:00,702,313,186,127,43,84,2016-12-03 08:00:00,702,56,88,42,130,186,2016-12-03 08:00:00,702,59113,58847
"4416",16857,2016-12-03 09:00:00,702,304,226,78,20,58,2016-12-03 09:00:00,702,28,53,22,75,103,2016-12-03 09:00:00,702,58192,57931
"4417",16858,2016-12-03 10:00:00,702,268,191,77,22,55,2016-12-03 10:00:00,702,38,39,6,45,83,2016-12-03 10:00:00,702,59129,58858
"4418",16859,2016-12-03 11:00:00,702,286,189,97,36,61,2016-12-03 11:00:00,702,55,73,36,109,164,2016-12-03 11:00:00,702,63733,63468
"4419",16860,2016-12-03 12:00:00,702,343,256,87,26,61,2016-12-03 12:00:00,702,69,125,59,184,253,2016-12-03 12:00:00,702,74064,73776
"4420",16861,2016-12-03 13:00:00,702,482,322,160,59,101,2016-12-03 13:00:00,702,159,341,152,493,652,2016-12-03 13:00:00,702,85508,85133
"4421",16862,2016-12-03 14:00:00,702,698,454,244,87,157,2016-12-03 14:00:00,702,265,731,336,1067,1332,2016-12-03 14:00:00,702,96563,96196
"4422",16863,2016-12-03 15:00:00,702,755,463,292,82,209,2016-12-03 15:00:00,702,373,1040,470,1510,1883,2016-12-03 15:00:00,702,104614,104170
"4423",16864,2016-12-03 16:00:00,702,900,584,316,100,216,2016-12-03 16:00:00,702,424,1199,529,1728,2152,2016-12-03 16:00:00,702,107288,106779
"4424",16865,2016-12-03 17:00:00,702,969,591,378,136,242,2016-12-03 17:00:00,702,455,1384,590,1974,2429,2016-12-03 17:00:00,702,106894,106392
"4425",16866,2016-12-03 18:00:00,702,984,621,363,122,241,2016-12-03 18:00:00,702,481,1440,610,2050,2531,2016-12-03 18:00:00,702,103260,102745
"4426",16867,2016-12-03 19:00:00,702,1033,616,417,142,275,2016-12-03 19:00:00,702,523,1459,596,2055,2578,2016-12-03 19:00:00,702,99821,99366
"4427",16868,2016-12-03 20:00:00,702,943,529,414,129,285,2016-12-03 20:00:00,702,496,1648,663,2311,2807,2016-12-03 20:00:00,702,95773,95299
"4428",16869,2016-12-03 21:00:00,702,880,523,357,99,258,2016-12-03 21:00:00,702,446,1533,638,2171,2617,2016-12-03 21:00:00,702,89935,89485
"4429",16870,2016-12-03 22:00:00,702,1094,648,446,151,295,2016-12-03 22:00:00,702,415,1430,561,1991,2406,2016-12-03 22:00:00,702,84051,83681
"4430",16871,2016-12-03 23:00:00,702,1038,567,471,136,335,2016-12-03 23:00:00,702,402,1391,533,1924,2326,2016-12-03 23:00:00,702,78407,78045
"4431",16872,2016-12-04 00:00:00,703,1052,536,516,144,372,2016-12-04 00:00:00,703,328,1331,522,1853,2181,2016-12-04 00:00:00,703,75725,75398
"4432",16873,2016-12-04 01:00:00,703,1012,537,475,133,342,2016-12-04 01:00:00,703,315,1314,487,1801,2116,2016-12-04 01:00:00,703,74376,74046
"4433",16874,2016-12-04 02:00:00,703,817,453,364,75,289,2016-12-04 02:00:00,703,309,1179,429,1608,1917,2016-12-04 02:00:00,703,74859,74501
"4434",16875,2016-12-04 03:00:00,703,811,452,359,66,293,2016-12-04 03:00:00,703,253,924,339,1263,1516,2016-12-04 03:00:00,703,77041,76705
"4435",16876,2016-12-04 04:00:00,703,685,355,330,70,260,2016-12-04 04:00:00,703,156,666,243,909,1065,2016-12-04 04:00:00,703,76888,76557
"4436",16877,2016-12-04 05:00:00,703,730,368,362,122,240,2016-12-04 05:00:00,703,138,444,152,596,734,2016-12-04 05:00:00,703,71181,70856
"4437",16878,2016-12-04 06:00:00,703,535,298,237,68,169,2016-12-04 06:00:00,703,88,294,115,409,497,2016-12-04 06:00:00,703,66514,66242
"4438",16879,2016-12-04 07:00:00,703,413,255,158,43,115,2016-12-04 07:00:00,703,67,177,62,239,306,2016-12-04 07:00:00,703,61605,61341
"4439",16880,2016-12-04 08:00:00,703,372,235,137,43,94,2016-12-04 08:00:00,703,47,88,38,126,173,2016-12-04 08:00:00,703,59588,59353
"4440",16881,2016-12-04 09:00:00,703,296,196,100,30,70,2016-12-04 09:00:00,703,57,39,14,53,110,2016-12-04 09:00:00,703,58962,58694
"4441",16882,2016-12-04 10:00:00,703,248,175,73,27,46,2016-12-04 10:00:00,703,41,34,22,56,97,2016-12-04 10:00:00,703,59587,59333
"4442",16883,2016-12-04 11:00:00,703,248,186,62,19,43,2016-12-04 11:00:00,703,44,50,20,70,114,2016-12-04 11:00:00,703,63045,62764
"4443",16884,2016-12-04 12:00:00,703,336,238,98,41,57,2016-12-04 12:00:00,703,64,109,44,153,217,2016-12-04 12:00:00,703,71126,70833
"4444",16885,2016-12-04 13:00:00,703,452,301,151,56,95,2016-12-04 13:00:00,703,97,267,112,379,476,2016-12-04 13:00:00,703,80989,80656
"4445",16886,2016-12-04 14:00:00,703,599,400,199,74,125,2016-12-04 14:00:00,703,205,587,257,844,1049,2016-12-04 14:00:00,703,88952,88606
"4446",16887,2016-12-04 15:00:00,703,706,452,254,83,171,2016-12-04 15:00:00,703,260,956,394,1350,1610,2016-12-04 15:00:00,703,95694,95275
"4447",16888,2016-12-04 16:00:00,703,869,542,327,111,216,2016-12-04 16:00:00,703,297,1150,473,1623,1920,2016-12-04 16:00:00,703,100828,100387
"4448",16889,2016-12-04 17:00:00,703,891,560,331,101,230,2016-12-04 17:00:00,703,363,1287,527,1814,2177,2016-12-04 17:00:00,703,102070,101588
"4449",16890,2016-12-04 18:00:00,703,957,573,384,105,279,2016-12-04 18:00:00,703,373,1294,535,1829,2202,2016-12-04 18:00:00,703,100685,100234
"4450",16891,2016-12-04 19:00:00,703,966,589,377,146,231,2016-12-04 19:00:00,703,413,1427,553,1980,2393,2016-12-04 19:00:00,703,100305,99828
"4451",16892,2016-12-04 20:00:00,703,1023,621,402,136,266,2016-12-04 20:00:00,703,448,1325,491,1816,2264,2016-12-04 20:00:00,703,99316,98822
"4452",16893,2016-12-04 21:00:00,703,887,520,367,109,258,2016-12-04 21:00:00,703,368,1473,556,2029,2397,2016-12-04 21:00:00,703,95770,95290
"4453",16894,2016-12-04 22:00:00,703,968,571,397,127,270,2016-12-04 22:00:00,703,422,1249,498,1747,2169,2016-12-04 22:00:00,703,92607,92206
"4454",16895,2016-12-04 23:00:00,703,854,492,362,106,256,2016-12-04 23:00:00,703,338,1172,470,1642,1980,2016-12-04 23:00:00,703,89277,88886
"4455",16896,2016-12-05 00:00:00,704,843,480,363,110,253,2016-12-05 00:00:00,704,327,1111,424,1535,1862,2016-12-05 00:00:00,704,97101,96711
"4456",16897,2016-12-05 01:00:00,704,963,554,409,119,290,2016-12-05 01:00:00,704,281,905,369,1274,1555,2016-12-05 01:00:00,704,104381,103940
"4457",16898,2016-12-05 02:00:00,704,963,549,414,115,299,2016-12-05 02:00:00,704,275,744,310,1054,1329,2016-12-05 02:00:00,704,99641,99199
"4458",16899,2016-12-05 03:00:00,704,838,474,364,119,245,2016-12-05 03:00:00,704,206,495,188,683,889,2016-12-05 03:00:00,704,96156,95769
"4459",16900,2016-12-05 04:00:00,704,713,392,321,100,221,2016-12-05 04:00:00,704,172,356,143,499,671,2016-12-05 04:00:00,704,94194,93808
"4460",16901,2016-12-05 05:00:00,704,556,340,216,74,142,2016-12-05 05:00:00,704,110,216,107,323,433,2016-12-05 05:00:00,704,90297,89954
"4461",16902,2016-12-05 06:00:00,704,396,258,138,39,99,2016-12-05 06:00:00,704,64,120,53,173,237,2016-12-05 06:00:00,704,91295,90926
"4462",16903,2016-12-05 07:00:00,704,330,232,98,27,71,2016-12-05 07:00:00,704,59,54,27,81,140,2016-12-05 07:00:00,704,91942,91566
"4463",16904,2016-12-05 08:00:00,704,244,180,64,15,49,2016-12-05 08:00:00,704,36,31,14,45,81,2016-12-05 08:00:00,704,92734,92287
"4464",16905,2016-12-05 09:00:00,704,263,212,51,17,34,2016-12-05 09:00:00,704,38,25,7,32,70,2016-12-05 09:00:00,704,95023,94575
"4465",16906,2016-12-05 10:00:00,704,256,201,55,15,40,2016-12-05 10:00:00,704,46,20,15,35,81,2016-12-05 10:00:00,704,96081,95663
"4466",16907,2016-12-05 11:00:00,704,283,227,56,21,35,2016-12-05 11:00:00,704,72,52,18,70,142,2016-12-05 11:00:00,704,115285,114882
"4467",16908,2016-12-05 12:00:00,704,340,278,62,25,37,2016-12-05 12:00:00,704,84,122,65,187,271,2016-12-05 12:00:00,704,186357,185892
"4468",16909,2016-12-05 13:00:00,704,446,366,80,38,42,2016-12-05 13:00:00,704,217,317,159,476,693,2016-12-05 13:00:00,704,290281,289675
"4469",16910,2016-12-05 14:00:00,704,580,456,124,47,77,2016-12-05 14:00:00,704,395,587,307,894,1289,2016-12-05 14:00:00,704,320350,319550
"4470",16911,2016-12-05 15:00:00,704,639,482,157,72,85,2016-12-05 15:00:00,704,482,674,334,1008,1490,2016-12-05 15:00:00,704,293541,292676
"4471",16912,2016-12-05 16:00:00,704,784,583,201,62,139,2016-12-05 16:00:00,704,568,896,453,1349,1917,2016-12-05 16:00:00,704,270882,270026
"4472",16913,2016-12-05 17:00:00,704,844,600,244,73,171,2016-12-05 17:00:00,704,622,937,450,1387,2009,2016-12-05 17:00:00,704,237023,236219
"4473",16914,2016-12-05 18:00:00,704,834,589,245,69,176,2016-12-05 18:00:00,704,685,1023,479,1502,2187,2016-12-05 18:00:00,704,222531,221702
"4474",16915,2016-12-05 19:00:00,704,840,605,235,72,163,2016-12-05 19:00:00,704,776,1122,526,1648,2424,2016-12-05 19:00:00,704,215849,215072
"4475",16916,2016-12-05 20:00:00,704,865,606,259,81,178,2016-12-05 20:00:00,704,765,1191,546,1737,2502,2016-12-05 20:00:00,704,199729,198992
"4476",16917,2016-12-05 21:00:00,704,934,589,345,94,251,2016-12-05 21:00:00,704,741,1407,607,2014,2755,2016-12-05 21:00:00,704,180205,179496
"4477",16918,2016-12-05 22:00:00,704,920,591,329,114,215,2016-12-05 22:00:00,704,730,1442,597,2039,2769,2016-12-05 22:00:00,704,148976,148405
"4478",16919,2016-12-05 23:00:00,704,892,569,323,96,227,2016-12-05 23:00:00,704,667,1483,606,2089,2756,2016-12-05 23:00:00,704,122713,122246
"4479",16920,2016-12-06 00:00:00,705,856,521,335,115,220,2016-12-06 00:00:00,705,511,1372,537,1909,2420,2016-12-06 00:00:00,705,114709,114217
"4480",16921,2016-12-06 01:00:00,705,934,572,362,118,244,2016-12-06 01:00:00,705,422,1198,469,1667,2089,2016-12-06 01:00:00,705,113841,113402
"4481",16922,2016-12-06 02:00:00,705,855,552,303,111,192,2016-12-06 02:00:00,705,389,1036,416,1452,1841,2016-12-06 02:00:00,705,106986,106546
"4482",16923,2016-12-06 03:00:00,705,769,460,309,104,205,2016-12-06 03:00:00,705,298,750,320,1070,1368,2016-12-06 03:00:00,705,100758,100319
"4483",16924,2016-12-06 04:00:00,705,592,380,212,55,157,2016-12-06 04:00:00,705,206,501,203,704,910,2016-12-06 04:00:00,705,92758,92387
"4484",16925,2016-12-06 05:00:00,705,529,337,192,60,132,2016-12-06 05:00:00,705,152,325,139,464,616,2016-12-06 05:00:00,705,86608,86234
"4485",16926,2016-12-06 06:00:00,705,448,315,133,36,97,2016-12-06 06:00:00,705,96,165,62,227,323,2016-12-06 06:00:00,705,87734,87339
"4486",16927,2016-12-06 07:00:00,705,310,235,75,29,46,2016-12-06 07:00:00,705,69,68,29,97,166,2016-12-06 07:00:00,705,88425,87999
"4487",16928,2016-12-06 08:00:00,705,281,191,90,33,57,2016-12-06 08:00:00,705,52,37,19,56,108,2016-12-06 08:00:00,705,89674,89221
"4488",16929,2016-12-06 09:00:00,705,263,210,53,17,36,2016-12-06 09:00:00,705,45,48,14,62,107,2016-12-06 09:00:00,705,90967,90529
"4489",16930,2016-12-06 10:00:00,705,274,221,53,17,36,2016-12-06 10:00:00,705,37,35,14,49,86,2016-12-06 10:00:00,705,91016,90530
"4490",16931,2016-12-06 11:00:00,705,287,237,50,18,32,2016-12-06 11:00:00,705,69,43,25,68,137,2016-12-06 11:00:00,705,98402,97972
"4491",16932,2016-12-06 12:00:00,705,320,248,72,25,47,2016-12-06 12:00:00,705,118,112,69,181,299,2016-12-06 12:00:00,705,130277,129816
"4492",16933,2016-12-06 13:00:00,705,407,326,81,36,45,2016-12-06 13:00:00,705,223,277,148,425,648,2016-12-06 13:00:00,705,185479,184893
"4493",16934,2016-12-06 14:00:00,705,553,432,121,40,81,2016-12-06 14:00:00,705,477,511,280,791,1268,2016-12-06 14:00:00,705,220459,219711
"4494",16935,2016-12-06 15:00:00,705,628,496,132,56,76,2016-12-06 15:00:00,705,640,648,339,987,1627,2016-12-06 15:00:00,705,225222,224418
"4495",16936,2016-12-06 16:00:00,705,778,563,215,62,153,2016-12-06 16:00:00,705,707,742,342,1084,1791,2016-12-06 16:00:00,705,219869,219008
"4496",16937,2016-12-06 17:00:00,705,832,592,240,64,176,2016-12-06 17:00:00,705,846,842,411,1253,2099,2016-12-06 17:00:00,705,203226,202410
"4497",16938,2016-12-06 18:00:00,705,828,599,229,69,160,2016-12-06 18:00:00,705,853,836,390,1226,2079,2016-12-06 18:00:00,705,201806,201031
"4498",16939,2016-12-06 19:00:00,705,844,649,195,71,123,2016-12-06 19:00:00,705,932,975,431,1406,2338,2016-12-06 19:00:00,705,198444,197661
"4499",16940,2016-12-06 20:00:00,705,827,604,223,67,156,2016-12-06 20:00:00,705,995,1026,440,1466,2461,2016-12-06 20:00:00,705,181644,180923
"4500",16941,2016-12-06 21:00:00,705,888,604,284,83,201,2016-12-06 21:00:00,705,959,1361,510,1871,2830,2016-12-06 21:00:00,705,166319,165617
"4501",16942,2016-12-06 22:00:00,705,871,538,333,110,223,2016-12-06 22:00:00,705,886,1336,537,1873,2759,2016-12-06 22:00:00,705,139329,138771
"4502",16943,2016-12-06 23:00:00,705,877,576,301,86,215,2016-12-06 23:00:00,705,830,1329,538,1867,2697,2016-12-06 23:00:00,705,115825,115322
"4503",16944,2016-12-07 00:00:00,706,806,507,299,92,207,2016-12-07 00:00:00,706,703,1290,517,1807,2510,2016-12-07 00:00:00,706,108132,107659
"4504",16945,2016-12-07 01:00:00,706,873,549,324,97,227,2016-12-07 01:00:00,706,718,1168,434,1602,2320,2016-12-07 01:00:00,706,104414,103931
"4505",16946,2016-12-07 02:00:00,706,825,534,291,73,218,2016-12-07 02:00:00,706,569,921,347,1268,1837,2016-12-07 02:00:00,706,100502,100020
"4506",16947,2016-12-07 03:00:00,706,779,496,283,92,191,2016-12-07 03:00:00,706,530,793,294,1087,1617,2016-12-07 03:00:00,706,98099,97699
"4507",16948,2016-12-07 04:00:00,706,630,406,224,72,152,2016-12-07 04:00:00,706,390,446,157,603,993,2016-12-07 04:00:00,706,91459,91127
"4508",16949,2016-12-07 05:00:00,706,517,347,170,48,122,2016-12-07 05:00:00,706,254,291,109,400,654,2016-12-07 05:00:00,706,86174,85793
"4509",16950,2016-12-07 06:00:00,706,389,256,133,34,99,2016-12-07 06:00:00,706,129,143,60,203,332,2016-12-07 06:00:00,706,86926,86561
"4510",16951,2016-12-07 07:00:00,706,324,226,98,28,70,2016-12-07 07:00:00,706,72,96,34,130,202,2016-12-07 07:00:00,706,88613,88173
"4511",16952,2016-12-07 08:00:00,706,273,212,61,17,44,2016-12-07 08:00:00,706,54,48,26,74,128,2016-12-07 08:00:00,706,89566,89137
"4512",16953,2016-12-07 09:00:00,706,275,204,71,21,50,2016-12-07 09:00:00,706,57,30,19,49,106,2016-12-07 09:00:00,706,92486,91993
"4513",16954,2016-12-07 10:00:00,706,278,212,66,22,44,2016-12-07 10:00:00,706,67,27,9,36,103,2016-12-07 10:00:00,706,91368,90934
"4514",16955,2016-12-07 11:00:00,706,258,215,43,20,23,2016-12-07 11:00:00,706,91,67,32,99,190,2016-12-07 11:00:00,706,95418,95014
"4515",16956,2016-12-07 12:00:00,706,314,260,54,15,39,2016-12-07 12:00:00,706,210,148,79,227,437,2016-12-07 12:00:00,706,117208,116784
"4516",16957,2016-12-07 13:00:00,706,473,393,80,29,51,2016-12-07 13:00:00,706,429,318,157,475,904,2016-12-07 13:00:00,706,158410,157820
"4517",16958,2016-12-07 14:00:00,706,536,434,102,29,73,2016-12-07 14:00:00,706,715,499,262,761,1476,2016-12-07 14:00:00,706,189958,189263
"4518",16959,2016-12-07 15:00:00,706,610,486,124,37,87,2016-12-07 15:00:00,706,911,595,302,897,1808,2016-12-07 15:00:00,706,199438,198623
"4519",16960,2016-12-07 16:00:00,706,698,559,139,57,82,2016-12-07 16:00:00,706,882,679,316,995,1877,2016-12-07 16:00:00,706,198318,197504
"4520",16961,2016-12-07 17:00:00,706,765,619,146,59,87,2016-12-07 17:00:00,706,990,714,342,1056,2046,2016-12-07 17:00:00,706,184444,183675
"4521",16962,2016-12-07 18:00:00,706,810,613,197,63,134,2016-12-07 18:00:00,706,1201,794,355,1149,2350,2016-12-07 18:00:00,706,181209,180433
"4522",16963,2016-12-07 19:00:00,706,769,565,204,71,133,2016-12-07 19:00:00,706,1211,866,350,1216,2427,2016-12-07 19:00:00,706,179853,179135
"4523",16964,2016-12-07 20:00:00,706,785,582,203,70,133,2016-12-07 20:00:00,706,1194,1010,417,1427,2621,2016-12-07 20:00:00,706,169669,168919
"4524",16965,2016-12-07 21:00:00,706,798,556,242,69,173,2016-12-07 21:00:00,706,1245,1150,452,1602,2847,2016-12-07 21:00:00,706,154302,153652
"4525",16966,2016-12-07 22:00:00,706,852,545,307,83,224,2016-12-07 22:00:00,706,1075,1334,489,1823,2898,2016-12-07 22:00:00,706,130983,130438
"4526",16967,2016-12-07 23:00:00,706,856,564,292,71,221,2016-12-07 23:00:00,706,912,1252,458,1710,2622,2016-12-07 23:00:00,706,111298,110806
"4527",16968,2016-12-08 00:00:00,707,841,525,316,96,220,2016-12-08 00:00:00,707,841,1218,430,1648,2489,2016-12-08 00:00:00,707,105726,105249
"4528",16969,2016-12-08 01:00:00,707,766,479,287,86,201,2016-12-08 01:00:00,707,708,1054,351,1405,2113,2016-12-08 01:00:00,707,105782,105381
"4529",16970,2016-12-08 02:00:00,707,770,483,287,86,201,2016-12-08 02:00:00,707,613,873,332,1205,1818,2016-12-08 02:00:00,707,102335,101849
"4530",16971,2016-12-08 03:00:00,707,689,460,229,73,156,2016-12-08 03:00:00,707,501,668,259,927,1428,2016-12-08 03:00:00,707,98295,97855
"4531",16972,2016-12-08 04:00:00,707,615,438,177,58,119,2016-12-08 04:00:00,707,386,454,160,614,1000,2016-12-08 04:00:00,707,93184,92797
"4532",16973,2016-12-08 05:00:00,707,503,319,184,52,132,2016-12-08 05:00:00,707,245,313,120,433,678,2016-12-08 05:00:00,707,87715,87342
"4533",16974,2016-12-08 06:00:00,707,395,269,126,42,84,2016-12-08 06:00:00,707,137,135,45,180,317,2016-12-08 06:00:00,707,88932,88563
"4534",16975,2016-12-08 07:00:00,707,290,201,89,29,60,2016-12-08 07:00:00,707,96,73,24,97,193,2016-12-08 07:00:00,707,90807,90412
"4535",16976,2016-12-08 08:00:00,707,270,209,61,22,39,2016-12-08 08:00:00,707,70,48,18,66,136,2016-12-08 08:00:00,707,91156,90758
"4536",16977,2016-12-08 09:00:00,707,228,178,50,18,32,2016-12-08 09:00:00,707,47,44,21,65,112,2016-12-08 09:00:00,707,93619,93204
"4537",16978,2016-12-08 10:00:00,707,242,195,47,22,25,2016-12-08 10:00:00,707,72,19,7,26,98,2016-12-08 10:00:00,707,93200,92778
"4538",16979,2016-12-08 11:00:00,707,280,244,36,15,21,2016-12-08 11:00:00,707,102,53,31,84,186,2016-12-08 11:00:00,707,101495,101094
"4539",16980,2016-12-08 12:00:00,707,317,269,48,8,40,2016-12-08 12:00:00,707,200,89,50,139,339,2016-12-08 12:00:00,707,140338,139888
"4540",16981,2016-12-08 13:00:00,707,460,379,81,29,52,2016-12-08 13:00:00,707,460,282,134,416,876,2016-12-08 13:00:00,707,205933,205374
"4541",16982,2016-12-08 14:00:00,707,529,448,81,31,50,2016-12-08 14:00:00,707,700,454,230,684,1384,2016-12-08 14:00:00,707,244210,243515
"4542",16983,2016-12-08 15:00:00,707,571,460,111,39,72,2016-12-08 15:00:00,707,803,545,253,798,1601,2016-12-08 15:00:00,707,245355,244559
"4543",16984,2016-12-08 16:00:00,707,700,561,139,50,89,2016-12-08 16:00:00,707,947,607,282,889,1836,2016-12-08 16:00:00,707,237799,237021
"4544",16985,2016-12-08 17:00:00,707,725,549,176,63,113,2016-12-08 17:00:00,707,1085,716,340,1056,2141,2016-12-08 17:00:00,707,216799,216044
"4545",16986,2016-12-08 18:00:00,707,716,541,175,68,107,2016-12-08 18:00:00,707,1095,819,328,1147,2242,2016-12-08 18:00:00,707,210080,209357
"4546",16987,2016-12-08 19:00:00,707,787,610,177,50,127,2016-12-08 19:00:00,707,1229,820,353,1173,2402,2016-12-08 19:00:00,707,208311,207533
"4547",16988,2016-12-08 20:00:00,707,820,567,253,75,178,2016-12-08 20:00:00,707,1232,1000,433,1433,2665,2016-12-08 20:00:00,707,193392,192653
"4548",16989,2016-12-08 21:00:00,707,791,557,234,67,167,2016-12-08 21:00:00,707,1151,1166,503,1669,2820,2016-12-08 21:00:00,707,175420,174780
"4549",16990,2016-12-08 22:00:00,707,783,538,245,85,160,2016-12-08 22:00:00,707,1085,1197,493,1690,2775,2016-12-08 22:00:00,707,143974,143397
"4550",16991,2016-12-08 23:00:00,707,787,537,250,75,175,2016-12-08 23:00:00,707,1014,1238,463,1701,2715,2016-12-08 23:00:00,707,118158,117701
"4551",16992,2016-12-09 00:00:00,708,743,463,280,88,192,2016-12-09 00:00:00,708,814,1090,377,1467,2281,2016-12-09 00:00:00,708,109839,109437
"4552",16993,2016-12-09 01:00:00,708,794,509,285,79,206,2016-12-09 01:00:00,708,775,993,366,1359,2134,2016-12-09 01:00:00,708,105422,104963
"4553",16994,2016-12-09 02:00:00,708,776,491,285,96,189,2016-12-09 02:00:00,708,551,833,325,1158,1709,2016-12-09 02:00:00,708,99316,98888
"4554",16995,2016-12-09 03:00:00,708,617,408,209,71,138,2016-12-09 03:00:00,708,470,627,237,864,1334,2016-12-09 03:00:00,708,94550,94126
"4555",16996,2016-12-09 04:00:00,708,536,345,191,60,131,2016-12-09 04:00:00,708,323,421,149,570,893,2016-12-09 04:00:00,708,86334,85991
"4556",16997,2016-12-09 05:00:00,708,463,290,173,47,126,2016-12-09 05:00:00,708,190,302,122,424,614,2016-12-09 05:00:00,708,79681,79347
"4557",16998,2016-12-09 06:00:00,708,367,255,112,26,86,2016-12-09 06:00:00,708,164,171,61,232,396,2016-12-09 06:00:00,708,80532,80155
"4558",16999,2016-12-09 07:00:00,708,288,218,70,17,53,2016-12-09 07:00:00,708,76,91,38,129,205,2016-12-09 07:00:00,708,80437,80068
"4559",17000,2016-12-09 08:00:00,708,248,198,50,13,37,2016-12-09 08:00:00,708,60,59,17,76,136,2016-12-09 08:00:00,708,80842,80482
"4560",17001,2016-12-09 09:00:00,708,272,207,65,20,45,2016-12-09 09:00:00,708,58,35,10,45,103,2016-12-09 09:00:00,708,83306,82906
"4561",17002,2016-12-09 10:00:00,708,267,217,50,19,31,2016-12-09 10:00:00,708,94,42,21,63,157,2016-12-09 10:00:00,708,84572,84210
"4562",17003,2016-12-09 11:00:00,708,228,194,34,12,22,2016-12-09 11:00:00,708,112,70,36,106,218,2016-12-09 11:00:00,708,93571,93181
"4563",17004,2016-12-09 12:00:00,708,327,263,64,23,41,2016-12-09 12:00:00,708,247,137,60,197,444,2016-12-09 12:00:00,708,131858,131404
"4564",17005,2016-12-09 13:00:00,708,446,367,79,24,55,2016-12-09 13:00:00,708,553,315,151,466,1019,2016-12-09 13:00:00,708,190374,189799
"4565",17006,2016-12-09 14:00:00,708,477,369,108,36,72,2016-12-09 14:00:00,708,877,439,207,646,1523,2016-12-09 14:00:00,708,219567,218856
"4566",17007,2016-12-09 15:00:00,708,608,482,126,38,88,2016-12-09 15:00:00,708,960,604,291,895,1855,2016-12-09 15:00:00,708,220851,220085
"4567",17008,2016-12-09 16:00:00,708,658,527,131,41,90,2016-12-09 16:00:00,708,1054,693,304,997,2051,2016-12-09 16:00:00,708,215804,214986
"4568",17009,2016-12-09 17:00:00,708,685,515,170,62,108,2016-12-09 17:00:00,708,982,737,333,1070,2052,2016-12-09 17:00:00,708,194541,193815
"4569",17010,2016-12-09 18:00:00,708,716,530,186,60,126,2016-12-09 18:00:00,708,1089,826,348,1174,2263,2016-12-09 18:00:00,708,187254,186504
"4570",17011,2016-12-09 19:00:00,708,715,542,173,52,121,2016-12-09 19:00:00,708,1102,860,344,1204,2306,2016-12-09 19:00:00,708,184412,183698
"4571",17012,2016-12-09 20:00:00,708,761,510,251,70,181,2016-12-09 20:00:00,708,1173,1123,444,1567,2740,2016-12-09 20:00:00,708,170803,170119
"4572",17013,2016-12-09 21:00:00,708,766,509,257,77,180,2016-12-09 21:00:00,708,1147,1092,457,1549,2696,2016-12-09 21:00:00,708,152934,152300
"4573",17014,2016-12-09 22:00:00,708,826,551,275,72,203,2016-12-09 22:00:00,708,900,1306,517,1823,2723,2016-12-09 22:00:00,708,130345,129797
"4574",17015,2016-12-09 23:00:00,708,767,464,303,93,210,2016-12-09 23:00:00,708,822,1296,506,1802,2624,2016-12-09 23:00:00,708,109478,109030
"4575",17016,2016-12-10 00:00:00,709,793,461,332,94,238,2016-12-10 00:00:00,709,695,1238,470,1708,2403,2016-12-10 00:00:00,709,97771,97340
"4576",17017,2016-12-10 01:00:00,709,795,498,297,74,223,2016-12-10 01:00:00,709,597,1239,468,1707,2304,2016-12-10 01:00:00,709,92576,92168
"4577",17018,2016-12-10 02:00:00,709,692,417,275,81,194,2016-12-10 02:00:00,709,520,1120,397,1517,2037,2016-12-10 02:00:00,709,88197,87823
"4578",17019,2016-12-10 03:00:00,709,644,400,244,71,173,2016-12-10 03:00:00,709,352,815,304,1119,1471,2016-12-10 03:00:00,709,85150,84808
"4579",17020,2016-12-10 04:00:00,709,599,342,257,70,187,2016-12-10 04:00:00,709,291,615,225,840,1131,2016-12-10 04:00:00,709,81190,80848
"4580",17021,2016-12-10 05:00:00,709,541,298,243,79,164,2016-12-10 05:00:00,709,176,472,162,634,810,2016-12-10 05:00:00,709,74647,74330
"4581",17022,2016-12-10 06:00:00,709,464,278,186,56,130,2016-12-10 06:00:00,709,126,207,83,290,416,2016-12-10 06:00:00,709,69702,69394
"4582",17023,2016-12-10 07:00:00,709,366,258,108,29,79,2016-12-10 07:00:00,709,74,109,35,144,218,2016-12-10 07:00:00,709,65691,65416
"4583",17024,2016-12-10 08:00:00,709,232,170,62,22,40,2016-12-10 08:00:00,709,64,57,21,78,142,2016-12-10 08:00:00,709,62981,62700
"4584",17025,2016-12-10 09:00:00,709,241,177,64,19,45,2016-12-10 09:00:00,709,55,33,17,50,105,2016-12-10 09:00:00,709,62743,62486
"4585",17026,2016-12-10 10:00:00,709,267,196,71,25,46,2016-12-10 10:00:00,709,72,43,19,62,134,2016-12-10 10:00:00,709,63903,63607
"4586",17027,2016-12-10 11:00:00,709,267,192,75,20,55,2016-12-10 11:00:00,709,84,53,26,79,163,2016-12-10 11:00:00,709,68899,68617
"4587",17028,2016-12-10 12:00:00,709,303,218,85,29,56,2016-12-10 12:00:00,709,163,99,51,150,313,2016-12-10 12:00:00,709,80180,79892
"4588",17029,2016-12-10 13:00:00,709,432,303,129,34,95,2016-12-10 13:00:00,709,265,267,126,393,658,2016-12-10 13:00:00,709,94462,94104
"4589",17030,2016-12-10 14:00:00,709,597,410,187,62,125,2016-12-10 14:00:00,709,532,575,249,824,1356,2016-12-10 14:00:00,709,106334,105928
"4590",17031,2016-12-10 15:00:00,709,662,465,197,64,133,2016-12-10 15:00:00,709,695,778,340,1118,1813,2016-12-10 15:00:00,709,113721,113242
"4591",17032,2016-12-10 16:00:00,709,801,523,278,97,180,2016-12-10 16:00:00,709,781,1003,418,1421,2202,2016-12-10 16:00:00,709,115809,115302
"4592",17033,2016-12-10 17:00:00,709,846,569,277,76,201,2016-12-10 17:00:00,709,853,1113,443,1556,2409,2016-12-10 17:00:00,709,114205,113686
"4593",17034,2016-12-10 18:00:00,709,849,545,304,83,221,2016-12-10 18:00:00,709,933,1285,471,1756,2689,2016-12-10 18:00:00,709,109519,108961
"4594",17035,2016-12-10 19:00:00,709,833,518,315,102,213,2016-12-10 19:00:00,709,814,1223,482,1705,2519,2016-12-10 19:00:00,709,105177,104639
"4595",17036,2016-12-10 20:00:00,709,799,466,333,123,210,2016-12-10 20:00:00,709,869,1197,473,1670,2539,2016-12-10 20:00:00,709,99787,99344
"4596",17037,2016-12-10 21:00:00,709,856,529,327,87,240,2016-12-10 21:00:00,709,723,1267,444,1711,2434,2016-12-10 21:00:00,709,94989,94537
"4597",17038,2016-12-10 22:00:00,709,958,543,415,107,308,2016-12-10 22:00:00,709,649,1230,407,1637,2286,2016-12-10 22:00:00,709,91318,90913
"4598",17039,2016-12-10 23:00:00,709,876,473,403,136,267,2016-12-10 23:00:00,709,575,1134,414,1548,2123,2016-12-10 23:00:00,709,84658,84293
"4599",17040,2016-12-11 00:00:00,710,861,469,392,127,265,2016-12-11 00:00:00,710,537,1162,424,1586,2123,2016-12-11 00:00:00,710,80792,80430
"4600",17041,2016-12-11 01:00:00,710,842,497,345,105,240,2016-12-11 01:00:00,710,461,1074,398,1472,1933,2016-12-11 01:00:00,710,79442,79098
"4601",17042,2016-12-11 02:00:00,710,875,521,354,136,218,2016-12-11 02:00:00,710,411,894,330,1224,1635,2016-12-11 02:00:00,710,77788,77436
"4602",17043,2016-12-11 03:00:00,710,854,481,373,102,271,2016-12-11 03:00:00,710,306,675,244,919,1225,2016-12-11 03:00:00,710,76335,75987
"4603",17044,2016-12-11 04:00:00,710,669,388,281,76,205,2016-12-11 04:00:00,710,205,507,180,687,892,2016-12-11 04:00:00,710,74639,74309
"4604",17045,2016-12-11 05:00:00,710,621,348,273,75,198,2016-12-11 05:00:00,710,187,402,132,534,721,2016-12-11 05:00:00,710,68999,68706
"4605",17046,2016-12-11 06:00:00,710,497,279,218,59,159,2016-12-11 06:00:00,710,94,349,105,454,548,2016-12-11 06:00:00,710,64911,64646
"4606",17047,2016-12-11 07:00:00,710,365,226,139,48,91,2016-12-11 07:00:00,710,64,134,53,187,251,2016-12-11 07:00:00,710,60561,60290
"4607",17048,2016-12-11 08:00:00,710,298,188,110,30,80,2016-12-11 08:00:00,710,40,79,22,101,141,2016-12-11 08:00:00,710,59566,59328
"4608",17049,2016-12-11 09:00:00,710,205,146,59,19,40,2016-12-11 09:00:00,710,44,42,19,61,105,2016-12-11 09:00:00,710,58630,58356
"4609",17050,2016-12-11 10:00:00,710,212,160,52,18,34,2016-12-11 10:00:00,710,51,41,12,53,104,2016-12-11 10:00:00,710,58979,58721
"4610",17051,2016-12-11 11:00:00,710,225,181,44,22,22,2016-12-11 11:00:00,710,54,30,12,42,96,2016-12-11 11:00:00,710,63173,62902
"4611",17052,2016-12-11 12:00:00,710,289,218,71,31,40,2016-12-11 12:00:00,710,108,100,49,149,257,2016-12-11 12:00:00,710,71822,71538
"4612",17053,2016-12-11 13:00:00,710,380,281,99,30,69,2016-12-11 13:00:00,710,220,204,87,291,511,2016-12-11 13:00:00,710,83054,82709
"4613",17054,2016-12-11 14:00:00,710,546,376,170,49,121,2016-12-11 14:00:00,710,351,469,191,660,1011,2016-12-11 14:00:00,710,92427,92044
"4614",17055,2016-12-11 15:00:00,710,588,415,173,53,120,2016-12-11 15:00:00,710,457,831,342,1173,1630,2016-12-11 15:00:00,710,99589,99153
"4615",17056,2016-12-11 16:00:00,710,699,483,216,70,146,2016-12-11 16:00:00,710,561,960,359,1319,1880,2016-12-11 16:00:00,710,105726,105241
"4616",17057,2016-12-11 17:00:00,710,817,527,290,109,181,2016-12-11 17:00:00,710,593,1152,437,1589,2182,2016-12-11 17:00:00,710,107458,106978
"4617",17058,2016-12-11 18:00:00,710,874,554,320,99,221,2016-12-11 18:00:00,710,596,1112,452,1564,2160,2016-12-11 18:00:00,710,106402,105915
"4618",17059,2016-12-11 19:00:00,710,779,505,274,87,187,2016-12-11 19:00:00,710,698,1122,399,1521,2219,2016-12-11 19:00:00,710,103841,103311
"4619",17060,2016-12-11 20:00:00,710,863,516,347,104,243,2016-12-11 20:00:00,710,672,1157,430,1587,2259,2016-12-11 20:00:00,710,100625,100131
"4620",17061,2016-12-11 21:00:00,710,821,498,323,111,212,2016-12-11 21:00:00,710,741,1142,384,1526,2267,2016-12-11 21:00:00,710,97670,97233
"4621",17062,2016-12-11 22:00:00,710,771,481,290,98,192,2016-12-11 22:00:00,710,700,1139,395,1534,2234,2016-12-11 22:00:00,710,94998,94569
"4622",17063,2016-12-11 23:00:00,710,744,423,321,101,220,2016-12-11 23:00:00,710,583,1240,399,1639,2222,2016-12-11 23:00:00,710,91533,91127
"4623",17064,2016-12-12 00:00:00,711,721,447,274,77,197,2016-12-12 00:00:00,711,542,1061,382,1443,1985,2016-12-12 00:00:00,711,96635,96212
"4624",17065,2016-12-12 01:00:00,711,885,557,328,103,225,2016-12-12 01:00:00,711,498,931,361,1292,1790,2016-12-12 01:00:00,711,102827,102406
"4625",17066,2016-12-12 02:00:00,711,786,486,300,93,207,2016-12-12 02:00:00,711,382,610,231,841,1223,2016-12-12 02:00:00,711,98292,97892
"4626",17067,2016-12-12 03:00:00,711,788,473,315,112,203,2016-12-12 03:00:00,711,260,570,220,790,1050,2016-12-12 03:00:00,711,97316,96929
"4627",17068,2016-12-12 04:00:00,711,635,419,216,53,163,2016-12-12 04:00:00,711,195,347,127,474,669,2016-12-12 04:00:00,711,94117,93753
"4628",17069,2016-12-12 05:00:00,711,561,373,188,63,125,2016-12-12 05:00:00,711,151,278,93,371,522,2016-12-12 05:00:00,711,90252,89899
"4629",17070,2016-12-12 06:00:00,711,587,320,267,59,208,2016-12-12 06:00:00,711,86,672,150,822,908,2016-12-12 06:00:00,711,92095,91714
"4630",17071,2016-12-12 07:00:00,711,483,278,205,47,158,2016-12-12 07:00:00,711,60,468,120,588,648,2016-12-12 07:00:00,711,91158,90795
"4631",17072,2016-12-12 08:00:00,711,311,214,97,29,68,2016-12-12 08:00:00,711,55,42,19,61,116,2016-12-12 08:00:00,711,91642,91250
"4632",17073,2016-12-12 09:00:00,711,244,193,51,13,38,2016-12-12 09:00:00,711,55,39,14,53,108,2016-12-12 09:00:00,711,92109,91726
"4633",17074,2016-12-12 10:00:00,711,237,187,50,19,31,2016-12-12 10:00:00,711,50,25,12,37,87,2016-12-12 10:00:00,711,96411,96008
"4634",17075,2016-12-12 11:00:00,711,285,246,39,16,23,2016-12-12 11:00:00,711,84,49,20,69,153,2016-12-12 11:00:00,711,113730,113302
"4635",17076,2016-12-12 12:00:00,711,298,239,59,23,36,2016-12-12 12:00:00,711,152,124,58,182,334,2016-12-12 12:00:00,711,183252,182768
"4636",17077,2016-12-12 13:00:00,711,476,399,77,33,44,2016-12-12 13:00:00,711,396,306,163,469,865,2016-12-12 13:00:00,711,282833,282223
"4637",17078,2016-12-12 14:00:00,711,510,409,101,47,54,2016-12-12 14:00:00,711,678,583,283,866,1544,2016-12-12 14:00:00,711,313888,313131
"4638",17079,2016-12-12 15:00:00,711,744,549,195,37,158,2016-12-12 15:00:00,711,827,1131,434,1565,2392,2016-12-12 15:00:00,711,291639,290800
"4639",17080,2016-12-12 16:00:00,711,1020,673,347,76,271,2016-12-12 16:00:00,711,933,2046,705,2751,3684,2016-12-12 16:00:00,711,273828,272920
"4640",17081,2016-12-12 17:00:00,711,858,625,233,73,160,2016-12-12 17:00:00,711,977,1122,479,1601,2578,2016-12-12 17:00:00,711,236184,235378
"4641",17082,2016-12-12 18:00:00,711,764,574,190,59,131,2016-12-12 18:00:00,711,955,991,416,1407,2362,2016-12-12 18:00:00,711,220283,219457
"4642",17083,2016-12-12 19:00:00,711,786,590,196,55,141,2016-12-12 19:00:00,711,1069,1137,474,1611,2680,2016-12-12 19:00:00,711,211938,211153
"4643",17084,2016-12-12 20:00:00,711,855,600,255,99,156,2016-12-12 20:00:00,711,1080,1165,462,1627,2707,2016-12-12 20:00:00,711,197855,197043
"4644",17085,2016-12-12 21:00:00,711,862,624,238,84,153,2016-12-12 21:00:00,711,1090,1336,546,1882,2972,2016-12-12 21:00:00,711,177442,176758
"4645",17086,2016-12-12 22:00:00,711,929,625,304,119,185,2016-12-12 22:00:00,711,964,1543,677,2220,3184,2016-12-12 22:00:00,711,148636,148088
"4646",17087,2016-12-12 23:00:00,711,832,556,276,86,190,2016-12-12 23:00:00,711,888,1585,632,2217,3105,2016-12-12 23:00:00,711,123853,123360
"4647",17088,2016-12-13 00:00:00,712,905,574,331,100,231,2016-12-13 00:00:00,712,779,1473,616,2089,2868,2016-12-13 00:00:00,712,116027,115581
"4648",17089,2016-12-13 01:00:00,712,937,570,367,123,244,2016-12-13 01:00:00,712,641,1281,553,1834,2475,2016-12-13 01:00:00,712,113332,112892
"4649",17090,2016-12-13 02:00:00,712,863,553,310,98,212,2016-12-13 02:00:00,712,608,1182,452,1634,2242,2016-12-13 02:00:00,712,105743,105313
"4650",17091,2016-12-13 03:00:00,712,737,459,278,92,186,2016-12-13 03:00:00,712,394,833,348,1181,1575,2016-12-13 03:00:00,712,100437,100045
"4651",17092,2016-12-13 04:00:00,712,649,418,231,82,149,2016-12-13 04:00:00,712,284,618,242,860,1144,2016-12-13 04:00:00,712,92781,92426
"4652",17093,2016-12-13 05:00:00,712,573,349,224,73,151,2016-12-13 05:00:00,712,177,624,155,779,956,2016-12-13 05:00:00,712,87630,87286
"4653",17094,2016-12-13 06:00:00,712,492,286,206,50,156,2016-12-13 06:00:00,712,115,255,91,346,461,2016-12-13 06:00:00,712,87774,87393
"4654",17095,2016-12-13 07:00:00,712,368,241,127,44,83,2016-12-13 07:00:00,712,80,109,43,152,232,2016-12-13 07:00:00,712,89122,88732
"4655",17096,2016-12-13 08:00:00,712,301,218,83,26,57,2016-12-13 08:00:00,712,51,75,27,102,153,2016-12-13 08:00:00,712,90191,89775
"4656",17097,2016-12-13 09:00:00,712,272,201,71,29,42,2016-12-13 09:00:00,712,55,36,14,50,105,2016-12-13 09:00:00,712,91875,91453
"4657",17098,2016-12-13 10:00:00,712,265,186,79,23,56,2016-12-13 10:00:00,712,50,40,18,58,108,2016-12-13 10:00:00,712,91962,91533
"4658",17099,2016-12-13 11:00:00,712,296,228,68,19,49,2016-12-13 11:00:00,712,72,47,23,70,142,2016-12-13 11:00:00,712,98539,98122
"4659",17100,2016-12-13 12:00:00,712,322,254,68,19,49,2016-12-13 12:00:00,712,122,129,58,187,309,2016-12-13 12:00:00,712,131150,130671
"4660",17101,2016-12-13 13:00:00,712,471,352,119,38,81,2016-12-13 13:00:00,712,334,500,192,692,1026,2016-12-13 13:00:00,712,186277,185722
"4661",17102,2016-12-13 14:00:00,712,595,479,116,47,69,2016-12-13 14:00:00,712,609,581,281,862,1471,2016-12-13 14:00:00,712,216607,215823
"4662",17103,2016-12-13 15:00:00,712,624,493,131,42,89,2016-12-13 15:00:00,712,673,761,339,1100,1773,2016-12-13 15:00:00,712,219883,219100
"4663",17104,2016-12-13 16:00:00,712,663,503,160,51,109,2016-12-13 16:00:00,712,786,821,368,1189,1975,2016-12-13 16:00:00,712,215061,214237
"4664",17105,2016-12-13 17:00:00,712,738,551,187,62,125,2016-12-13 17:00:00,712,814,897,380,1277,2091,2016-12-13 17:00:00,712,196140,195367
"4665",17106,2016-12-13 18:00:00,712,764,553,211,72,139,2016-12-13 18:00:00,712,874,1038,448,1486,2360,2016-12-13 18:00:00,712,190331,189535
"4666",17107,2016-12-13 19:00:00,712,803,569,234,57,177,2016-12-13 19:00:00,712,893,994,449,1443,2336,2016-12-13 19:00:00,712,189378,188582
"4667",17108,2016-12-13 20:00:00,712,841,567,274,100,174,2016-12-13 20:00:00,712,903,1301,508,1809,2712,2016-12-13 20:00:00,712,178659,177902
"4668",17109,2016-12-13 21:00:00,712,902,607,295,86,209,2016-12-13 21:00:00,712,809,1560,631,2191,3000,2016-12-13 21:00:00,712,162991,162278
"4669",17110,2016-12-13 22:00:00,712,957,585,372,117,255,2016-12-13 22:00:00,712,778,1673,653,2326,3104,2016-12-13 22:00:00,712,137681,137072
"4670",17111,2016-12-13 23:00:00,712,977,597,380,103,277,2016-12-13 23:00:00,712,686,1815,643,2458,3144,2016-12-13 23:00:00,712,117341,116827
"4671",17112,2016-12-14 00:00:00,713,965,574,391,77,314,2016-12-14 00:00:00,713,629,1759,590,2349,2978,2016-12-14 00:00:00,713,110153,109717
"4672",17113,2016-12-14 01:00:00,713,898,552,346,81,265,2016-12-14 01:00:00,713,552,1606,564,2170,2722,2016-12-14 01:00:00,713,106936,106447
"4673",17114,2016-12-14 02:00:00,713,866,538,328,95,233,2016-12-14 02:00:00,713,500,1220,382,1602,2102,2016-12-14 02:00:00,713,101888,101444
"4674",17115,2016-12-14 03:00:00,713,783,500,283,93,190,2016-12-14 03:00:00,713,359,1151,421,1572,1931,2016-12-14 03:00:00,713,98350,97925
"4675",17116,2016-12-14 04:00:00,713,662,393,269,85,184,2016-12-14 04:00:00,713,218,754,258,1012,1230,2016-12-14 04:00:00,713,93630,93222
"4676",17117,2016-12-14 05:00:00,713,545,320,225,69,156,2016-12-14 05:00:00,713,150,408,130,538,688,2016-12-14 05:00:00,713,87623,87226
"4677",17118,2016-12-14 06:00:00,713,433,272,161,35,126,2016-12-14 06:00:00,713,85,207,84,291,376,2016-12-14 06:00:00,713,87716,87326
"4678",17119,2016-12-14 07:00:00,713,332,208,124,38,86,2016-12-14 07:00:00,713,60,83,34,117,177,2016-12-14 07:00:00,713,87935,87504
"4679",17120,2016-12-14 08:00:00,713,285,202,83,21,62,2016-12-14 08:00:00,713,41,59,13,72,113,2016-12-14 08:00:00,713,93230,92747
"4680",17121,2016-12-14 09:00:00,713,250,185,65,19,46,2016-12-14 09:00:00,713,37,48,16,64,101,2016-12-14 09:00:00,713,94978,94483
"4681",17122,2016-12-14 10:00:00,713,269,196,73,23,50,2016-12-14 10:00:00,713,41,46,16,62,103,2016-12-14 10:00:00,713,93214,92817
"4682",17123,2016-12-14 11:00:00,713,265,199,66,29,37,2016-12-14 11:00:00,713,74,68,22,90,164,2016-12-14 11:00:00,713,100120,99700
"4683",17124,2016-12-14 12:00:00,713,293,223,70,20,50,2016-12-14 12:00:00,713,122,162,51,213,335,2016-12-14 12:00:00,713,122695,122204
"4684",17125,2016-12-14 13:00:00,713,403,297,106,38,68,2016-12-14 13:00:00,713,336,333,144,477,813,2016-12-14 13:00:00,713,165630,165031
"4685",17126,2016-12-14 14:00:00,713,580,427,153,53,100,2016-12-14 14:00:00,713,566,679,275,954,1520,2016-12-14 14:00:00,713,197783,196996
"4686",17127,2016-12-14 15:00:00,713,674,493,181,66,115,2016-12-14 15:00:00,713,722,770,288,1058,1780,2016-12-14 15:00:00,713,206530,205688
"4687",17128,2016-12-14 16:00:00,713,724,554,170,39,131,2016-12-14 16:00:00,713,771,930,376,1306,2077,2016-12-14 16:00:00,713,206983,206098
"4688",17129,2016-12-14 17:00:00,713,816,591,225,70,155,2016-12-14 17:00:00,713,808,955,371,1326,2134,2016-12-14 17:00:00,713,190066,189264
"4689",17130,2016-12-14 18:00:00,713,783,533,250,66,184,2016-12-14 18:00:00,713,850,1048,405,1453,2303,2016-12-14 18:00:00,713,184567,183738
"4690",17131,2016-12-14 19:00:00,713,878,582,296,82,214,2016-12-14 19:00:00,713,856,1108,435,1543,2399,2016-12-14 19:00:00,713,182690,181892
"4691",17132,2016-12-14 20:00:00,713,902,621,281,91,190,2016-12-14 20:00:00,713,860,1254,444,1698,2558,2016-12-14 20:00:00,713,171124,170373
"4692",17133,2016-12-14 21:00:00,713,984,612,372,104,268,2016-12-14 21:00:00,713,823,1485,552,2037,2860,2016-12-14 21:00:00,713,156144,155447
"4693",17134,2016-12-14 22:00:00,713,941,578,363,114,249,2016-12-14 22:00:00,713,840,1555,565,2120,2960,2016-12-14 22:00:00,713,135651,135052
"4694",17135,2016-12-14 23:00:00,713,914,558,356,88,268,2016-12-14 23:00:00,713,711,1559,518,2077,2788,2016-12-14 23:00:00,713,115801,115333
"4695",17136,2016-12-15 00:00:00,714,845,526,319,93,226,2016-12-15 00:00:00,714,627,1476,495,1971,2598,2016-12-15 00:00:00,714,109531,109082
"4696",17137,2016-12-15 01:00:00,714,902,556,346,109,237,2016-12-15 01:00:00,714,481,1348,404,1752,2233,2016-12-15 01:00:00,714,109440,108986
"4697",17138,2016-12-15 02:00:00,714,808,490,318,88,230,2016-12-15 02:00:00,714,464,1104,358,1462,1926,2016-12-15 02:00:00,714,104031,103556
"4698",17139,2016-12-15 03:00:00,714,754,493,261,79,182,2016-12-15 03:00:00,714,383,865,278,1143,1526,2016-12-15 03:00:00,714,99682,99237
"4699",17140,2016-12-15 04:00:00,714,616,401,215,67,148,2016-12-15 04:00:00,714,257,576,206,782,1039,2016-12-15 04:00:00,714,93630,93218
"4700",17141,2016-12-15 05:00:00,714,535,329,206,70,136,2016-12-15 05:00:00,714,169,370,156,526,695,2016-12-15 05:00:00,714,88204,87824
"4701",17142,2016-12-15 06:00:00,714,420,265,155,50,105,2016-12-15 06:00:00,714,131,198,82,280,411,2016-12-15 06:00:00,714,89248,88869
"4702",17143,2016-12-15 07:00:00,714,286,220,66,21,45,2016-12-15 07:00:00,714,94,94,35,129,223,2016-12-15 07:00:00,714,90699,90267
"4703",17144,2016-12-15 08:00:00,714,260,186,74,30,44,2016-12-15 08:00:00,714,54,44,16,60,114,2016-12-15 08:00:00,714,93518,93119
"4704",17145,2016-12-15 09:00:00,714,236,175,61,18,43,2016-12-15 09:00:00,714,42,41,14,55,97,2016-12-15 09:00:00,714,95814,95364
"4705",17146,2016-12-15 10:00:00,714,260,209,51,23,28,2016-12-15 10:00:00,714,47,28,16,44,91,2016-12-15 10:00:00,714,94869,94440
"4706",17147,2016-12-15 11:00:00,714,238,183,55,24,31,2016-12-15 11:00:00,714,73,54,22,76,149,2016-12-15 11:00:00,714,103155,102728
"4707",17148,2016-12-15 12:00:00,714,265,196,69,25,44,2016-12-15 12:00:00,714,129,138,74,212,341,2016-12-15 12:00:00,714,141875,141399
"4708",17149,2016-12-15 13:00:00,714,444,343,101,41,60,2016-12-15 13:00:00,714,276,256,126,382,658,2016-12-15 13:00:00,714,206403,205803
"4709",17150,2016-12-15 14:00:00,714,493,373,120,39,81,2016-12-15 14:00:00,714,517,531,263,794,1311,2016-12-15 14:00:00,714,242531,241739
"4710",17151,2016-12-15 15:00:00,714,635,484,151,45,106,2016-12-15 15:00:00,714,674,625,277,902,1576,2016-12-15 15:00:00,714,241691,240870
"4711",17152,2016-12-15 16:00:00,714,697,531,166,58,108,2016-12-15 16:00:00,714,777,742,308,1050,1827,2016-12-15 16:00:00,714,233561,232767
"4712",17153,2016-12-15 17:00:00,714,746,534,212,62,150,2016-12-15 17:00:00,714,726,800,348,1148,1874,2016-12-15 17:00:00,714,212226,211433
"4713",17154,2016-12-15 18:00:00,714,819,577,242,71,171,2016-12-15 18:00:00,714,756,869,354,1223,1979,2016-12-15 18:00:00,714,202157,201436
"4714",17155,2016-12-15 19:00:00,714,785,562,223,68,155,2016-12-15 19:00:00,714,807,987,422,1409,2216,2016-12-15 19:00:00,714,198720,197909
"4715",17156,2016-12-15 20:00:00,714,837,570,267,88,179,2016-12-15 20:00:00,714,800,1112,460,1572,2372,2016-12-15 20:00:00,714,184868,184167
"4716",17157,2016-12-15 21:00:00,714,836,557,279,103,176,2016-12-15 21:00:00,714,764,1268,486,1754,2518,2016-12-15 21:00:00,714,167925,167267
"4717",17158,2016-12-15 22:00:00,714,825,533,292,84,208,2016-12-15 22:00:00,714,688,1318,530,1848,2536,2016-12-15 22:00:00,714,140206,139660
"4718",17159,2016-12-15 23:00:00,714,792,502,290,83,207,2016-12-15 23:00:00,714,602,1301,468,1769,2371,2016-12-15 23:00:00,714,116152,115704
"4719",17160,2016-12-16 00:00:00,715,752,477,275,87,188,2016-12-16 00:00:00,715,555,1241,489,1730,2285,2016-12-16 00:00:00,715,107622,107160
"4720",17161,2016-12-16 01:00:00,715,674,486,188,71,117,2016-12-16 01:00:00,715,474,1191,422,1613,2087,2016-12-16 01:00:00,715,104334,103920
"4721",17162,2016-12-16 02:00:00,715,670,412,258,80,178,2016-12-16 02:00:00,715,416,932,323,1255,1671,2016-12-16 02:00:00,715,99104,98674
"4722",17163,2016-12-16 03:00:00,715,668,443,225,62,163,2016-12-16 03:00:00,715,304,696,292,988,1292,2016-12-16 03:00:00,715,92923,92552
"4723",17164,2016-12-16 04:00:00,715,545,366,179,59,120,2016-12-16 04:00:00,715,231,513,179,692,923,2016-12-16 04:00:00,715,85511,85171
"4724",17165,2016-12-16 05:00:00,715,470,270,200,57,142,2016-12-16 05:00:00,715,113,335,139,474,587,2016-12-16 05:00:00,715,79817,79478
"4725",17166,2016-12-16 06:00:00,715,338,215,123,45,78,2016-12-16 06:00:00,715,121,174,72,246,367,2016-12-16 06:00:00,715,80146,79823
"4726",17167,2016-12-16 07:00:00,715,318,211,107,31,76,2016-12-16 07:00:00,715,75,103,38,141,216,2016-12-16 07:00:00,715,80905,80554
"4727",17168,2016-12-16 08:00:00,715,285,190,95,32,63,2016-12-16 08:00:00,715,60,53,17,70,130,2016-12-16 08:00:00,715,81961,81562
"4728",17169,2016-12-16 09:00:00,715,212,162,50,18,32,2016-12-16 09:00:00,715,35,34,12,46,81,2016-12-16 09:00:00,715,83447,83086
"4729",17170,2016-12-16 10:00:00,715,231,165,66,24,42,2016-12-16 10:00:00,715,45,28,14,42,87,2016-12-16 10:00:00,715,82717,82330
"4730",17171,2016-12-16 11:00:00,715,238,184,54,16,38,2016-12-16 11:00:00,715,66,59,24,83,149,2016-12-16 11:00:00,715,91136,90765
"4731",17172,2016-12-16 12:00:00,715,314,222,92,35,57,2016-12-16 12:00:00,715,121,124,66,190,311,2016-12-16 12:00:00,715,126248,125844
"4732",17173,2016-12-16 13:00:00,715,408,292,116,44,72,2016-12-16 13:00:00,715,290,298,145,443,733,2016-12-16 13:00:00,715,179222,178709
"4733",17174,2016-12-16 14:00:00,715,498,386,112,41,71,2016-12-16 14:00:00,715,464,545,267,812,1276,2016-12-16 14:00:00,715,207567,206914
"4734",17175,2016-12-16 15:00:00,715,576,443,133,38,95,2016-12-16 15:00:00,715,575,623,278,901,1476,2016-12-16 15:00:00,715,205547,204822
"4735",17176,2016-12-16 16:00:00,715,726,533,193,69,123,2016-12-16 16:00:00,715,691,797,355,1152,1843,2016-12-16 16:00:00,715,199812,199081
"4736",17177,2016-12-16 17:00:00,715,676,507,169,52,117,2016-12-16 17:00:00,715,712,886,370,1256,1968,2016-12-16 17:00:00,715,180036,179328
"4737",17178,2016-12-16 18:00:00,715,765,523,242,82,160,2016-12-16 18:00:00,715,711,964,407,1371,2082,2016-12-16 18:00:00,715,169399,168723
"4738",17179,2016-12-16 19:00:00,715,828,575,253,82,171,2016-12-16 19:00:00,715,710,1126,449,1575,2285,2016-12-16 19:00:00,715,164378,163719
"4739",17180,2016-12-16 20:00:00,715,789,526,263,77,186,2016-12-16 20:00:00,715,739,1469,529,1998,2737,2016-12-16 20:00:00,715,151422,150770
"4740",17181,2016-12-16 21:00:00,715,982,542,440,99,341,2016-12-16 21:00:00,715,774,1649,557,2206,2980,2016-12-16 21:00:00,715,134621,134074
"4741",17182,2016-12-16 22:00:00,715,961,506,455,107,348,2016-12-16 22:00:00,715,626,1854,597,2451,3077,2016-12-16 22:00:00,715,113364,112892
"4742",17183,2016-12-16 23:00:00,715,916,512,404,85,319,2016-12-16 23:00:00,715,512,1678,520,2198,2710,2016-12-16 23:00:00,715,96355,95966
"4743",17184,2016-12-17 00:00:00,716,891,475,416,87,329,2016-12-17 00:00:00,716,453,1456,471,1927,2380,2016-12-17 00:00:00,716,86664,86274
"4744",17185,2016-12-17 01:00:00,716,975,500,475,97,378,2016-12-17 01:00:00,716,380,1425,509,1934,2314,2016-12-17 01:00:00,716,81239,80878
"4745",17186,2016-12-17 02:00:00,716,779,417,362,87,275,2016-12-17 02:00:00,716,342,1241,424,1665,2007,2016-12-17 02:00:00,716,77435,77095
"4746",17187,2016-12-17 03:00:00,716,725,365,360,66,294,2016-12-17 03:00:00,716,258,1179,359,1538,1796,2016-12-17 03:00:00,716,75542,75202
"4747",17188,2016-12-17 04:00:00,716,681,357,324,84,240,2016-12-17 04:00:00,716,245,845,290,1135,1380,2016-12-17 04:00:00,716,71817,71511
"4748",17189,2016-12-17 05:00:00,716,532,281,251,49,202,2016-12-17 05:00:00,716,171,532,191,723,894,2016-12-17 05:00:00,716,66861,66552
"4749",17190,2016-12-17 06:00:00,716,410,198,212,50,162,2016-12-17 06:00:00,716,99,305,121,426,525,2016-12-17 06:00:00,716,61994,61700
"4750",17191,2016-12-17 07:00:00,716,363,189,174,56,118,2016-12-17 07:00:00,716,77,165,53,218,295,2016-12-17 07:00:00,716,58463,58189
"4751",17192,2016-12-17 08:00:00,716,277,180,97,36,61,2016-12-17 08:00:00,716,37,108,41,149,186,2016-12-17 08:00:00,716,56384,56134
"4752",17193,2016-12-17 09:00:00,716,207,147,60,13,47,2016-12-17 09:00:00,716,37,60,15,75,112,2016-12-17 09:00:00,716,56990,56752
"4753",17194,2016-12-17 10:00:00,716,242,165,77,23,54,2016-12-17 10:00:00,716,50,51,27,78,128,2016-12-17 10:00:00,716,58704,58437
"4754",17195,2016-12-17 11:00:00,716,270,192,78,22,56,2016-12-17 11:00:00,716,42,60,30,90,132,2016-12-17 11:00:00,716,61877,61618
"4755",17196,2016-12-17 12:00:00,716,310,212,98,29,69,2016-12-17 12:00:00,716,117,145,63,208,325,2016-12-17 12:00:00,716,70610,70315
"4756",17197,2016-12-17 13:00:00,716,399,253,146,42,104,2016-12-17 13:00:00,716,200,327,123,450,650,2016-12-17 13:00:00,716,83376,83061
"4757",17198,2016-12-17 14:00:00,716,585,338,247,61,186,2016-12-17 14:00:00,716,329,716,281,997,1326,2016-12-17 14:00:00,716,95930,95561
"4758",17199,2016-12-17 15:00:00,716,793,457,336,95,241,2016-12-17 15:00:00,716,408,1110,465,1575,1983,2016-12-17 15:00:00,716,102292,101857
"4759",17200,2016-12-17 16:00:00,716,860,543,317,88,229,2016-12-17 16:00:00,716,551,1230,480,1710,2261,2016-12-17 16:00:00,716,107095,106615
"4760",17201,2016-12-17 17:00:00,716,927,557,370,112,258,2016-12-17 17:00:00,716,566,1446,574,2020,2586,2016-12-17 17:00:00,716,105255,104767
"4761",17202,2016-12-17 18:00:00,716,973,582,391,124,267,2016-12-17 18:00:00,716,636,1469,576,2045,2681,2016-12-17 18:00:00,716,101129,100633
"4762",17203,2016-12-17 19:00:00,716,994,573,421,113,308,2016-12-17 19:00:00,716,660,1475,557,2032,2692,2016-12-17 19:00:00,716,97104,96599
"4763",17204,2016-12-17 20:00:00,716,821,465,356,91,265,2016-12-17 20:00:00,716,606,1466,514,1980,2586,2016-12-17 20:00:00,716,93021,92565
"4764",17205,2016-12-17 21:00:00,716,930,521,409,128,281,2016-12-17 21:00:00,716,603,1458,567,2025,2628,2016-12-17 21:00:00,716,88105,87661
"4765",17206,2016-12-17 22:00:00,716,1090,599,491,128,363,2016-12-17 22:00:00,716,524,1534,587,2121,2645,2016-12-17 22:00:00,716,82862,82456
"4766",17207,2016-12-17 23:00:00,716,927,512,415,101,314,2016-12-17 23:00:00,716,410,1347,490,1837,2247,2016-12-17 23:00:00,716,78021,77684
"4767",17208,2016-12-18 00:00:00,717,902,442,460,137,323,2016-12-18 00:00:00,717,423,1395,518,1913,2336,2016-12-18 00:00:00,717,74126,73766
"4768",17209,2016-12-18 01:00:00,717,1041,577,464,118,346,2016-12-18 01:00:00,717,334,1221,453,1674,2008,2016-12-18 01:00:00,717,71704,71377
"4769",17210,2016-12-18 02:00:00,717,845,457,388,93,295,2016-12-18 02:00:00,717,315,1002,339,1341,1656,2016-12-18 02:00:00,717,70944,70608
"4770",17211,2016-12-18 03:00:00,717,838,445,393,105,288,2016-12-18 03:00:00,717,214,856,300,1156,1370,2016-12-18 03:00:00,717,72518,72215
"4771",17212,2016-12-18 04:00:00,717,714,384,330,63,267,2016-12-18 04:00:00,717,175,627,241,868,1043,2016-12-18 04:00:00,717,71947,71642
"4772",17213,2016-12-18 05:00:00,717,587,327,260,67,193,2016-12-18 05:00:00,717,107,423,176,599,706,2016-12-18 05:00:00,717,67567,67285
"4773",17214,2016-12-18 06:00:00,717,526,288,238,67,171,2016-12-18 06:00:00,717,97,243,79,322,419,2016-12-18 06:00:00,717,63351,63074
"4774",17215,2016-12-18 07:00:00,717,405,232,173,64,109,2016-12-18 07:00:00,717,67,161,60,221,288,2016-12-18 07:00:00,717,59657,59404
"4775",17216,2016-12-18 08:00:00,717,336,201,135,50,85,2016-12-18 08:00:00,717,45,94,37,131,176,2016-12-18 08:00:00,717,57965,57744
"4776",17217,2016-12-18 09:00:00,717,268,159,109,46,63,2016-12-18 09:00:00,717,36,52,24,76,112,2016-12-18 09:00:00,717,56966,56730
"4777",17218,2016-12-18 10:00:00,717,224,150,74,22,52,2016-12-18 10:00:00,717,27,34,17,51,78,2016-12-18 10:00:00,717,57613,57363
"4778",17219,2016-12-18 11:00:00,717,221,150,71,24,46,2016-12-18 11:00:00,717,34,44,15,59,93,2016-12-18 11:00:00,717,61410,61159
"4779",17220,2016-12-18 12:00:00,717,284,201,83,25,58,2016-12-18 12:00:00,717,81,119,53,172,253,2016-12-18 12:00:00,717,69471,69171
"4780",17221,2016-12-18 13:00:00,717,412,293,119,28,90,2016-12-18 13:00:00,717,129,237,89,326,455,2016-12-18 13:00:00,717,78987,78635
"4781",17222,2016-12-18 14:00:00,717,594,376,218,67,151,2016-12-18 14:00:00,717,192,542,205,747,939,2016-12-18 14:00:00,717,87404,87045
"4782",17223,2016-12-18 15:00:00,717,800,527,273,71,202,2016-12-18 15:00:00,717,332,875,358,1233,1565,2016-12-18 15:00:00,717,94564,94160
"4783",17224,2016-12-18 16:00:00,717,896,625,271,83,188,2016-12-18 16:00:00,717,378,1057,394,1451,1829,2016-12-18 16:00:00,717,98940,98487
"4784",17225,2016-12-18 17:00:00,717,907,617,290,98,192,2016-12-18 17:00:00,717,403,1201,440,1641,2044,2016-12-18 17:00:00,717,99333,98854
"4785",17226,2016-12-18 18:00:00,717,925,577,348,103,245,2016-12-18 18:00:00,717,418,1283,468,1751,2169,2016-12-18 18:00:00,717,98633,98137
"4786",17227,2016-12-18 19:00:00,717,994,615,379,120,259,2016-12-18 19:00:00,717,525,1375,484,1859,2384,2016-12-18 19:00:00,717,98732,98252
"4787",17228,2016-12-18 20:00:00,717,944,541,403,125,277,2016-12-18 20:00:00,717,527,1324,485,1809,2336,2016-12-18 20:00:00,717,93385,92912
"4788",17229,2016-12-18 21:00:00,717,973,601,372,108,264,2016-12-18 21:00:00,717,500,1464,535,1999,2499,2016-12-18 21:00:00,717,89725,89283
"4789",17230,2016-12-18 22:00:00,717,939,583,356,104,252,2016-12-18 22:00:00,717,457,1361,503,1864,2321,2016-12-18 22:00:00,717,87501,87100
"4790",17231,2016-12-18 23:00:00,717,913,532,381,113,268,2016-12-18 23:00:00,717,374,1367,497,1864,2238,2016-12-18 23:00:00,717,83632,83268
"4791",17232,2016-12-19 00:00:00,718,827,494,333,88,245,2016-12-19 00:00:00,718,351,1207,423,1630,1981,2016-12-19 00:00:00,718,89766,89415
"4792",17233,2016-12-19 01:00:00,718,996,563,433,110,323,2016-12-19 01:00:00,718,300,1047,385,1432,1732,2016-12-19 01:00:00,718,97489,97090
"4793",17234,2016-12-19 02:00:00,718,754,446,308,78,230,2016-12-19 02:00:00,718,261,859,320,1179,1440,2016-12-19 02:00:00,718,93680,93306
"4794",17235,2016-12-19 03:00:00,718,792,437,355,91,264,2016-12-19 03:00:00,718,190,654,260,914,1104,2016-12-19 03:00:00,718,91512,91136
"4795",17236,2016-12-19 04:00:00,718,712,449,263,96,167,2016-12-19 04:00:00,718,162,421,164,585,747,2016-12-19 04:00:00,718,91535,91159
"4796",17237,2016-12-19 05:00:00,718,600,345,255,70,185,2016-12-19 05:00:00,718,111,275,114,389,500,2016-12-19 05:00:00,718,86512,86174
"4797",17238,2016-12-19 06:00:00,718,455,261,194,64,130,2016-12-19 06:00:00,718,61,166,63,229,290,2016-12-19 06:00:00,718,88026,87638
"4798",17239,2016-12-19 07:00:00,718,302,201,101,33,68,2016-12-19 07:00:00,718,62,84,34,118,180,2016-12-19 07:00:00,718,89324,88909
"4799",17240,2016-12-19 08:00:00,718,275,200,75,27,48,2016-12-19 08:00:00,718,44,58,17,75,119,2016-12-19 08:00:00,718,89369,88982
"4800",17241,2016-12-19 09:00:00,718,223,186,37,11,25,2016-12-19 09:00:00,718,29,28,11,39,68,2016-12-19 09:00:00,718,91363,90945
"4801",17242,2016-12-19 10:00:00,718,255,191,64,15,49,2016-12-19 10:00:00,718,33,28,11,39,72,2016-12-19 10:00:00,718,92009,91590
"4802",17243,2016-12-19 11:00:00,718,298,220,78,22,56,2016-12-19 11:00:00,718,60,62,28,90,150,2016-12-19 11:00:00,718,108344,107938
"4803",17244,2016-12-19 12:00:00,718,325,253,72,23,49,2016-12-19 12:00:00,718,85,109,47,156,241,2016-12-19 12:00:00,718,172416,171953
"4804",17245,2016-12-19 13:00:00,718,434,327,107,32,75,2016-12-19 13:00:00,718,232,346,171,517,749,2016-12-19 13:00:00,718,261486,260897
"4805",17246,2016-12-19 14:00:00,718,514,403,111,37,74,2016-12-19 14:00:00,718,437,623,313,936,1373,2016-12-19 14:00:00,718,282426,281747
"4806",17247,2016-12-19 15:00:00,718,699,514,185,54,131,2016-12-19 15:00:00,718,613,866,341,1207,1820,2016-12-19 15:00:00,718,260703,259909
"4807",17248,2016-12-19 16:00:00,718,840,602,238,93,145,2016-12-19 16:00:00,718,667,1038,464,1502,2169,2016-12-19 16:00:00,718,242784,242014
"4808",17249,2016-12-19 17:00:00,718,917,628,289,103,186,2016-12-19 17:00:00,718,822,1249,537,1786,2608,2016-12-19 17:00:00,718,208719,207988
"4809",17250,2016-12-19 18:00:00,718,950,670,280,93,187,2016-12-19 18:00:00,718,803,1197,487,1684,2487,2016-12-19 18:00:00,718,195442,194694
"4810",17251,2016-12-19 19:00:00,718,908,614,294,102,192,2016-12-19 19:00:00,718,844,1255,510,1765,2609,2016-12-19 19:00:00,718,188026,187309
"4811",17252,2016-12-19 20:00:00,718,962,634,328,95,233,2016-12-19 20:00:00,718,879,1440,578,2018,2897,2016-12-19 20:00:00,718,172693,172010
"4812",17253,2016-12-19 21:00:00,718,961,607,354,107,247,2016-12-19 21:00:00,718,798,1523,622,2145,2943,2016-12-19 21:00:00,718,158211,157581
"4813",17254,2016-12-19 22:00:00,718,961,607,354,103,251,2016-12-19 22:00:00,718,723,1645,649,2294,3017,2016-12-19 22:00:00,718,129731,129232
"4814",17255,2016-12-19 23:00:00,718,956,594,362,115,247,2016-12-19 23:00:00,718,591,1524,561,2085,2676,2016-12-19 23:00:00,718,92941,92590
"4815",17256,2016-12-20 00:00:00,719,910,552,358,108,250,2016-12-20 00:00:00,719,523,1538,571,2109,2632,2016-12-20 00:00:00,719,77475,77301
"4816",17257,2016-12-20 01:00:00,719,826,488,338,92,246,2016-12-20 01:00:00,719,411,1358,500,1858,2269,2016-12-20 01:00:00,719,99534,99097
"4817",17258,2016-12-20 02:00:00,719,789,496,293,86,207,2016-12-20 02:00:00,719,371,1236,463,1699,2070,2016-12-20 02:00:00,719,93892,93463
"4818",17259,2016-12-20 03:00:00,719,780,496,284,93,191,2016-12-20 03:00:00,719,278,937,349,1286,1564,2016-12-20 03:00:00,719,90176,89785
"4819",17260,2016-12-20 04:00:00,719,650,399,251,81,170,2016-12-20 04:00:00,719,225,706,249,955,1180,2016-12-20 04:00:00,719,85223,84886
"4820",17261,2016-12-20 05:00:00,719,617,361,256,86,170,2016-12-20 05:00:00,719,144,430,155,585,729,2016-12-20 05:00:00,719,80259,79894
"4821",17262,2016-12-20 06:00:00,719,486,304,182,69,113,2016-12-20 06:00:00,719,106,234,90,324,430,2016-12-20 06:00:00,719,81008,80612
"4822",17263,2016-12-20 07:00:00,719,353,220,133,51,82,2016-12-20 07:00:00,719,64,109,42,151,215,2016-12-20 07:00:00,719,83693,83290
"4823",17264,2016-12-20 08:00:00,719,293,191,102,34,68,2016-12-20 08:00:00,719,28,61,24,85,113,2016-12-20 08:00:00,719,84293,83870
"4824",17265,2016-12-20 09:00:00,719,234,170,64,25,39,2016-12-20 09:00:00,719,38,46,18,64,102,2016-12-20 09:00:00,719,86753,86311
"4825",17266,2016-12-20 10:00:00,719,242,186,56,27,29,2016-12-20 10:00:00,719,33,41,15,56,89,2016-12-20 10:00:00,719,85179,84746
"4826",17267,2016-12-20 11:00:00,719,300,242,58,27,31,2016-12-20 11:00:00,719,54,56,39,95,149,2016-12-20 11:00:00,719,103067,102659
"4827",17268,2016-12-20 12:00:00,719,304,241,63,20,43,2016-12-20 12:00:00,719,105,119,54,173,278,2016-12-20 12:00:00,719,120346,119905
"4828",17269,2016-12-20 13:00:00,719,443,350,93,38,55,2016-12-20 13:00:00,719,230,307,141,448,678,2016-12-20 13:00:00,719,167114,166550
"4829",17270,2016-12-20 14:00:00,719,562,439,123,38,85,2016-12-20 14:00:00,719,427,555,256,811,1238,2016-12-20 14:00:00,719,191956,191294
"4830",17271,2016-12-20 15:00:00,719,676,482,194,68,126,2016-12-20 15:00:00,719,532,710,319,1029,1561,2016-12-20 15:00:00,719,196076,195299
"4831",17272,2016-12-20 16:00:00,719,790,571,219,62,157,2016-12-20 16:00:00,719,608,878,385,1263,1871,2016-12-20 16:00:00,719,191158,190420
"4832",17273,2016-12-20 17:00:00,719,854,605,249,75,174,2016-12-20 17:00:00,719,630,1167,467,1634,2264,2016-12-20 17:00:00,719,176657,175917
"4833",17274,2016-12-20 18:00:00,719,836,543,293,77,216,2016-12-20 18:00:00,719,684,1168,474,1642,2326,2016-12-20 18:00:00,719,165018,164305
"4834",17275,2016-12-20 19:00:00,719,952,599,353,120,233,2016-12-20 19:00:00,719,755,1340,534,1874,2629,2016-12-20 19:00:00,719,164528,163805
"4835",17276,2016-12-20 20:00:00,719,998,623,375,141,234,2016-12-20 20:00:00,719,766,1440,543,1983,2749,2016-12-20 20:00:00,719,155659,154954
"4836",17277,2016-12-20 21:00:00,719,1005,590,415,154,261,2016-12-20 21:00:00,719,720,1533,610,2143,2863,2016-12-20 21:00:00,719,141236,140645
"4837",17278,2016-12-20 22:00:00,719,1106,650,456,170,286,2016-12-20 22:00:00,719,562,1555,596,2151,2713,2016-12-20 22:00:00,719,120246,119733
"4838",17279,2016-12-20 23:00:00,719,892,526,366,101,265,2016-12-20 23:00:00,719,512,1541,577,2118,2630,2016-12-20 23:00:00,719,100847,100380
"4839",17280,2016-12-21 00:00:00,720,816,463,353,112,241,2016-12-21 00:00:00,720,483,1478,538,2016,2499,2016-12-21 00:00:00,720,94198,93832
"4840",17281,2016-12-21 01:00:00,720,817,470,347,113,234,2016-12-21 01:00:00,720,406,1229,434,1663,2069,2016-12-21 01:00:00,720,90890,90483
"4841",17282,2016-12-21 02:00:00,720,843,482,361,106,255,2016-12-21 02:00:00,720,336,1240,457,1697,2033,2016-12-21 02:00:00,720,88384,87988
"4842",17283,2016-12-21 03:00:00,720,815,497,318,95,223,2016-12-21 03:00:00,720,276,1133,425,1558,1834,2016-12-21 03:00:00,720,85979,85572
"4843",17284,2016-12-21 04:00:00,720,665,381,284,92,192,2016-12-21 04:00:00,720,207,805,304,1109,1316,2016-12-21 04:00:00,720,82534,82183
"4844",17285,2016-12-21 05:00:00,720,585,323,262,80,181,2016-12-21 05:00:00,720,131,414,149,563,694,2016-12-21 05:00:00,720,77830,77494
"4845",17286,2016-12-21 06:00:00,720,402,223,179,68,111,2016-12-21 06:00:00,720,97,222,75,297,394,2016-12-21 06:00:00,720,79081,78707
"4846",17287,2016-12-21 07:00:00,720,329,214,115,39,76,2016-12-21 07:00:00,720,52,110,40,150,202,2016-12-21 07:00:00,720,79379,79024
"4847",17288,2016-12-21 08:00:00,720,277,183,94,33,61,2016-12-21 08:00:00,720,49,74,28,102,151,2016-12-21 08:00:00,720,81808,81434
"4848",17289,2016-12-21 09:00:00,720,252,181,71,21,50,2016-12-21 09:00:00,720,38,35,14,49,87,2016-12-21 09:00:00,720,83557,83191
"4849",17290,2016-12-21 10:00:00,720,230,174,56,22,34,2016-12-21 10:00:00,720,19,26,10,36,55,2016-12-21 10:00:00,720,82853,82445
"4850",17291,2016-12-21 11:00:00,720,262,201,61,32,29,2016-12-21 11:00:00,720,50,51,27,78,128,2016-12-21 11:00:00,720,86226,85867
"4851",17292,2016-12-21 12:00:00,720,281,214,67,25,42,2016-12-21 12:00:00,720,113,133,55,188,301,2016-12-21 12:00:00,720,105651,105269
"4852",17293,2016-12-21 13:00:00,720,385,282,103,33,70,2016-12-21 13:00:00,720,230,305,143,448,678,2016-12-21 13:00:00,720,139357,138839
"4853",17294,2016-12-21 14:00:00,720,527,395,132,39,93,2016-12-21 14:00:00,720,371,624,275,899,1270,2016-12-21 14:00:00,720,163914,163264
"4854",17295,2016-12-21 15:00:00,720,671,466,205,66,139,2016-12-21 15:00:00,720,505,714,288,1002,1507,2016-12-21 15:00:00,720,172749,171974
"4855",17296,2016-12-21 16:00:00,720,762,533,229,76,153,2016-12-21 16:00:00,720,572,919,385,1304,1876,2016-12-21 16:00:00,720,169797,169107
"4856",17297,2016-12-21 17:00:00,720,761,527,234,70,164,2016-12-21 17:00:00,720,629,1079,433,1512,2141,2016-12-21 17:00:00,720,156647,155961
"4857",17298,2016-12-21 18:00:00,720,863,600,263,70,193,2016-12-21 18:00:00,720,652,1207,499,1706,2358,2016-12-21 18:00:00,720,152815,152170
"4858",17299,2016-12-21 19:00:00,720,881,586,295,91,204,2016-12-21 19:00:00,720,619,1214,495,1709,2328,2016-12-21 19:00:00,720,150722,150039
"4859",17300,2016-12-21 20:00:00,720,907,579,328,137,191,2016-12-21 20:00:00,720,706,1368,561,1929,2635,2016-12-21 20:00:00,720,144113,143450
"4860",17301,2016-12-21 21:00:00,720,945,577,368,118,250,2016-12-21 21:00:00,720,616,1465,582,2047,2663,2016-12-21 21:00:00,720,133548,133002
"4861",17302,2016-12-21 22:00:00,720,886,538,348,130,217,2016-12-21 22:00:00,720,584,1595,610,2205,2789,2016-12-21 22:00:00,720,114137,113647
"4862",17303,2016-12-21 23:00:00,720,880,518,362,105,257,2016-12-21 23:00:00,720,552,1518,579,2097,2649,2016-12-21 23:00:00,720,97592,97174
"4863",17304,2016-12-22 00:00:00,721,838,489,349,114,235,2016-12-22 00:00:00,721,448,1334,488,1822,2270,2016-12-22 00:00:00,721,92387,92005
"4864",17305,2016-12-22 01:00:00,721,846,484,362,118,244,2016-12-22 01:00:00,721,401,1397,534,1931,2332,2016-12-22 01:00:00,721,92503,92103
"4865",17306,2016-12-22 02:00:00,721,813,470,343,106,237,2016-12-22 02:00:00,721,351,1254,480,1734,2085,2016-12-22 02:00:00,721,88000,87584
"4866",17307,2016-12-22 03:00:00,721,753,471,282,80,202,2016-12-22 03:00:00,721,287,1031,390,1421,1708,2016-12-22 03:00:00,721,86189,85805
"4867",17308,2016-12-22 04:00:00,721,667,366,301,85,216,2016-12-22 04:00:00,721,182,732,253,985,1167,2016-12-22 04:00:00,721,83951,83591
"4868",17309,2016-12-22 05:00:00,721,605,359,246,83,163,2016-12-22 05:00:00,721,137,545,191,736,873,2016-12-22 05:00:00,721,80160,79806
"4869",17310,2016-12-22 06:00:00,721,433,264,169,41,128,2016-12-22 06:00:00,721,98,255,103,358,456,2016-12-22 06:00:00,721,82331,82016
"4870",17311,2016-12-22 07:00:00,721,361,227,134,43,91,2016-12-22 07:00:00,721,63,136,51,187,250,2016-12-22 07:00:00,721,82623,82268
"4871",17312,2016-12-22 08:00:00,721,307,211,96,21,75,2016-12-22 08:00:00,721,41,101,41,142,183,2016-12-22 08:00:00,721,83400,82993
"4872",17313,2016-12-22 09:00:00,721,296,207,89,38,51,2016-12-22 09:00:00,721,46,44,19,63,109,2016-12-22 09:00:00,721,83764,83362
"4873",17314,2016-12-22 10:00:00,721,267,186,81,40,41,2016-12-22 10:00:00,721,33,51,26,77,110,2016-12-22 10:00:00,721,83189,82811
"4874",17315,2016-12-22 11:00:00,721,272,198,74,26,48,2016-12-22 11:00:00,721,63,69,31,100,163,2016-12-22 11:00:00,721,89918,89546
"4875",17316,2016-12-22 12:00:00,721,277,206,71,20,51,2016-12-22 12:00:00,721,99,136,71,207,306,2016-12-22 12:00:00,721,119753,119347
"4876",17317,2016-12-22 13:00:00,721,421,305,116,38,78,2016-12-22 13:00:00,721,178,313,135,448,626,2016-12-22 13:00:00,721,170231,169751
"4877",17318,2016-12-22 14:00:00,721,539,395,144,52,92,2016-12-22 14:00:00,721,318,631,294,925,1243,2016-12-22 14:00:00,721,197383,196788
"4878",17319,2016-12-22 15:00:00,721,638,488,150,42,108,2016-12-22 15:00:00,721,450,862,382,1244,1694,2016-12-22 15:00:00,721,198636,197927
"4879",17320,2016-12-22 16:00:00,721,802,582,220,64,156,2016-12-22 16:00:00,721,552,992,421,1413,1965,2016-12-22 16:00:00,721,193039,192322
"4880",17321,2016-12-22 17:00:00,721,882,586,296,107,189,2016-12-22 17:00:00,721,608,1178,503,1681,2289,2016-12-22 17:00:00,721,172955,172285
"4881",17322,2016-12-22 18:00:00,721,883,597,286,90,196,2016-12-22 18:00:00,721,651,1213,528,1741,2392,2016-12-22 18:00:00,721,165827,165195
"4882",17323,2016-12-22 19:00:00,721,963,600,363,129,234,2016-12-22 19:00:00,721,598,1275,472,1747,2345,2016-12-22 19:00:00,721,161024,160414
"4883",17324,2016-12-22 20:00:00,721,1004,644,360,125,235,2016-12-22 20:00:00,721,686,1367,543,1910,2596,2016-12-22 20:00:00,721,151571,150969
"4884",17325,2016-12-22 21:00:00,721,1023,675,348,127,221,2016-12-22 21:00:00,721,662,1408,523,1931,2593,2016-12-22 21:00:00,721,138084,137544
"4885",17326,2016-12-22 22:00:00,721,991,648,343,136,206,2016-12-22 22:00:00,721,536,1500,573,2073,2609,2016-12-22 22:00:00,721,116048,115541
"4886",17327,2016-12-22 23:00:00,721,931,554,377,115,262,2016-12-22 23:00:00,721,511,1474,536,2010,2521,2016-12-22 23:00:00,721,96832,96442
"4887",17328,2016-12-23 00:00:00,722,870,484,386,108,278,2016-12-23 00:00:00,722,403,1712,555,2267,2670,2016-12-23 00:00:00,722,90077,89720
"4888",17329,2016-12-23 01:00:00,722,938,530,408,139,269,2016-12-23 01:00:00,722,390,1384,488,1872,2262,2016-12-23 01:00:00,722,88120,87748
"4889",17330,2016-12-23 02:00:00,722,819,486,333,109,224,2016-12-23 02:00:00,722,280,1173,424,1597,1877,2016-12-23 02:00:00,722,83093,82745
"4890",17331,2016-12-23 03:00:00,722,731,437,294,93,201,2016-12-23 03:00:00,722,234,1077,361,1438,1672,2016-12-23 03:00:00,722,80175,79828
"4891",17332,2016-12-23 04:00:00,722,636,364,272,92,180,2016-12-23 04:00:00,722,207,838,293,1131,1338,2016-12-23 04:00:00,722,75206,74864
"4892",17333,2016-12-23 05:00:00,722,578,296,282,89,193,2016-12-23 05:00:00,722,142,620,212,832,974,2016-12-23 05:00:00,722,70586,70271
"4893",17334,2016-12-23 06:00:00,722,488,300,188,53,134,2016-12-23 06:00:00,722,117,284,109,393,510,2016-12-23 06:00:00,722,71546,71223
"4894",17335,2016-12-23 07:00:00,722,392,233,159,64,95,2016-12-23 07:00:00,722,69,147,65,212,281,2016-12-23 07:00:00,722,70937,70612
"4895",17336,2016-12-23 08:00:00,722,286,188,98,31,67,2016-12-23 08:00:00,722,53,93,28,121,174,2016-12-23 08:00:00,722,70092,69788
"4896",17337,2016-12-23 09:00:00,722,257,171,86,32,54,2016-12-23 09:00:00,722,34,40,21,61,95,2016-12-23 09:00:00,722,70989,70640
"4897",17338,2016-12-23 10:00:00,722,200,159,41,10,31,2016-12-23 10:00:00,722,28,47,22,69,97,2016-12-23 10:00:00,722,70511,70191
"4898",17339,2016-12-23 11:00:00,722,267,194,73,23,50,2016-12-23 11:00:00,722,34,49,22,71,105,2016-12-23 11:00:00,722,76035,75739
"4899",17340,2016-12-23 12:00:00,722,331,288,43,12,31,2016-12-23 12:00:00,722,89,120,51,171,260,2016-12-23 12:00:00,722,99075,98732
"4900",17341,2016-12-23 13:00:00,722,638,533,105,33,71,2016-12-23 13:00:00,722,193,329,134,463,656,2016-12-23 13:00:00,722,132038,131626
"4901",17342,2016-12-23 14:00:00,722,1005,841,164,56,108,2016-12-23 14:00:00,722,322,758,329,1087,1409,2016-12-23 14:00:00,722,147621,147119
"4902",17343,2016-12-23 15:00:00,722,1246,1000,246,89,157,2016-12-23 15:00:00,722,401,972,405,1377,1778,2016-12-23 15:00:00,722,149537,149030
"4903",17344,2016-12-23 16:00:00,722,1300,1017,283,104,179,2016-12-23 16:00:00,722,550,1069,437,1506,2056,2016-12-23 16:00:00,722,147056,146507
"4904",17345,2016-12-23 17:00:00,722,1220,907,313,112,201,2016-12-23 17:00:00,722,513,1322,557,1879,2392,2016-12-23 17:00:00,722,135186,134674
"4905",17346,2016-12-23 18:00:00,722,1229,865,364,130,234,2016-12-23 18:00:00,722,609,1302,482,1784,2393,2016-12-23 18:00:00,722,124658,124148
"4906",17347,2016-12-23 19:00:00,722,1225,806,419,144,275,2016-12-23 19:00:00,722,523,1473,530,2003,2526,2016-12-23 19:00:00,722,116352,115849
"4907",17348,2016-12-23 20:00:00,722,1084,711,373,125,248,2016-12-23 20:00:00,722,533,1546,616,2162,2695,2016-12-23 20:00:00,722,107820,107352
"4908",17349,2016-12-23 21:00:00,722,1015,672,343,119,224,2016-12-23 21:00:00,722,558,1578,573,2151,2709,2016-12-23 21:00:00,722,97842,97438
"4909",17350,2016-12-23 22:00:00,722,1010,649,361,126,235,2016-12-23 22:00:00,722,499,1532,555,2087,2586,2016-12-23 22:00:00,722,87004,86638
"4910",17351,2016-12-23 23:00:00,722,974,604,370,138,232,2016-12-23 23:00:00,722,480,1467,542,2009,2489,2016-12-23 23:00:00,722,76101,75764
"4911",17352,2016-12-24 00:00:00,723,953,596,357,115,242,2016-12-24 00:00:00,723,405,1418,494,1912,2317,2016-12-24 00:00:00,723,70508,70223
"4912",17353,2016-12-24 01:00:00,723,1071,723,348,108,240,2016-12-24 01:00:00,723,323,1358,481,1839,2162,2016-12-24 01:00:00,723,68453,68167
"4913",17354,2016-12-24 02:00:00,723,1059,683,376,122,254,2016-12-24 02:00:00,723,252,1289,454,1743,1995,2016-12-24 02:00:00,723,66076,65801
"4914",17355,2016-12-24 03:00:00,723,893,549,344,125,219,2016-12-24 03:00:00,723,196,1281,483,1764,1960,2016-12-24 03:00:00,723,66079,65790
"4915",17356,2016-12-24 04:00:00,723,860,525,335,122,213,2016-12-24 04:00:00,723,163,906,312,1218,1381,2016-12-24 04:00:00,723,64918,64646
"4916",17357,2016-12-24 05:00:00,723,781,461,320,87,233,2016-12-24 05:00:00,723,143,715,282,997,1140,2016-12-24 05:00:00,723,61078,60799
"4917",17358,2016-12-24 06:00:00,723,561,307,254,89,165,2016-12-24 06:00:00,723,97,411,155,566,663,2016-12-24 06:00:00,723,57851,57571
"4918",17359,2016-12-24 07:00:00,723,466,301,165,55,110,2016-12-24 07:00:00,723,60,183,74,257,317,2016-12-24 07:00:00,723,53956,53688
"4919",17360,2016-12-24 08:00:00,723,410,305,105,39,66,2016-12-24 08:00:00,723,49,111,44,155,204,2016-12-24 08:00:00,723,51765,51553
"4920",17361,2016-12-24 09:00:00,723,333,228,105,44,61,2016-12-24 09:00:00,723,53,60,21,81,134,2016-12-24 09:00:00,723,51803,51575
"4921",17362,2016-12-24 10:00:00,723,321,224,97,40,57,2016-12-24 10:00:00,723,40,50,21,71,111,2016-12-24 10:00:00,723,50549,50340
"4922",17363,2016-12-24 11:00:00,723,298,205,93,37,56,2016-12-24 11:00:00,723,31,60,21,81,112,2016-12-24 11:00:00,723,53587,53353
"4923",17364,2016-12-24 12:00:00,723,383,253,130,41,89,2016-12-24 12:00:00,723,50,120,53,173,223,2016-12-24 12:00:00,723,60351,60105
"4924",17365,2016-12-24 13:00:00,723,465,323,142,53,89,2016-12-24 13:00:00,723,105,279,106,385,490,2016-12-24 13:00:00,723,68512,68236
"4925",17366,2016-12-24 14:00:00,723,595,376,219,76,143,2016-12-24 14:00:00,723,191,641,261,902,1093,2016-12-24 14:00:00,723,77180,76812
"4926",17367,2016-12-24 15:00:00,723,657,421,236,77,159,2016-12-24 15:00:00,723,265,983,394,1377,1642,2016-12-24 15:00:00,723,82580,82249
"4927",17368,2016-12-24 16:00:00,723,743,459,284,106,178,2016-12-24 16:00:00,723,304,1104,410,1514,1818,2016-12-24 16:00:00,723,84236,83869
"4928",17369,2016-12-24 17:00:00,723,810,448,362,120,242,2016-12-24 17:00:00,723,307,1365,524,1889,2196,2016-12-24 17:00:00,723,82575,82198
"4929",17370,2016-12-24 18:00:00,723,788,459,329,104,225,2016-12-24 18:00:00,723,327,1400,495,1895,2222,2016-12-24 18:00:00,723,78142,77767
"4930",17371,2016-12-24 19:00:00,723,779,434,345,117,228,2016-12-24 19:00:00,723,344,1439,529,1968,2312,2016-12-24 19:00:00,723,75341,74992
"4931",17372,2016-12-24 20:00:00,723,772,438,334,117,217,2016-12-24 20:00:00,723,335,1448,534,1982,2317,2016-12-24 20:00:00,723,71126,70761
"4932",17373,2016-12-24 21:00:00,723,708,372,336,110,226,2016-12-24 21:00:00,723,289,1387,527,1914,2203,2016-12-24 21:00:00,723,66043,65723
"4933",17374,2016-12-24 22:00:00,723,845,418,427,136,291,2016-12-24 22:00:00,723,247,1299,469,1768,2015,2016-12-24 22:00:00,723,60657,60420
"4934",17375,2016-12-24 23:00:00,723,777,358,419,156,263,2016-12-24 23:00:00,723,201,1225,424,1649,1850,2016-12-24 23:00:00,723,55149,54901
"4935",17376,2016-12-25 00:00:00,724,751,360,391,136,255,2016-12-25 00:00:00,724,183,1157,434,1591,1774,2016-12-25 00:00:00,724,52408,52167
"4936",17377,2016-12-25 01:00:00,724,774,379,395,143,252,2016-12-25 01:00:00,724,186,1079,393,1472,1658,2016-12-25 01:00:00,724,52300,52064
"4937",17378,2016-12-25 02:00:00,724,810,399,411,125,286,2016-12-25 02:00:00,724,168,1026,363,1389,1557,2016-12-25 02:00:00,724,54307,54076
"4938",17379,2016-12-25 03:00:00,724,845,446,399,89,310,2016-12-25 03:00:00,724,113,938,358,1296,1409,2016-12-25 03:00:00,724,58606,58371
"4939",17380,2016-12-25 04:00:00,724,810,424,386,124,262,2016-12-25 04:00:00,724,99,741,270,1011,1110,2016-12-25 04:00:00,724,60339,60105
"4940",17381,2016-12-25 05:00:00,724,712,345,367,122,245,2016-12-25 05:00:00,724,90,524,194,718,808,2016-12-25 05:00:00,724,58154,57924
"4941",17382,2016-12-25 06:00:00,724,608,340,268,89,179,2016-12-25 06:00:00,724,43,293,115,408,451,2016-12-25 06:00:00,724,55452,55220
"4942",17383,2016-12-25 07:00:00,724,454,278,176,58,118,2016-12-25 07:00:00,724,52,239,98,337,389,2016-12-25 07:00:00,724,53015,52771
"4943",17384,2016-12-25 08:00:00,724,364,232,132,40,92,2016-12-25 08:00:00,724,34,158,47,205,239,2016-12-25 08:00:00,724,51814,51583
"4944",17385,2016-12-25 09:00:00,724,356,209,147,48,99,2016-12-25 09:00:00,724,23,71,28,99,122,2016-12-25 09:00:00,724,50391,50181
"4945",17386,2016-12-25 10:00:00,724,318,191,127,45,82,2016-12-25 10:00:00,724,40,88,36,124,164,2016-12-25 10:00:00,724,51093,50868
"4946",17387,2016-12-25 11:00:00,724,289,186,103,38,65,2016-12-25 11:00:00,724,35,97,38,135,170,2016-12-25 11:00:00,724,53137,52928
"4947",17388,2016-12-25 12:00:00,724,367,226,141,45,96,2016-12-25 12:00:00,724,40,296,106,402,442,2016-12-25 12:00:00,724,59065,58830
"4948",17389,2016-12-25 13:00:00,724,460,245,215,52,163,2016-12-25 13:00:00,724,73,756,245,1001,1074,2016-12-25 13:00:00,724,68365,68052
"4949",17390,2016-12-25 14:00:00,724,690,351,339,80,259,2016-12-25 14:00:00,724,104,1510,488,1998,2102,2016-12-25 14:00:00,724,78720,78384
"4950",17391,2016-12-25 15:00:00,724,1052,493,559,135,424,2016-12-25 15:00:00,724,206,2592,897,3489,3695,2016-12-25 15:00:00,724,86379,86006
"4951",17392,2016-12-25 16:00:00,724,1115,508,607,141,466,2016-12-25 16:00:00,724,210,2629,884,3513,3723,2016-12-25 16:00:00,724,91854,91444
"4952",17393,2016-12-25 17:00:00,724,1255,554,701,142,559,2016-12-25 17:00:00,724,235,2936,981,3917,4152,2016-12-25 17:00:00,724,93457,92996
"4953",17394,2016-12-25 18:00:00,724,1323,549,774,196,578,2016-12-25 18:00:00,724,277,3107,1029,4136,4413,2016-12-25 18:00:00,724,91598,91156
"4954",17395,2016-12-25 19:00:00,724,1346,599,747,192,555,2016-12-25 19:00:00,724,262,2949,941,3890,4152,2016-12-25 19:00:00,724,86836,86437
"4955",17396,2016-12-25 20:00:00,724,1323,569,754,184,570,2016-12-25 20:00:00,724,231,2585,838,3423,3654,2016-12-25 20:00:00,724,82282,81887
"4956",17397,2016-12-25 21:00:00,724,1295,544,751,217,533,2016-12-25 21:00:00,724,221,2452,770,3222,3443,2016-12-25 21:00:00,724,76873,76481
"4957",17398,2016-12-25 22:00:00,724,1321,648,673,192,481,2016-12-25 22:00:00,724,229,2571,812,3383,3612,2016-12-25 22:00:00,724,72624,72289
"4958",17399,2016-12-25 23:00:00,724,1292,622,670,181,489,2016-12-25 23:00:00,724,217,2305,701,3006,3223,2016-12-25 23:00:00,724,70233,69901
"4959",17400,2016-12-26 00:00:00,725,1161,600,561,135,426,2016-12-26 00:00:00,725,205,2416,726,3142,3347,2016-12-26 00:00:00,725,72215,71879
"4960",17401,2016-12-26 01:00:00,725,1357,660,697,202,495,2016-12-26 01:00:00,725,218,2237,691,2928,3146,2016-12-26 01:00:00,725,78504,78168
"4961",17402,2016-12-26 02:00:00,725,1171,563,608,161,447,2016-12-26 02:00:00,725,166,1924,632,2556,2722,2016-12-26 02:00:00,725,77748,77405
"4962",17403,2016-12-26 03:00:00,725,1172,563,609,166,443,2016-12-26 03:00:00,725,153,1608,523,2131,2284,2016-12-26 03:00:00,725,79923,79575
"4963",17404,2016-12-26 04:00:00,725,1079,500,579,169,410,2016-12-26 04:00:00,725,125,1132,351,1483,1608,2016-12-26 04:00:00,725,80472,80147
"4964",17405,2016-12-26 05:00:00,725,998,459,539,137,402,2016-12-26 05:00:00,725,92,703,216,919,1011,2016-12-26 05:00:00,725,75425,75062
"4965",17406,2016-12-26 06:00:00,725,719,353,366,91,275,2016-12-26 06:00:00,725,64,479,162,641,705,2016-12-26 06:00:00,725,72276,71955
"4966",17407,2016-12-26 07:00:00,725,558,298,260,94,166,2016-12-26 07:00:00,725,34,216,74,290,324,2016-12-26 07:00:00,725,67494,67188
"4967",17408,2016-12-26 08:00:00,725,374,191,183,63,120,2016-12-26 08:00:00,725,35,123,37,160,195,2016-12-26 08:00:00,725,64991,64699
"4968",17409,2016-12-26 09:00:00,725,344,223,121,49,72,2016-12-26 09:00:00,725,26,66,27,93,119,2016-12-26 09:00:00,725,65032,64743
"4969",17410,2016-12-26 10:00:00,725,315,202,113,29,84,2016-12-26 10:00:00,725,31,50,23,73,104,2016-12-26 10:00:00,725,65489,65175
"4970",17411,2016-12-26 11:00:00,725,279,183,96,26,70,2016-12-26 11:00:00,725,51,111,46,157,208,2016-12-26 11:00:00,725,70064,69713
"4971",17412,2016-12-26 12:00:00,725,347,217,130,43,87,2016-12-26 12:00:00,725,73,237,74,311,384,2016-12-26 12:00:00,725,83636,83319
"4972",17413,2016-12-26 13:00:00,725,461,329,132,36,96,2016-12-26 13:00:00,725,159,791,236,1027,1186,2016-12-26 13:00:00,725,99161,98801
"4973",17414,2016-12-26 14:00:00,725,621,366,255,58,197,2016-12-26 14:00:00,725,289,1761,589,2350,2639,2016-12-26 14:00:00,725,110466,110056
"4974",17415,2016-12-26 15:00:00,725,806,452,354,82,272,2016-12-26 15:00:00,725,403,2450,836,3286,3689,2016-12-26 15:00:00,725,116994,116510
"4975",17416,2016-12-26 16:00:00,725,1077,638,439,97,342,2016-12-26 16:00:00,725,531,3095,1097,4192,4723,2016-12-26 16:00:00,725,121400,120883
"4976",17417,2016-12-26 17:00:00,725,1219,646,573,144,429,2016-12-26 17:00:00,725,606,3486,1166,4652,5258,2016-12-26 17:00:00,725,119858,119301
"4977",17418,2016-12-26 18:00:00,725,1249,621,628,135,493,2016-12-26 18:00:00,725,629,3745,1304,5049,5678,2016-12-26 18:00:00,725,115663,115139
"4978",17419,2016-12-26 19:00:00,725,1443,727,716,172,544,2016-12-26 19:00:00,725,670,4047,1433,5480,6150,2016-12-26 19:00:00,725,112992,112462
"4979",17420,2016-12-26 20:00:00,725,1508,755,753,178,575,2016-12-26 20:00:00,725,624,4198,1414,5612,6236,2016-12-26 20:00:00,725,109180,108615
"4980",17421,2016-12-26 21:00:00,725,1482,769,713,147,566,2016-12-26 21:00:00,725,576,4206,1441,5647,6223,2016-12-26 21:00:00,725,103972,103487
"4981",17422,2016-12-26 22:00:00,725,1593,782,811,172,639,2016-12-26 22:00:00,725,503,4309,1480,5789,6292,2016-12-26 22:00:00,725,98285,97841
"4982",17423,2016-12-26 23:00:00,725,1593,742,851,186,665,2016-12-26 23:00:00,725,528,4011,1352,5363,5891,2016-12-26 23:00:00,725,92144,91710
"4983",17424,2016-12-27 00:00:00,726,1690,844,846,267,579,2016-12-27 00:00:00,726,446,3792,1252,5044,5490,2016-12-27 00:00:00,726,95807,95356
"4984",17425,2016-12-27 01:00:00,726,1599,723,876,239,637,2016-12-27 01:00:00,726,385,3405,1114,4519,4904,2016-12-27 01:00:00,726,96268,95822
"4985",17426,2016-12-27 02:00:00,726,1512,670,842,235,607,2016-12-27 02:00:00,726,322,3007,916,3923,4245,2016-12-27 02:00:00,726,92283,91870
"4986",17427,2016-12-27 03:00:00,726,1303,576,727,177,550,2016-12-27 03:00:00,726,242,2243,737,2980,3222,2016-12-27 03:00:00,726,90018,89635
"4987",17428,2016-12-27 04:00:00,726,1166,512,654,193,461,2016-12-27 04:00:00,726,205,1581,529,2110,2315,2016-12-27 04:00:00,726,86013,85689
"4988",17429,2016-12-27 05:00:00,726,1011,484,527,166,361,2016-12-27 05:00:00,726,147,1144,392,1536,1683,2016-12-27 05:00:00,726,81126,80784
"4989",17430,2016-12-27 06:00:00,726,764,340,424,129,295,2016-12-27 06:00:00,726,104,668,250,918,1022,2016-12-27 06:00:00,726,79068,78705
"4990",17431,2016-12-27 07:00:00,726,577,278,299,92,207,2016-12-27 07:00:00,726,77,317,107,424,501,2016-12-27 07:00:00,726,77168,76792
"4991",17432,2016-12-27 08:00:00,726,361,207,154,44,110,2016-12-27 08:00:00,726,64,167,68,235,299,2016-12-27 08:00:00,726,75117,74781
"4992",17433,2016-12-27 09:00:00,726,290,206,84,20,64,2016-12-27 09:00:00,726,45,99,29,128,173,2016-12-27 09:00:00,726,75182,74794
"4993",17434,2016-12-27 10:00:00,726,277,192,85,24,61,2016-12-27 10:00:00,726,44,65,26,91,135,2016-12-27 10:00:00,726,77452,77119
"4994",17435,2016-12-27 11:00:00,726,294,197,97,31,66,2016-12-27 11:00:00,726,55,69,34,103,158,2016-12-27 11:00:00,726,93040,92694
"4995",17436,2016-12-27 12:00:00,726,338,238,100,30,70,2016-12-27 12:00:00,726,55,227,103,330,385,2016-12-27 12:00:00,726,141895,141526
"4996",17437,2016-12-27 13:00:00,726,461,335,126,29,97,2016-12-27 13:00:00,726,179,520,220,740,919,2016-12-27 13:00:00,726,210797,210352
"4997",17438,2016-12-27 14:00:00,726,656,485,171,47,123,2016-12-27 14:00:00,726,374,1341,533,1874,2248,2016-12-27 14:00:00,726,222215,221596
"4998",17439,2016-12-27 15:00:00,726,803,568,235,49,186,2016-12-27 15:00:00,726,496,1850,687,2537,3033,2016-12-27 15:00:00,726,207931,207225
"4999",17440,2016-12-27 16:00:00,726,1063,678,385,89,295,2016-12-27 16:00:00,726,605,2135,785,2920,3525,2016-12-27 16:00:00,726,197542,196824
"5000",17441,2016-12-27 17:00:00,726,1124,631,493,114,379,2016-12-27 17:00:00,726,666,2534,964,3498,4164,2016-12-27 17:00:00,726,174942,174244
"5001",17442,2016-12-27 18:00:00,726,1431,769,662,183,479,2016-12-27 18:00:00,726,691,2607,939,3546,4237,2016-12-27 18:00:00,726,161628,160956
"5002",17443,2016-12-27 19:00:00,726,1536,836,700,188,512,2016-12-27 19:00:00,726,698,2725,969,3694,4392,2016-12-27 19:00:00,726,156050,155360
"5003",17444,2016-12-27 20:00:00,726,1661,869,792,276,516,2016-12-27 20:00:00,726,666,2875,993,3868,4534,2016-12-27 20:00:00,726,148673,147996
"5004",17445,2016-12-27 21:00:00,726,1556,843,713,225,488,2016-12-27 21:00:00,726,688,2761,972,3733,4421,2016-12-27 21:00:00,726,138380,137807
"5005",17446,2016-12-27 22:00:00,726,1446,776,670,217,453,2016-12-27 22:00:00,726,609,2807,998,3805,4414,2016-12-27 22:00:00,726,120197,119652
"5006",17447,2016-12-27 23:00:00,726,1452,774,678,194,484,2016-12-27 23:00:00,726,551,2817,985,3802,4353,2016-12-27 23:00:00,726,103192,102741
"5007",17448,2016-12-28 00:00:00,727,1494,762,732,215,517,2016-12-28 00:00:00,727,537,2718,913,3631,4168,2016-12-28 00:00:00,727,99843,99439
"5008",17449,2016-12-28 01:00:00,727,1593,747,846,214,632,2016-12-28 01:00:00,727,445,2811,878,3689,4134,2016-12-28 01:00:00,727,98843,98419
"5009",17450,2016-12-28 02:00:00,727,1308,649,659,150,509,2016-12-28 02:00:00,727,358,2966,864,3830,4188,2016-12-28 02:00:00,727,95028,94571
"5010",17451,2016-12-28 03:00:00,727,1272,587,685,144,541,2016-12-28 03:00:00,727,292,2176,662,2838,3130,2016-12-28 03:00:00,727,92477,92069
"5011",17452,2016-12-28 04:00:00,727,1238,619,619,154,465,2016-12-28 04:00:00,727,237,1412,447,1859,2096,2016-12-28 04:00:00,727,87875,87482
"5012",17453,2016-12-28 05:00:00,727,1063,499,564,146,418,2016-12-28 05:00:00,727,140,839,280,1119,1259,2016-12-28 05:00:00,727,82415,82037
"5013",17454,2016-12-28 06:00:00,727,775,410,365,131,234,2016-12-28 06:00:00,727,87,454,139,593,680,2016-12-28 06:00:00,727,80594,80247
"5014",17455,2016-12-28 07:00:00,727,564,322,242,66,176,2016-12-28 07:00:00,727,52,231,74,305,357,2016-12-28 07:00:00,727,78221,77823
"5015",17456,2016-12-28 08:00:00,727,485,294,191,71,120,2016-12-28 08:00:00,727,32,144,45,189,221,2016-12-28 08:00:00,727,76788,76436
"5016",17457,2016-12-28 09:00:00,727,340,211,129,54,75,2016-12-28 09:00:00,727,38,99,31,130,168,2016-12-28 09:00:00,727,77002,76631
"5017",17458,2016-12-28 10:00:00,727,327,236,91,28,63,2016-12-28 10:00:00,727,34,61,22,83,117,2016-12-28 10:00:00,727,74891,74534
"5018",17459,2016-12-28 11:00:00,727,314,220,94,26,68,2016-12-28 11:00:00,727,48,94,42,136,184,2016-12-28 11:00:00,727,80588,80256
"5019",17460,2016-12-28 12:00:00,727,376,259,117,36,81,2016-12-28 12:00:00,727,93,205,100,305,398,2016-12-28 12:00:00,727,103194,102816
"5020",17461,2016-12-28 13:00:00,727,498,337,161,46,115,2016-12-28 13:00:00,727,180,502,239,741,921,2016-12-28 13:00:00,727,138855,138374
"5021",17462,2016-12-28 14:00:00,727,624,444,180,46,134,2016-12-28 14:00:00,727,366,1101,473,1574,1940,2016-12-28 14:00:00,727,158148,157534
"5022",17463,2016-12-28 15:00:00,727,841,564,277,60,217,2016-12-28 15:00:00,727,492,1569,643,2212,2704,2016-12-28 15:00:00,727,162843,162144
"5023",17464,2016-12-28 16:00:00,727,826,549,277,69,208,2016-12-28 16:00:00,727,588,2004,838,2842,3430,2016-12-28 16:00:00,727,163331,162612
"5024",17465,2016-12-28 17:00:00,727,1192,736,456,114,342,2016-12-28 17:00:00,727,665,2157,831,2988,3653,2016-12-28 17:00:00,727,164765,164032
"5025",17466,2016-12-28 18:00:00,727,1380,773,607,190,417,2016-12-28 18:00:00,727,604,2310,878,3188,3792,2016-12-28 18:00:00,727,157417,156756
"5026",17467,2016-12-28 19:00:00,727,1469,847,622,185,437,2016-12-28 19:00:00,727,661,2430,923,3353,4014,2016-12-28 19:00:00,727,152309,151640
"5027",17468,2016-12-28 20:00:00,727,1417,793,624,175,449,2016-12-28 20:00:00,727,704,2620,1016,3636,4340,2016-12-28 20:00:00,727,145620,144947
"5028",17469,2016-12-28 21:00:00,727,1432,808,624,207,417,2016-12-28 21:00:00,727,625,2590,988,3578,4203,2016-12-28 21:00:00,727,135114,134468
"5029",17470,2016-12-28 22:00:00,727,1400,751,649,212,437,2016-12-28 22:00:00,727,592,2555,956,3511,4103,2016-12-28 22:00:00,727,116947,116455
"5030",17471,2016-12-28 23:00:00,727,1301,725,576,166,410,2016-12-28 23:00:00,727,551,2699,953,3652,4203,2016-12-28 23:00:00,727,101037,100622
"5031",17472,2016-12-29 00:00:00,728,1288,647,641,201,440,2016-12-29 00:00:00,728,470,2526,865,3391,3861,2016-12-29 00:00:00,728,96013,95578
"5032",17473,2016-12-29 01:00:00,728,1405,718,687,202,484,2016-12-29 01:00:00,728,390,2309,805,3114,3504,2016-12-29 01:00:00,728,94426,94014
"5033",17474,2016-12-29 02:00:00,728,1242,647,595,174,420,2016-12-29 02:00:00,728,365,1881,635,2516,2881,2016-12-29 02:00:00,728,90949,90546
"5034",17475,2016-12-29 03:00:00,728,1130,586,544,154,390,2016-12-29 03:00:00,728,269,1398,497,1895,2164,2016-12-29 03:00:00,728,88561,88129
"5035",17476,2016-12-29 04:00:00,728,941,487,454,114,340,2016-12-29 04:00:00,728,200,1014,354,1368,1568,2016-12-29 04:00:00,728,85234,84838
"5036",17477,2016-12-29 05:00:00,728,810,409,401,127,274,2016-12-29 05:00:00,728,130,780,261,1041,1171,2016-12-29 05:00:00,728,81145,80769
"5037",17478,2016-12-29 06:00:00,728,573,313,260,89,171,2016-12-29 06:00:00,728,74,432,170,602,676,2016-12-29 06:00:00,728,79152,78839
"5038",17479,2016-12-29 07:00:00,728,455,262,193,68,125,2016-12-29 07:00:00,728,81,184,79,263,344,2016-12-29 07:00:00,728,76364,76028
"5039",17480,2016-12-29 08:00:00,728,371,201,170,59,111,2016-12-29 08:00:00,728,43,131,49,180,223,2016-12-29 08:00:00,728,75588,75245
"5040",17481,2016-12-29 09:00:00,728,305,195,110,51,59,2016-12-29 09:00:00,728,35,64,23,87,122,2016-12-29 09:00:00,728,74942,74592
"5041",17482,2016-12-29 10:00:00,728,272,202,70,28,42,2016-12-29 10:00:00,728,26,59,26,85,111,2016-12-29 10:00:00,728,74504,74140
"5042",17483,2016-12-29 11:00:00,728,282,205,77,22,55,2016-12-29 11:00:00,728,38,66,35,101,139,2016-12-29 11:00:00,728,79600,79235
"5043",17484,2016-12-29 12:00:00,728,306,235,71,20,51,2016-12-29 12:00:00,728,69,138,63,201,270,2016-12-29 12:00:00,728,97891,97517
"5044",17485,2016-12-29 13:00:00,728,399,305,94,27,67,2016-12-29 13:00:00,728,183,407,178,585,768,2016-12-29 13:00:00,728,127988,127490
"5045",17486,2016-12-29 14:00:00,728,552,391,161,38,123,2016-12-29 14:00:00,728,310,802,366,1168,1478,2016-12-29 14:00:00,728,147925,147396
"5046",17487,2016-12-29 15:00:00,728,630,463,167,38,129,2016-12-29 15:00:00,728,447,1183,492,1675,2122,2016-12-29 15:00:00,728,156973,156300
"5047",17488,2016-12-29 16:00:00,728,1004,615,389,118,271,2016-12-29 16:00:00,728,607,1498,604,2102,2709,2016-12-29 16:00:00,728,158176,157488
"5048",17489,2016-12-29 17:00:00,728,1139,656,483,174,309,2016-12-29 17:00:00,728,661,1755,699,2454,3115,2016-12-29 17:00:00,728,150200,149489
"5049",17490,2016-12-29 18:00:00,728,1305,773,532,172,360,2016-12-29 18:00:00,728,621,1914,734,2648,3269,2016-12-29 18:00:00,728,144507,143859
"5050",17491,2016-12-29 19:00:00,728,1356,763,593,182,411,2016-12-29 19:00:00,728,681,1934,750,2684,3365,2016-12-29 19:00:00,728,143531,142902
"5051",17492,2016-12-29 20:00:00,728,1332,763,569,168,400,2016-12-29 20:00:00,728,714,2191,844,3035,3749,2016-12-29 20:00:00,728,138667,138043
"5052",17493,2016-12-29 21:00:00,728,1306,729,577,205,372,2016-12-29 21:00:00,728,643,2335,817,3152,3795,2016-12-29 21:00:00,728,130558,129960
"5053",17494,2016-12-29 22:00:00,728,1275,726,549,189,360,2016-12-29 22:00:00,728,580,2334,818,3152,3732,2016-12-29 22:00:00,728,115884,115364
"5054",17495,2016-12-29 23:00:00,728,1191,638,553,172,381,2016-12-29 23:00:00,728,449,2086,768,2854,3303,2016-12-29 23:00:00,728,99561,99099
"5055",17496,2016-12-30 00:00:00,729,1214,655,559,160,399,2016-12-30 00:00:00,729,409,2127,732,2859,3268,2016-12-30 00:00:00,729,93761,93346
"5056",17497,2016-12-30 01:00:00,729,1268,654,614,175,439,2016-12-30 01:00:00,729,395,1863,622,2485,2880,2016-12-30 01:00:00,729,91715,91332
"5057",17498,2016-12-30 02:00:00,729,1172,585,587,190,397,2016-12-30 02:00:00,729,396,1524,516,2040,2436,2016-12-30 02:00:00,729,86721,86322
"5058",17499,2016-12-30 03:00:00,729,1098,546,552,166,386,2016-12-30 03:00:00,729,295,1293,467,1760,2055,2016-12-30 03:00:00,729,83682,83292
"5059",17500,2016-12-30 04:00:00,729,986,473,513,162,351,2016-12-30 04:00:00,729,218,943,303,1246,1464,2016-12-30 04:00:00,729,77648,77296
"5060",17501,2016-12-30 05:00:00,729,780,387,393,116,277,2016-12-30 05:00:00,729,139,627,244,871,1010,2016-12-30 05:00:00,729,70962,70678
"5061",17502,2016-12-30 06:00:00,729,664,357,307,118,189,2016-12-30 06:00:00,729,117,371,125,496,613,2016-12-30 06:00:00,729,69133,68828
"5062",17503,2016-12-30 07:00:00,729,494,289,205,77,128,2016-12-30 07:00:00,729,57,190,71,261,318,2016-12-30 07:00:00,729,66359,66053
"5063",17504,2016-12-30 08:00:00,729,396,220,176,64,112,2016-12-30 08:00:00,729,50,106,30,136,186,2016-12-30 08:00:00,729,65097,64784
"5064",17505,2016-12-30 09:00:00,729,304,192,112,38,74,2016-12-30 09:00:00,729,58,71,21,92,150,2016-12-30 09:00:00,729,66123,65838
"5065",17506,2016-12-30 10:00:00,729,239,170,69,28,41,2016-12-30 10:00:00,729,45,53,21,74,119,2016-12-30 10:00:00,729,66599,66285
"5066",17507,2016-12-30 11:00:00,729,285,190,95,28,67,2016-12-30 11:00:00,729,46,87,39,126,172,2016-12-30 11:00:00,729,74267,73986
"5067",17508,2016-12-30 12:00:00,729,284,205,79,38,41,2016-12-30 12:00:00,729,87,138,66,204,291,2016-12-30 12:00:00,729,99144,98797
"5068",17509,2016-12-30 13:00:00,729,412,275,137,33,104,2016-12-30 13:00:00,729,163,341,127,468,631,2016-12-30 13:00:00,729,139135,138714
"5069",17510,2016-12-30 14:00:00,729,599,403,196,74,122,2016-12-30 14:00:00,729,373,808,342,1150,1523,2016-12-30 14:00:00,729,159270,158753
"5070",17511,2016-12-30 15:00:00,729,760,492,268,87,181,2016-12-30 15:00:00,729,437,1036,446,1482,1919,2016-12-30 15:00:00,729,162390,161789
"5071",17512,2016-12-30 16:00:00,729,914,580,334,109,225,2016-12-30 16:00:00,729,525,1424,620,2044,2569,2016-12-30 16:00:00,729,160092,159486
"5072",17513,2016-12-30 17:00:00,729,1079,658,421,149,272,2016-12-30 17:00:00,729,551,1541,590,2131,2682,2016-12-30 17:00:00,729,148573,147957
"5073",17514,2016-12-30 18:00:00,729,1083,625,458,152,306,2016-12-30 18:00:00,729,604,1705,669,2374,2978,2016-12-30 18:00:00,729,140858,140285
"5074",17515,2016-12-30 19:00:00,729,1182,679,503,167,336,2016-12-30 19:00:00,729,667,1729,660,2389,3056,2016-12-30 19:00:00,729,135413,134787
"5075",17516,2016-12-30 20:00:00,729,1157,619,538,178,360,2016-12-30 20:00:00,729,705,1916,696,2612,3317,2016-12-30 20:00:00,729,128228,127691
"5076",17517,2016-12-30 21:00:00,729,1215,679,536,178,358,2016-12-30 21:00:00,729,608,1907,730,2637,3245,2016-12-30 21:00:00,729,116638,116147
"5077",17518,2016-12-30 22:00:00,729,1195,694,501,146,355,2016-12-30 22:00:00,729,593,1953,725,2678,3271,2016-12-30 22:00:00,729,102123,101649
"5078",17519,2016-12-30 23:00:00,729,1045,580,465,154,311,2016-12-30 23:00:00,729,467,1939,688,2627,3094,2016-12-30 23:00:00,729,88215,87826
"5079",17520,2016-12-31 00:00:00,730,1047,560,487,148,339,2016-12-31 00:00:00,730,387,1714,596,2310,2697,2016-12-31 00:00:00,730,80197,79851
"5080",17521,2016-12-31 01:00:00,730,1087,565,522,184,338,2016-12-31 01:00:00,730,324,1615,551,2166,2490,2016-12-31 01:00:00,730,75252,74888
"5081",17522,2016-12-31 02:00:00,730,982,503,479,159,320,2016-12-31 02:00:00,730,295,1496,525,2021,2316,2016-12-31 02:00:00,730,72249,71861
"5082",17523,2016-12-31 03:00:00,730,834,395,439,110,329,2016-12-31 03:00:00,730,273,4671,1157,5828,6101,2016-12-31 03:00:00,730,74708,74367
"5083",17524,2016-12-31 04:00:00,730,1147,430,717,203,514,2016-12-31 04:00:00,730,199,1686,426,2112,2311,2016-12-31 04:00:00,730,68487,68212
"5084",17525,2016-12-31 05:00:00,730,829,408,421,136,285,2016-12-31 05:00:00,730,167,667,210,877,1044,2016-12-31 05:00:00,730,62730,62406
"5085",17526,2016-12-31 06:00:00,730,671,312,359,110,249,2016-12-31 06:00:00,730,110,458,149,607,717,2016-12-31 06:00:00,730,57879,57616
"5086",17527,2016-12-31 07:00:00,730,514,268,246,99,147,2016-12-31 07:00:00,730,87,252,81,333,420,2016-12-31 07:00:00,730,53485,53212
"5087",17528,2016-12-31 08:00:00,730,360,197,163,63,100,2016-12-31 08:00:00,730,47,117,50,167,214,2016-12-31 08:00:00,730,51227,50991
"5088",17529,2016-12-31 09:00:00,730,302,170,132,49,83,2016-12-31 09:00:00,730,27,82,36,118,145,2016-12-31 09:00:00,730,49741,49512
"5089",17530,2016-12-31 10:00:00,730,261,164,97,41,56,2016-12-31 10:00:00,730,38,42,18,60,98,2016-12-31 10:00:00,730,50852,50622
"5090",17531,2016-12-31 11:00:00,730,237,154,83,30,53,2016-12-31 11:00:00,730,53,45,22,67,120,2016-12-31 11:00:00,730,54060,53820
"5091",17532,2016-12-31 12:00:00,730,306,185,121,51,70,2016-12-31 12:00:00,730,50,106,44,150,200,2016-12-31 12:00:00,730,60479,60222
"5092",17533,2016-12-31 13:00:00,730,319,221,98,24,74,2016-12-31 13:00:00,730,136,259,108,367,503,2016-12-31 13:00:00,730,70107,69862
"5093",17534,2016-12-31 14:00:00,730,348,215,133,35,98,2016-12-31 14:00:00,730,193,556,220,776,969,2016-12-31 14:00:00,730,79035,78692
"5094",17535,2016-12-31 15:00:00,730,530,280,250,69,181,2016-12-31 15:00:00,730,309,903,356,1259,1568,2016-12-31 15:00:00,730,88565,88180
"5095",17536,2016-12-31 16:00:00,730,738,409,329,104,225,2016-12-31 16:00:00,730,380,1192,473,1665,2045,2016-12-31 16:00:00,730,89518,89111
"5096",17537,2016-12-31 17:00:00,730,798,410,388,120,267,2016-12-31 17:00:00,730,389,1428,525,1953,2342,2016-12-31 17:00:00,730,89536,89113
"5097",17538,2016-12-31 18:00:00,730,861,455,406,115,291,2016-12-31 18:00:00,730,445,1561,545,2106,2551,2016-12-31 18:00:00,730,86778,86390
"5098",17539,2016-12-31 19:00:00,730,900,465,435,138,297,2016-12-31 19:00:00,730,467,1571,556,2127,2594,2016-12-31 19:00:00,730,83534,83123
"5099",17540,2016-12-31 20:00:00,730,872,436,436,142,294,2016-12-31 20:00:00,730,457,1568,539,2107,2564,2016-12-31 20:00:00,730,78818,78419
"5100",17541,2016-12-31 21:00:00,730,884,457,427,134,293,2016-12-31 21:00:00,730,411,1574,555,2129,2540,2016-12-31 21:00:00,730,74326,73941
"5101",17542,2016-12-31 22:00:00,730,1058,543,515,159,356,2016-12-31 22:00:00,730,353,1453,476,1929,2282,2016-12-31 22:00:00,730,68030,67706
"5102",17543,2016-12-31 23:00:00,730,987,500,487,146,341,2016-12-31 23:00:00,730,303,1303,462,1765,2068,2016-12-31 23:00:00,730,63097,62805
"5103",17544,2017-01-01 00:00:00,731,923,460,463,120,343,2017-01-01 00:00:00,731,265,1300,430,1730,1995,2017-01-01 00:00:00,731,60305,60000
"5104",17545,2017-01-01 01:00:00,731,923,456,467,148,319,2017-01-01 01:00:00,731,205,1086,350,1436,1641,2017-01-01 01:00:00,731,58031,57744
"5105",17546,2017-01-01 02:00:00,731,810,411,399,126,273,2017-01-01 02:00:00,731,163,826,286,1112,1275,2017-01-01 02:00:00,731,54828,54583
"5106",17547,2017-01-01 03:00:00,731,705,344,361,137,224,2017-01-01 03:00:00,731,140,687,228,915,1055,2017-01-01 03:00:00,731,53984,53702
"5107",17548,2017-01-01 04:00:00,731,593,295,298,93,205,2017-01-01 04:00:00,731,99,417,128,545,644,2017-01-01 04:00:00,731,54421,54179
"5108",17549,2017-01-01 05:00:00,731,510,234,276,82,194,2017-01-01 05:00:00,731,82,333,118,451,533,2017-01-01 05:00:00,731,50504,50279
"5109",17550,2017-01-01 06:00:00,731,477,226,251,78,173,2017-01-01 06:00:00,731,66,280,92,372,438,2017-01-01 06:00:00,731,49067,48862
"5110",17551,2017-01-01 07:00:00,731,387,172,215,74,141,2017-01-01 07:00:00,731,58,171,52,223,281,2017-01-01 07:00:00,731,46454,46239
"5111",17552,2017-01-01 08:00:00,731,358,182,176,54,122,2017-01-01 08:00:00,731,45,120,47,167,212,2017-01-01 08:00:00,731,45544,45382
"5112",17553,2017-01-01 09:00:00,731,279,157,122,53,69,2017-01-01 09:00:00,731,34,73,23,96,130,2017-01-01 09:00:00,731,44411,44222
"5113",17554,2017-01-01 10:00:00,731,265,165,100,43,57,2017-01-01 10:00:00,731,34,63,20,83,117,2017-01-01 10:00:00,731,45816,45620
"5114",17555,2017-01-01 11:00:00,731,241,147,94,28,66,2017-01-01 11:00:00,731,17,88,23,111,128,2017-01-01 11:00:00,731,49448,49225
"5115",17556,2017-01-01 12:00:00,731,227,163,64,27,37,2017-01-01 12:00:00,731,39,82,33,115,154,2017-01-01 12:00:00,731,54150,53937
"5116",17557,2017-01-01 13:00:00,731,333,202,131,70,61,2017-01-01 13:00:00,731,60,169,66,235,295,2017-01-01 13:00:00,731,61708,61443
"5117",17558,2017-01-01 14:00:00,731,477,281,196,54,142,2017-01-01 14:00:00,731,96,361,126,487,583,2017-01-01 14:00:00,731,68775,68447
"5118",17559,2017-01-01 15:00:00,731,639,404,235,76,159,2017-01-01 15:00:00,731,153,606,243,849,1002,2017-01-01 15:00:00,731,76185,75863
"5119",17560,2017-01-01 16:00:00,731,735,459,276,107,169,2017-01-01 16:00:00,731,215,802,323,1125,1340,2017-01-01 16:00:00,731,83742,83421
"5120",17561,2017-01-01 17:00:00,731,885,517,368,136,232,2017-01-01 17:00:00,731,245,1176,414,1590,1835,2017-01-01 17:00:00,731,84334,83959
"5121",17562,2017-01-01 18:00:00,731,1019,583,436,163,273,2017-01-01 18:00:00,731,278,1379,517,1896,2174,2017-01-01 18:00:00,731,82446,82054
"5122",17563,2017-01-01 19:00:00,731,1025,502,523,177,346,2017-01-01 19:00:00,731,329,1503,521,2024,2353,2017-01-01 19:00:00,731,82205,81810
"5123",17564,2017-01-01 20:00:00,731,1080,577,503,170,333,2017-01-01 20:00:00,731,301,1652,588,2240,2541,2017-01-01 20:00:00,731,81176,80775
"5124",17565,2017-01-01 21:00:00,731,1105,593,512,176,336,2017-01-01 21:00:00,731,312,1685,627,2312,2624,2017-01-01 21:00:00,731,78155,77790
"5125",17566,2017-01-01 22:00:00,731,1111,577,534,181,353,2017-01-01 22:00:00,731,265,1602,540,2142,2407,2017-01-01 22:00:00,731,75045,74628
"5126",17567,2017-01-01 23:00:00,731,1017,550,467,159,308,2017-01-01 23:00:00,731,244,1612,520,2132,2376,2017-01-01 23:00:00,731,72239,71899
"5127",17568,2017-01-02 00:00:00,732,1036,557,479,155,324,2017-01-02 00:00:00,732,244,1469,497,1966,2210,2017-01-02 00:00:00,732,72038,71699
"5128",17569,2017-01-02 01:00:00,732,1206,611,595,185,410,2017-01-02 01:00:00,732,256,1399,448,1847,2103,2017-01-02 01:00:00,732,73660,73300
"5129",17570,2017-01-02 02:00:00,732,1030,543,487,142,344,2017-01-02 02:00:00,732,191,1295,462,1757,1948,2017-01-02 02:00:00,732,73453,73100
"5130",17571,2017-01-02 03:00:00,732,937,485,452,121,331,2017-01-02 03:00:00,732,202,942,324,1266,1468,2017-01-02 03:00:00,732,76816,76463
"5131",17572,2017-01-02 04:00:00,732,913,477,436,112,324,2017-01-02 04:00:00,732,134,704,265,969,1103,2017-01-02 04:00:00,732,80824,80456
"5132",17573,2017-01-02 05:00:00,732,749,399,350,104,246,2017-01-02 05:00:00,732,74,510,176,686,760,2017-01-02 05:00:00,732,75635,75295
"5133",17574,2017-01-02 06:00:00,732,569,307,262,76,186,2017-01-02 06:00:00,732,67,309,107,416,483,2017-01-02 06:00:00,732,73670,73344
"5134",17575,2017-01-02 07:00:00,732,517,256,261,92,169,2017-01-02 07:00:00,732,45,202,70,272,317,2017-01-02 07:00:00,732,70248,69932
"5135",17576,2017-01-02 08:00:00,732,424,241,183,73,110,2017-01-02 08:00:00,732,45,111,41,152,197,2017-01-02 08:00:00,732,69043,68755
"5136",17577,2017-01-02 09:00:00,732,350,214,136,62,74,2017-01-02 09:00:00,732,32,63,22,85,117,2017-01-02 09:00:00,732,70727,70394
"5137",17578,2017-01-02 10:00:00,732,338,222,116,56,60,2017-01-02 10:00:00,732,47,53,17,70,117,2017-01-02 10:00:00,732,72245,71877
"5138",17579,2017-01-02 11:00:00,732,311,229,82,36,46,2017-01-02 11:00:00,732,36,76,27,103,139,2017-01-02 11:00:00,732,78963,78593
"5139",17580,2017-01-02 12:00:00,732,394,257,137,58,79,2017-01-02 12:00:00,732,75,94,37,131,206,2017-01-02 12:00:00,732,97851,97473
"5140",17581,2017-01-02 13:00:00,732,539,378,161,58,103,2017-01-02 13:00:00,732,168,293,141,434,602,2017-01-02 13:00:00,732,117134,116735
"5141",17582,2017-01-02 14:00:00,732,703,478,225,101,124,2017-01-02 14:00:00,732,291,690,303,993,1284,2017-01-02 14:00:00,732,130083,129611
"5142",17583,2017-01-02 15:00:00,732,853,551,302,100,202,2017-01-02 15:00:00,732,423,1005,393,1398,1821,2017-01-02 15:00:00,732,133554,133023
"5143",17584,2017-01-02 16:00:00,732,976,615,361,118,243,2017-01-02 16:00:00,732,561,1426,567,1993,2554,2017-01-02 16:00:00,732,133334,132840
"5144",17585,2017-01-02 17:00:00,732,1195,750,445,139,306,2017-01-02 17:00:00,732,590,1784,683,2467,3057,2017-01-02 17:00:00,732,128475,127905
"5145",17586,2017-01-02 18:00:00,732,1331,798,533,179,354,2017-01-02 18:00:00,732,598,1942,746,2688,3286,2017-01-02 18:00:00,732,125197,124634
"5146",17587,2017-01-02 19:00:00,732,1409,809,600,213,387,2017-01-02 19:00:00,732,732,2080,812,2892,3624,2017-01-02 19:00:00,732,123025,122464
"5147",17588,2017-01-02 20:00:00,732,1416,770,646,223,423,2017-01-02 20:00:00,732,706,2107,766,2873,3579,2017-01-02 20:00:00,732,119298,118755
"5148",17589,2017-01-02 21:00:00,732,1412,809,603,241,362,2017-01-02 21:00:00,732,608,2133,807,2940,3548,2017-01-02 21:00:00,732,111951,111445
"5149",17590,2017-01-02 22:00:00,732,1345,785,560,200,360,2017-01-02 22:00:00,732,571,1965,724,2689,3260,2017-01-02 22:00:00,732,102825,102365
"5150",17591,2017-01-02 23:00:00,732,1214,705,509,163,346,2017-01-02 23:00:00,732,452,1985,724,2709,3161,2017-01-02 23:00:00,732,95944,95503
"5151",17592,2017-01-03 00:00:00,733,1169,654,515,171,344,2017-01-03 00:00:00,733,429,1926,687,2613,3042,2017-01-03 00:00:00,733,100377,99937
"5152",17593,2017-01-03 01:00:00,733,1103,589,514,179,335,2017-01-03 01:00:00,733,444,1688,596,2284,2728,2017-01-03 01:00:00,733,103841,103385
"5153",17594,2017-01-03 02:00:00,733,1019,543,476,149,327,2017-01-03 02:00:00,733,283,1483,528,2011,2294,2017-01-03 02:00:00,733,95014,94577
"5154",17595,2017-01-03 03:00:00,733,956,535,421,147,274,2017-01-03 03:00:00,733,236,1138,418,1556,1792,2017-01-03 03:00:00,733,90171,89764
"5155",17596,2017-01-03 04:00:00,733,791,460,331,114,217,2017-01-03 04:00:00,733,171,815,301,1116,1287,2017-01-03 04:00:00,733,84205,83856
"5156",17597,2017-01-03 05:00:00,733,739,396,343,142,200,2017-01-03 05:00:00,733,130,469,164,633,763,2017-01-03 05:00:00,733,81288,80977
"5157",17598,2017-01-03 06:00:00,733,522,286,236,97,139,2017-01-03 06:00:00,733,84,263,103,366,450,2017-01-03 06:00:00,733,81458,81091
"5158",17599,2017-01-03 07:00:00,733,410,255,155,64,91,2017-01-03 07:00:00,733,62,155,63,218,280,2017-01-03 07:00:00,733,81729,81360
"5159",17600,2017-01-03 08:00:00,733,330,212,118,56,62,2017-01-03 08:00:00,733,49,76,37,113,162,2017-01-03 08:00:00,733,83316,82920
"5160",17601,2017-01-03 09:00:00,733,307,211,96,36,60,2017-01-03 09:00:00,733,31,42,17,59,90,2017-01-03 09:00:00,733,85020,84613
"5161",17602,2017-01-03 10:00:00,733,310,205,105,44,61,2017-01-03 10:00:00,733,21,41,16,57,78,2017-01-03 10:00:00,733,86876,86501
"5162",17603,2017-01-03 11:00:00,733,327,241,86,33,53,2017-01-03 11:00:00,733,38,89,34,123,161,2017-01-03 11:00:00,733,106152,105726
"5163",17604,2017-01-03 12:00:00,733,359,266,93,29,64,2017-01-03 12:00:00,733,73,138,69,207,280,2017-01-03 12:00:00,733,175220,174769
"5164",17605,2017-01-03 13:00:00,733,557,411,146,69,77,2017-01-03 13:00:00,733,152,316,177,493,645,2017-01-03 13:00:00,733,270922,270306
"5165",17606,2017-01-03 14:00:00,733,668,484,184,92,92,2017-01-03 14:00:00,733,334,623,296,919,1253,2017-01-03 14:00:00,733,286339,285610
"5166",17607,2017-01-03 15:00:00,733,782,579,203,87,116,2017-01-03 15:00:00,733,508,836,415,1251,1759,2017-01-03 15:00:00,733,262803,261957
"5167",17608,2017-01-03 16:00:00,733,934,661,273,77,196,2017-01-03 16:00:00,733,550,1125,516,1641,2191,2017-01-03 16:00:00,733,244958,244114
"5168",17609,2017-01-03 17:00:00,733,1040,724,316,108,208,2017-01-03 17:00:00,733,634,1185,570,1755,2389,2017-01-03 17:00:00,733,211792,211041
"5169",17610,2017-01-03 18:00:00,733,1104,766,338,116,222,2017-01-03 18:00:00,733,634,1414,597,2011,2645,2017-01-03 18:00:00,733,198626,197863
"5170",17611,2017-01-03 19:00:00,733,1105,734,371,119,252,2017-01-03 19:00:00,733,769,1556,660,2216,2985,2017-01-03 19:00:00,733,188446,187693
"5171",17612,2017-01-03 20:00:00,733,1267,784,483,135,348,2017-01-03 20:00:00,733,695,1752,737,2489,3184,2017-01-03 20:00:00,733,174487,173829
"5172",17613,2017-01-03 21:00:00,733,1313,835,478,162,316,2017-01-03 21:00:00,733,745,1903,745,2648,3393,2017-01-03 21:00:00,733,145868,145373
"5173",17614,2017-01-03 22:00:00,733,1259,773,486,170,316,2017-01-03 22:00:00,733,607,2000,806,2806,3413,2017-01-03 22:00:00,733,103902,103729
"5174",17615,2017-01-03 23:00:00,733,1233,737,496,179,317,2017-01-03 23:00:00,733,530,2050,774,2824,3354,2017-01-03 23:00:00,733,114408,113922
"5175",17616,2017-01-04 00:00:00,734,1144,653,491,183,308,2017-01-04 00:00:00,734,460,1923,748,2671,3131,2017-01-04 00:00:00,734,106877,106428
"5176",17617,2017-01-04 01:00:00,734,1055,634,421,153,268,2017-01-04 01:00:00,734,357,1752,670,2422,2779,2017-01-04 01:00:00,734,103143,102694
"5177",17618,2017-01-04 02:00:00,734,1071,635,436,166,270,2017-01-04 02:00:00,734,356,1257,481,1738,2094,2017-01-04 02:00:00,734,97325,96894
"5178",17619,2017-01-04 03:00:00,734,940,576,364,130,233,2017-01-04 03:00:00,734,298,945,335,1280,1578,2017-01-04 03:00:00,734,91244,90860
"5179",17620,2017-01-04 04:00:00,734,749,448,301,108,193,2017-01-04 04:00:00,734,212,699,268,967,1179,2017-01-04 04:00:00,734,86027,85651
"5180",17621,2017-01-04 05:00:00,734,631,370,261,89,172,2017-01-04 05:00:00,734,136,450,176,626,762,2017-01-04 05:00:00,734,80814,80470
"5181",17622,2017-01-04 06:00:00,734,500,304,196,75,121,2017-01-04 06:00:00,734,93,247,89,336,429,2017-01-04 06:00:00,734,81225,80872
"5182",17623,2017-01-04 07:00:00,734,448,277,171,82,89,2017-01-04 07:00:00,734,57,140,65,205,262,2017-01-04 07:00:00,734,82338,81937
"5183",17624,2017-01-04 08:00:00,734,341,217,124,51,73,2017-01-04 08:00:00,734,30,76,29,105,135,2017-01-04 08:00:00,734,83921,83492
"5184",17625,2017-01-04 09:00:00,734,298,205,93,45,48,2017-01-04 09:00:00,734,30,60,21,81,111,2017-01-04 09:00:00,734,86027,85604
"5185",17626,2017-01-04 10:00:00,734,270,208,62,18,44,2017-01-04 10:00:00,734,37,47,16,63,100,2017-01-04 10:00:00,734,84719,84287
"5186",17627,2017-01-04 11:00:00,734,324,233,91,38,53,2017-01-04 11:00:00,734,47,78,41,119,166,2017-01-04 11:00:00,734,90517,90144
"5187",17628,2017-01-04 12:00:00,734,339,252,87,32,55,2017-01-04 12:00:00,734,99,135,71,206,305,2017-01-04 12:00:00,734,116190,115741
"5188",17629,2017-01-04 13:00:00,734,474,357,117,45,72,2017-01-04 13:00:00,734,182,293,163,456,638,2017-01-04 13:00:00,734,158823,158263
"5189",17630,2017-01-04 14:00:00,734,607,461,146,57,89,2017-01-04 14:00:00,734,380,578,283,861,1241,2017-01-04 14:00:00,734,188601,187905
"5190",17631,2017-01-04 15:00:00,734,756,573,183,59,124,2017-01-04 15:00:00,734,496,744,344,1088,1584,2017-01-04 15:00:00,734,195903,195155
"5191",17632,2017-01-04 16:00:00,734,841,609,232,92,140,2017-01-04 16:00:00,734,587,969,459,1428,2015,2017-01-04 16:00:00,734,195747,194916
"5192",17633,2017-01-04 17:00:00,734,937,650,287,105,181,2017-01-04 17:00:00,734,611,1141,531,1672,2283,2017-01-04 17:00:00,734,181319,180550
"5193",17634,2017-01-04 18:00:00,734,970,684,286,98,188,2017-01-04 18:00:00,734,629,1270,558,1828,2457,2017-01-04 18:00:00,734,178854,178099
"5194",17635,2017-01-04 19:00:00,734,1110,779,331,120,210,2017-01-04 19:00:00,734,681,1338,554,1892,2573,2017-01-04 19:00:00,734,177948,177140
"5195",17636,2017-01-04 20:00:00,734,1135,781,354,136,218,2017-01-04 20:00:00,734,716,1608,665,2273,2989,2017-01-04 20:00:00,734,169722,168961
"5196",17637,2017-01-04 21:00:00,734,1165,740,425,147,278,2017-01-04 21:00:00,734,700,1755,668,2423,3123,2017-01-04 21:00:00,734,154343,153695
"5197",17638,2017-01-04 22:00:00,734,1158,725,433,150,283,2017-01-04 22:00:00,734,621,1927,721,2648,3269,2017-01-04 22:00:00,734,130452,129880
"5198",17639,2017-01-04 23:00:00,734,1101,668,433,151,282,2017-01-04 23:00:00,734,515,1849,711,2560,3075,2017-01-04 23:00:00,734,108443,107943
"5199",17640,2017-01-05 00:00:00,735,1011,599,412,142,270,2017-01-05 00:00:00,735,471,1660,625,2285,2756,2017-01-05 00:00:00,735,100839,100397
"5200",17641,2017-01-05 01:00:00,735,1144,699,445,145,300,2017-01-05 01:00:00,735,426,1579,606,2185,2611,2017-01-05 01:00:00,735,97611,97196
"5201",17642,2017-01-05 02:00:00,735,1043,639,404,146,258,2017-01-05 02:00:00,735,361,1244,427,1671,2032,2017-01-05 02:00:00,735,95829,95372
"5202",17643,2017-01-05 03:00:00,735,907,574,333,107,226,2017-01-05 03:00:00,735,308,929,322,1251,1559,2017-01-05 03:00:00,735,91924,91501
"5203",17644,2017-01-05 04:00:00,735,731,444,287,100,187,2017-01-05 04:00:00,735,206,665,244,909,1115,2017-01-05 04:00:00,735,87418,87051
"5204",17645,2017-01-05 05:00:00,735,636,418,218,64,154,2017-01-05 05:00:00,735,130,427,150,577,707,2017-01-05 05:00:00,735,82133,81778
"5205",17646,2017-01-05 06:00:00,735,530,307,223,76,147,2017-01-05 06:00:00,735,81,222,82,304,385,2017-01-05 06:00:00,735,82188,81814
"5206",17647,2017-01-05 07:00:00,735,351,215,136,44,92,2017-01-05 07:00:00,735,52,106,38,144,196,2017-01-05 07:00:00,735,82696,82320
"5207",17648,2017-01-05 08:00:00,735,356,228,128,60,68,2017-01-05 08:00:00,735,48,67,19,86,134,2017-01-05 08:00:00,735,83992,83597
"5208",17649,2017-01-05 09:00:00,735,285,187,98,39,59,2017-01-05 09:00:00,735,60,57,22,79,139,2017-01-05 09:00:00,735,87236,86840
"5209",17650,2017-01-05 10:00:00,735,190,148,42,16,26,2017-01-05 10:00:00,735,39,36,13,49,88,2017-01-05 10:00:00,735,85454,85109
"5210",17651,2017-01-05 11:00:00,735,336,245,91,43,48,2017-01-05 11:00:00,735,57,62,30,92,149,2017-01-05 11:00:00,735,91077,90676
"5211",17652,2017-01-05 12:00:00,735,322,245,77,38,39,2017-01-05 12:00:00,735,97,100,47,147,244,2017-01-05 12:00:00,735,114811,114353
"5212",17653,2017-01-05 13:00:00,735,498,386,112,45,67,2017-01-05 13:00:00,735,196,345,165,510,706,2017-01-05 13:00:00,735,153715,153191
"5213",17654,2017-01-05 14:00:00,735,612,461,151,57,94,2017-01-05 14:00:00,735,355,628,267,895,1250,2017-01-05 14:00:00,735,183807,183112
"5214",17655,2017-01-05 15:00:00,735,717,567,150,56,94,2017-01-05 15:00:00,735,517,666,320,986,1503,2017-01-05 15:00:00,735,193466,192719
"5215",17656,2017-01-05 16:00:00,735,869,625,244,89,155,2017-01-05 16:00:00,735,573,833,342,1175,1748,2017-01-05 16:00:00,735,192351,191507
"5216",17657,2017-01-05 17:00:00,735,867,619,248,94,154,2017-01-05 17:00:00,735,666,1033,439,1472,2138,2017-01-05 17:00:00,735,181059,180294
"5217",17658,2017-01-05 18:00:00,735,845,609,236,96,140,2017-01-05 18:00:00,735,628,1125,512,1637,2265,2017-01-05 18:00:00,735,175681,174957
"5218",17659,2017-01-05 19:00:00,735,972,699,273,98,175,2017-01-05 19:00:00,735,674,1252,485,1737,2411,2017-01-05 19:00:00,735,171522,170771
"5219",17660,2017-01-05 20:00:00,735,995,667,328,107,221,2017-01-05 20:00:00,735,721,1430,565,1995,2716,2017-01-05 20:00:00,735,164192,163495
"5220",17661,2017-01-05 21:00:00,735,1160,710,450,161,289,2017-01-05 21:00:00,735,689,1636,669,2305,2994,2017-01-05 21:00:00,735,150417,149786
"5221",17662,2017-01-05 22:00:00,735,1011,592,419,127,292,2017-01-05 22:00:00,735,642,1736,658,2394,3036,2017-01-05 22:00:00,735,127926,127361
"5222",17663,2017-01-05 23:00:00,735,1090,653,437,160,277,2017-01-05 23:00:00,735,560,1851,671,2522,3082,2017-01-05 23:00:00,735,109507,109034
"5223",17664,2017-01-06 00:00:00,736,956,581,375,133,242,2017-01-06 00:00:00,736,471,1614,597,2211,2682,2017-01-06 00:00:00,736,103671,103227
"5224",17665,2017-01-06 01:00:00,736,1009,595,414,162,252,2017-01-06 01:00:00,736,426,1470,511,1981,2407,2017-01-06 01:00:00,736,102252,101790
"5225",17666,2017-01-06 02:00:00,736,918,579,339,121,218,2017-01-06 02:00:00,736,316,1194,413,1607,1923,2017-01-06 02:00:00,736,95483,95035
"5226",17667,2017-01-06 03:00:00,736,957,596,361,156,205,2017-01-06 03:00:00,736,257,870,314,1184,1441,2017-01-06 03:00:00,736,89801,89423
"5227",17668,2017-01-06 04:00:00,736,699,434,265,87,178,2017-01-06 04:00:00,736,197,624,237,861,1058,2017-01-06 04:00:00,736,82616,82232
"5228",17669,2017-01-06 05:00:00,736,620,349,271,96,175,2017-01-06 05:00:00,736,144,453,165,618,762,2017-01-06 05:00:00,736,76158,75844
"5229",17670,2017-01-06 06:00:00,736,407,262,145,46,99,2017-01-06 06:00:00,736,104,213,95,308,412,2017-01-06 06:00:00,736,75726,75392
"5230",17671,2017-01-06 07:00:00,736,308,190,118,41,77,2017-01-06 07:00:00,736,69,128,50,178,247,2017-01-06 07:00:00,736,74094,73790
"5231",17672,2017-01-06 08:00:00,736,279,181,98,30,68,2017-01-06 08:00:00,736,60,75,31,106,166,2017-01-06 08:00:00,736,74338,74020
"5232",17673,2017-01-06 09:00:00,736,244,169,75,32,43,2017-01-06 09:00:00,736,25,30,10,40,65,2017-01-06 09:00:00,736,77114,76757
"5233",17674,2017-01-06 10:00:00,736,250,197,53,17,36,2017-01-06 10:00:00,736,31,36,14,50,81,2017-01-06 10:00:00,736,77142,76787
"5234",17675,2017-01-06 11:00:00,736,292,205,87,30,57,2017-01-06 11:00:00,736,43,47,22,69,112,2017-01-06 11:00:00,736,87045,86725
"5235",17676,2017-01-06 12:00:00,736,341,253,88,36,52,2017-01-06 12:00:00,736,80,116,65,181,261,2017-01-06 12:00:00,736,123551,123143
"5236",17677,2017-01-06 13:00:00,736,437,321,116,51,65,2017-01-06 13:00:00,736,198,312,146,458,656,2017-01-06 13:00:00,736,185775,185277
"5237",17678,2017-01-06 14:00:00,736,558,426,132,57,75,2017-01-06 14:00:00,736,327,492,218,710,1037,2017-01-06 14:00:00,736,217520,216903
"5238",17679,2017-01-06 15:00:00,736,708,511,197,72,125,2017-01-06 15:00:00,736,496,661,314,975,1471,2017-01-06 15:00:00,736,217221,216483
"5239",17680,2017-01-06 16:00:00,736,852,627,225,94,130,2017-01-06 16:00:00,736,573,872,392,1264,1837,2017-01-06 16:00:00,736,212534,211788
"5240",17681,2017-01-06 17:00:00,736,825,572,253,83,170,2017-01-06 17:00:00,736,628,1127,481,1608,2236,2017-01-06 17:00:00,736,192323,191596
"5241",17682,2017-01-06 18:00:00,736,864,601,263,88,173,2017-01-06 18:00:00,736,693,1121,459,1580,2273,2017-01-06 18:00:00,736,182956,182257
"5242",17683,2017-01-06 19:00:00,736,921,631,290,118,172,2017-01-06 19:00:00,736,708,1248,471,1719,2427,2017-01-06 19:00:00,736,177340,176600
"5243",17684,2017-01-06 20:00:00,736,926,612,314,111,203,2017-01-06 20:00:00,736,704,1453,535,1988,2692,2017-01-06 20:00:00,736,164626,163936
"5244",17685,2017-01-06 21:00:00,736,1027,642,385,135,250,2017-01-06 21:00:00,736,646,1689,632,2321,2967,2017-01-06 21:00:00,736,148074,147413
"5245",17686,2017-01-06 22:00:00,736,1055,643,412,153,259,2017-01-06 22:00:00,736,598,1761,634,2395,2993,2017-01-06 22:00:00,736,121333,120861
"5246",17687,2017-01-06 23:00:00,736,1048,571,477,167,310,2017-01-06 23:00:00,736,476,1705,589,2294,2770,2017-01-06 23:00:00,736,100151,99695
"5247",17688,2017-01-07 00:00:00,737,933,499,434,164,270,2017-01-07 00:00:00,737,442,1745,611,2356,2798,2017-01-07 00:00:00,737,89090,88687
"5248",17689,2017-01-07 01:00:00,737,1039,615,424,148,276,2017-01-07 01:00:00,737,335,1494,471,1965,2300,2017-01-07 01:00:00,737,81580,81235
"5249",17690,2017-01-07 02:00:00,737,924,499,425,132,293,2017-01-07 02:00:00,737,301,1336,430,1766,2067,2017-01-07 02:00:00,737,76095,75774
"5250",17691,2017-01-07 03:00:00,737,846,467,379,94,285,2017-01-07 03:00:00,737,278,1094,375,1469,1747,2017-01-07 03:00:00,737,73536,73195
"5251",17692,2017-01-07 04:00:00,737,795,424,371,136,235,2017-01-07 04:00:00,737,176,819,269,1088,1264,2017-01-07 04:00:00,737,70489,70195
"5252",17693,2017-01-07 05:00:00,737,668,348,320,100,220,2017-01-07 05:00:00,737,133,625,224,849,982,2017-01-07 05:00:00,737,66321,66023
"5253",17694,2017-01-07 06:00:00,737,476,267,209,66,143,2017-01-07 06:00:00,737,109,335,130,465,574,2017-01-07 06:00:00,737,61632,61338
"5254",17695,2017-01-07 07:00:00,737,411,236,175,72,103,2017-01-07 07:00:00,737,63,177,56,233,296,2017-01-07 07:00:00,737,58223,57939
"5255",17696,2017-01-07 08:00:00,737,357,203,154,63,91,2017-01-07 08:00:00,737,45,103,29,132,177,2017-01-07 08:00:00,737,55399,55129
"5256",17697,2017-01-07 09:00:00,737,296,189,107,38,69,2017-01-07 09:00:00,737,51,50,14,64,115,2017-01-07 09:00:00,737,54755,54508
"5257",17698,2017-01-07 10:00:00,737,253,158,95,46,49,2017-01-07 10:00:00,737,33,42,15,57,90,2017-01-07 10:00:00,737,55849,55591
"5258",17699,2017-01-07 11:00:00,737,262,167,95,51,44,2017-01-07 11:00:00,737,39,41,16,57,96,2017-01-07 11:00:00,737,60325,60100
"5259",17700,2017-01-07 12:00:00,737,340,213,127,51,76,2017-01-07 12:00:00,737,68,93,39,132,200,2017-01-07 12:00:00,737,68288,68014
"5260",17701,2017-01-07 13:00:00,737,419,255,164,57,107,2017-01-07 13:00:00,737,137,242,110,352,489,2017-01-07 13:00:00,737,79349,79041
"5261",17702,2017-01-07 14:00:00,737,694,459,235,87,148,2017-01-07 14:00:00,737,229,574,234,808,1037,2017-01-07 14:00:00,737,90215,89853
"5262",17703,2017-01-07 15:00:00,737,712,447,265,83,182,2017-01-07 15:00:00,737,354,1009,406,1415,1769,2017-01-07 15:00:00,737,100959,100483
"5263",17704,2017-01-07 16:00:00,737,901,535,366,126,240,2017-01-07 16:00:00,737,401,1246,492,1738,2139,2017-01-07 16:00:00,737,106272,105800
"5264",17705,2017-01-07 17:00:00,737,1072,687,385,130,255,2017-01-07 17:00:00,737,505,1482,573,2055,2560,2017-01-07 17:00:00,737,107440,106951
"5265",17706,2017-01-07 18:00:00,737,1045,633,412,150,262,2017-01-07 18:00:00,737,541,1582,599,2181,2722,2017-01-07 18:00:00,737,104009,103482
"5266",17707,2017-01-07 19:00:00,737,1020,570,450,149,301,2017-01-07 19:00:00,737,552,1793,635,2428,2980,2017-01-07 19:00:00,737,100973,100468
"5267",17708,2017-01-07 20:00:00,737,1120,601,519,188,331,2017-01-07 20:00:00,737,525,1820,626,2446,2971,2017-01-07 20:00:00,737,97276,96812
"5268",17709,2017-01-07 21:00:00,737,1019,538,481,140,341,2017-01-07 21:00:00,737,525,1990,697,2687,3212,2017-01-07 21:00:00,737,91014,90570
"5269",17710,2017-01-07 22:00:00,737,1191,643,548,159,389,2017-01-07 22:00:00,737,521,1692,603,2295,2816,2017-01-07 22:00:00,737,83938,83503
"5270",17711,2017-01-07 23:00:00,737,1105,540,565,175,390,2017-01-07 23:00:00,737,480,1608,596,2204,2684,2017-01-07 23:00:00,737,78066,77698
"5271",17712,2017-01-08 00:00:00,738,1052,509,543,204,339,2017-01-08 00:00:00,738,360,1549,504,2053,2413,2017-01-08 00:00:00,738,73648,73307
"5272",17713,2017-01-08 01:00:00,738,1052,530,522,187,335,2017-01-08 01:00:00,738,330,1450,489,1939,2269,2017-01-08 01:00:00,738,71897,71551
"5273",17714,2017-01-08 02:00:00,738,804,437,367,101,265,2017-01-08 02:00:00,738,309,1174,400,1574,1883,2017-01-08 02:00:00,738,70734,70419
"5274",17715,2017-01-08 03:00:00,738,777,425,352,93,259,2017-01-08 03:00:00,738,224,900,318,1218,1442,2017-01-08 03:00:00,738,71199,70864
"5275",17716,2017-01-08 04:00:00,738,742,406,336,88,247,2017-01-08 04:00:00,738,165,741,263,1004,1169,2017-01-08 04:00:00,738,71562,71242
"5276",17717,2017-01-08 05:00:00,738,708,349,359,129,230,2017-01-08 05:00:00,738,147,506,187,693,840,2017-01-08 05:00:00,738,66430,66145
"5277",17718,2017-01-08 06:00:00,738,503,248,255,89,166,2017-01-08 06:00:00,738,81,297,108,405,486,2017-01-08 06:00:00,738,61101,60829
"5278",17719,2017-01-08 07:00:00,738,530,283,247,118,128,2017-01-08 07:00:00,738,75,153,44,197,272,2017-01-08 07:00:00,738,57067,56797
"5279",17720,2017-01-08 08:00:00,738,361,202,159,55,104,2017-01-08 08:00:00,738,58,109,43,152,210,2017-01-08 08:00:00,738,55828,55582
"5280",17721,2017-01-08 09:00:00,738,350,209,141,44,97,2017-01-08 09:00:00,738,29,69,24,93,122,2017-01-08 09:00:00,738,54929,54673
"5281",17722,2017-01-08 10:00:00,738,282,178,104,36,68,2017-01-08 10:00:00,738,27,55,22,77,104,2017-01-08 10:00:00,738,55461,55227
"5282",17723,2017-01-08 11:00:00,738,279,170,109,53,56,2017-01-08 11:00:00,738,46,42,17,59,105,2017-01-08 11:00:00,738,59424,59189
"5283",17724,2017-01-08 12:00:00,738,308,185,123,51,72,2017-01-08 12:00:00,738,58,82,35,117,175,2017-01-08 12:00:00,738,66684,66383
"5284",17725,2017-01-08 13:00:00,738,396,251,145,52,92,2017-01-08 13:00:00,738,110,191,62,253,363,2017-01-08 13:00:00,738,74670,74364
"5285",17726,2017-01-08 14:00:00,738,570,346,224,90,134,2017-01-08 14:00:00,738,186,528,214,742,928,2017-01-08 14:00:00,738,83359,83012
"5286",17727,2017-01-08 15:00:00,738,774,501,273,107,166,2017-01-08 15:00:00,738,262,831,314,1145,1407,2017-01-08 15:00:00,738,91500,91106
"5287",17728,2017-01-08 16:00:00,738,875,545,330,140,190,2017-01-08 16:00:00,738,341,1069,429,1498,1839,2017-01-08 16:00:00,738,97372,96943
"5288",17729,2017-01-08 17:00:00,738,894,527,367,129,238,2017-01-08 17:00:00,738,374,1407,566,1973,2347,2017-01-08 17:00:00,738,98425,97952
"5289",17730,2017-01-08 18:00:00,738,1023,607,416,154,262,2017-01-08 18:00:00,738,397,1571,551,2122,2519,2017-01-08 18:00:00,738,96743,96293
"5290",17731,2017-01-08 19:00:00,738,1144,692,452,180,272,2017-01-08 19:00:00,738,445,1546,564,2110,2555,2017-01-08 19:00:00,738,96453,95988
"5291",17732,2017-01-08 20:00:00,738,1077,626,451,168,283,2017-01-08 20:00:00,738,480,1756,689,2445,2925,2017-01-08 20:00:00,738,96474,95996
"5292",17733,2017-01-08 21:00:00,738,1122,629,493,170,323,2017-01-08 21:00:00,738,423,1694,587,2281,2704,2017-01-08 21:00:00,738,92241,91787
"5293",17734,2017-01-08 22:00:00,738,1113,655,458,161,297,2017-01-08 22:00:00,738,393,1621,604,2225,2618,2017-01-08 22:00:00,738,86725,86270
"5294",17735,2017-01-08 23:00:00,738,996,570,426,159,267,2017-01-08 23:00:00,738,434,1366,460,1826,2260,2017-01-08 23:00:00,738,83377,82958
"5295",17736,2017-01-09 00:00:00,739,940,592,348,138,210,2017-01-09 00:00:00,739,304,1311,459,1770,2074,2017-01-09 00:00:00,739,87992,87637
"5296",17737,2017-01-09 01:00:00,739,1070,595,475,148,327,2017-01-09 01:00:00,739,271,1143,417,1560,1831,2017-01-09 01:00:00,739,94768,94400
"5297",17738,2017-01-09 02:00:00,739,914,522,392,120,272,2017-01-09 02:00:00,739,257,916,352,1268,1525,2017-01-09 02:00:00,739,91780,91406
"5298",17739,2017-01-09 03:00:00,739,871,514,357,113,244,2017-01-09 03:00:00,739,180,623,233,856,1036,2017-01-09 03:00:00,739,89904,89551
"5299",17740,2017-01-09 04:00:00,739,743,424,319,102,217,2017-01-09 04:00:00,739,146,357,116,473,619,2017-01-09 04:00:00,739,87720,87378
"5300",17741,2017-01-09 05:00:00,739,566,309,257,89,168,2017-01-09 05:00:00,739,88,235,91,326,414,2017-01-09 05:00:00,739,83147,82849
"5301",17742,2017-01-09 06:00:00,739,434,254,180,72,107,2017-01-09 06:00:00,739,62,174,58,232,294,2017-01-09 06:00:00,739,85094,84771
"5302",17743,2017-01-09 07:00:00,739,317,202,115,43,72,2017-01-09 07:00:00,739,51,81,34,115,166,2017-01-09 07:00:00,739,86337,85969
"5303",17744,2017-01-09 08:00:00,739,355,238,117,63,54,2017-01-09 08:00:00,739,42,49,19,68,110,2017-01-09 08:00:00,739,88874,88474
"5304",17745,2017-01-09 09:00:00,739,300,213,87,41,46,2017-01-09 09:00:00,739,29,40,15,55,84,2017-01-09 09:00:00,739,91580,91160
"5305",17746,2017-01-09 10:00:00,739,258,186,72,33,39,2017-01-09 10:00:00,739,39,47,20,67,106,2017-01-09 10:00:00,739,91550,91121
"5306",17747,2017-01-09 11:00:00,739,261,193,68,27,41,2017-01-09 11:00:00,739,43,42,21,63,106,2017-01-09 11:00:00,739,103913,103531
"5307",17748,2017-01-09 12:00:00,739,316,249,67,30,37,2017-01-09 12:00:00,739,84,131,66,197,281,2017-01-09 12:00:00,739,156770,156312
"5308",17749,2017-01-09 13:00:00,739,452,353,99,45,54,2017-01-09 13:00:00,739,216,308,161,469,685,2017-01-09 13:00:00,739,239145,238608
"5309",17750,2017-01-09 14:00:00,739,628,486,142,60,82,2017-01-09 14:00:00,739,370,618,314,932,1302,2017-01-09 14:00:00,739,274467,273762
"5310",17751,2017-01-09 15:00:00,739,716,543,173,69,104,2017-01-09 15:00:00,739,495,803,364,1167,1662,2017-01-09 15:00:00,739,265928,265114
"5311",17752,2017-01-09 16:00:00,739,858,660,198,73,125,2017-01-09 16:00:00,739,566,909,407,1316,1882,2017-01-09 16:00:00,739,253104,252312
"5312",17753,2017-01-09 17:00:00,739,902,665,237,90,147,2017-01-09 17:00:00,739,684,1004,482,1486,2170,2017-01-09 17:00:00,739,225668,224837
"5313",17754,2017-01-09 18:00:00,739,986,660,326,123,203,2017-01-09 18:00:00,739,744,1096,474,1570,2314,2017-01-09 18:00:00,739,215843,215018
"5314",17755,2017-01-09 19:00:00,739,965,708,257,95,162,2017-01-09 19:00:00,739,768,1188,481,1669,2437,2017-01-09 19:00:00,739,209242,208458
"5315",17756,2017-01-09 20:00:00,739,1056,751,305,123,182,2017-01-09 20:00:00,739,768,1426,559,1985,2753,2017-01-09 20:00:00,739,196347,195608
"5316",17757,2017-01-09 21:00:00,739,1124,770,354,150,204,2017-01-09 21:00:00,739,740,1668,658,2326,3066,2017-01-09 21:00:00,739,179332,178691
"5317",17758,2017-01-09 22:00:00,739,1088,698,390,150,240,2017-01-09 22:00:00,739,671,1825,753,2578,3249,2017-01-09 22:00:00,739,145833,145259
"5318",17759,2017-01-09 23:00:00,739,1039,628,411,138,273,2017-01-09 23:00:00,739,539,1744,676,2420,2959,2017-01-09 23:00:00,739,118747,118270
"5319",17760,2017-01-10 00:00:00,740,1008,638,370,132,237,2017-01-10 00:00:00,740,474,1767,668,2435,2909,2017-01-10 00:00:00,740,113196,112751
"5320",17761,2017-01-10 01:00:00,740,960,589,371,139,232,2017-01-10 01:00:00,740,429,1376,509,1885,2314,2017-01-10 01:00:00,740,107507,107056
"5321",17762,2017-01-10 02:00:00,740,873,568,305,116,189,2017-01-10 02:00:00,740,368,1121,421,1542,1910,2017-01-10 02:00:00,740,101432,101003
"5322",17763,2017-01-10 03:00:00,740,862,565,297,119,178,2017-01-10 03:00:00,740,247,905,332,1237,1484,2017-01-10 03:00:00,740,95333,94912
"5323",17764,2017-01-10 04:00:00,740,632,422,210,74,136,2017-01-10 04:00:00,740,197,561,226,787,984,2017-01-10 04:00:00,740,88247,87877
"5324",17765,2017-01-10 05:00:00,740,546,323,223,76,147,2017-01-10 05:00:00,740,108,318,112,430,538,2017-01-10 05:00:00,740,81780,81413
"5325",17766,2017-01-10 06:00:00,740,467,292,175,71,104,2017-01-10 06:00:00,740,86,193,64,257,343,2017-01-10 06:00:00,740,84452,84084
"5326",17767,2017-01-10 07:00:00,740,343,248,95,31,64,2017-01-10 07:00:00,740,41,80,33,113,154,2017-01-10 07:00:00,740,85928,85536
"5327",17768,2017-01-10 08:00:00,740,333,253,80,48,32,2017-01-10 08:00:00,740,38,32,12,44,82,2017-01-10 08:00:00,740,87914,87526
"5328",17769,2017-01-10 09:00:00,740,277,217,60,33,27,2017-01-10 09:00:00,740,46,45,13,58,104,2017-01-10 09:00:00,740,90020,89608
"5329",17770,2017-01-10 10:00:00,740,248,195,53,15,38,2017-01-10 10:00:00,740,39,32,13,45,84,2017-01-10 10:00:00,740,90748,90322
"5330",17771,2017-01-10 11:00:00,740,248,197,51,23,28,2017-01-10 11:00:00,740,66,52,20,72,138,2017-01-10 11:00:00,740,97633,97213
"5331",17772,2017-01-10 12:00:00,740,298,223,75,28,47,2017-01-10 12:00:00,740,86,118,63,181,267,2017-01-10 12:00:00,740,130780,130315
"5332",17773,2017-01-10 13:00:00,740,427,334,93,54,39,2017-01-10 13:00:00,740,218,271,132,403,621,2017-01-10 13:00:00,740,184599,184037
"5333",17774,2017-01-10 14:00:00,740,586,465,121,48,73,2017-01-10 14:00:00,740,364,577,276,853,1217,2017-01-10 14:00:00,740,215932,215163
"5334",17775,2017-01-10 15:00:00,740,723,539,184,72,112,2017-01-10 15:00:00,740,491,673,300,973,1464,2017-01-10 15:00:00,740,220734,219865
"5335",17776,2017-01-10 16:00:00,740,843,641,202,82,120,2017-01-10 16:00:00,740,551,780,377,1157,1708,2017-01-10 16:00:00,740,214889,214048
"5336",17777,2017-01-10 17:00:00,740,825,631,194,71,123,2017-01-10 17:00:00,740,684,895,397,1292,1976,2017-01-10 17:00:00,740,197482,196664
"5337",17778,2017-01-10 18:00:00,740,926,670,256,91,165,2017-01-10 18:00:00,740,673,964,420,1384,2057,2017-01-10 18:00:00,740,190251,189430
"5338",17779,2017-01-10 19:00:00,740,984,717,267,105,162,2017-01-10 19:00:00,740,695,1055,453,1508,2203,2017-01-10 19:00:00,740,188952,188111
"5339",17780,2017-01-10 20:00:00,740,982,682,300,95,205,2017-01-10 20:00:00,740,705,1274,539,1813,2518,2017-01-10 20:00:00,740,180401,179603
"5340",17781,2017-01-10 21:00:00,740,1012,686,326,140,186,2017-01-10 21:00:00,740,671,1457,589,2046,2717,2017-01-10 21:00:00,740,165627,164915
"5341",17782,2017-01-10 22:00:00,740,1055,669,386,146,240,2017-01-10 22:00:00,740,604,1536,599,2135,2739,2017-01-10 22:00:00,740,140800,140220
"5342",17783,2017-01-10 23:00:00,740,994,649,345,114,231,2017-01-10 23:00:00,740,503,1615,620,2235,2738,2017-01-10 23:00:00,740,118993,118489
"5343",17784,2017-01-11 00:00:00,741,1022,653,369,140,229,2017-01-11 00:00:00,741,463,1657,621,2278,2741,2017-01-11 00:00:00,741,113222,112719
"5344",17785,2017-01-11 01:00:00,741,963,595,368,122,246,2017-01-11 01:00:00,741,376,1306,500,1806,2182,2017-01-11 01:00:00,741,110069,109585
"5345",17786,2017-01-11 02:00:00,741,898,532,366,136,230,2017-01-11 02:00:00,741,308,1036,387,1423,1731,2017-01-11 02:00:00,741,102667,102162
"5346",17787,2017-01-11 03:00:00,741,775,479,296,106,190,2017-01-11 03:00:00,741,268,772,279,1051,1319,2017-01-11 03:00:00,741,99961,99527
"5347",17788,2017-01-11 04:00:00,741,658,442,216,70,146,2017-01-11 04:00:00,741,209,561,209,770,979,2017-01-11 04:00:00,741,94599,94206
"5348",17789,2017-01-11 05:00:00,741,521,309,212,70,142,2017-01-11 05:00:00,741,110,323,119,442,552,2017-01-11 05:00:00,741,88986,88634
"5349",17790,2017-01-11 06:00:00,741,413,298,115,41,74,2017-01-11 06:00:00,741,73,151,68,219,292,2017-01-11 06:00:00,741,88531,88126
"5350",17791,2017-01-11 07:00:00,741,332,232,100,34,66,2017-01-11 07:00:00,741,58,64,35,99,157,2017-01-11 07:00:00,741,89788,89378
"5351",17792,2017-01-11 08:00:00,741,273,193,80,38,42,2017-01-11 08:00:00,741,42,42,12,54,96,2017-01-11 08:00:00,741,94234,93792
"5352",17793,2017-01-11 09:00:00,741,256,179,77,32,45,2017-01-11 09:00:00,741,25,23,11,34,59,2017-01-11 09:00:00,741,95429,95002
"5353",17794,2017-01-11 10:00:00,741,285,202,83,30,53,2017-01-11 10:00:00,741,24,29,11,40,64,2017-01-11 10:00:00,741,94151,93740
"5354",17795,2017-01-11 11:00:00,741,261,194,67,31,36,2017-01-11 11:00:00,741,42,62,35,97,139,2017-01-11 11:00:00,741,100706,100249
"5355",17796,2017-01-11 12:00:00,741,306,220,86,43,43,2017-01-11 12:00:00,741,99,115,53,168,267,2017-01-11 12:00:00,741,124670,124196
"5356",17797,2017-01-11 13:00:00,741,437,321,116,54,62,2017-01-11 13:00:00,741,228,258,137,395,623,2017-01-11 13:00:00,741,166153,165569
"5357",17798,2017-01-11 14:00:00,741,619,482,137,56,81,2017-01-11 14:00:00,741,368,485,248,733,1101,2017-01-11 14:00:00,741,199961,199156
"5358",17799,2017-01-11 15:00:00,741,660,513,147,56,91,2017-01-11 15:00:00,741,485,598,248,846,1331,2017-01-11 15:00:00,741,207151,206329
"5359",17800,2017-01-11 16:00:00,741,775,607,168,63,105,2017-01-11 16:00:00,741,533,746,348,1094,1627,2017-01-11 16:00:00,741,203233,202329
"5360",17801,2017-01-11 17:00:00,741,842,632,210,93,117,2017-01-11 17:00:00,741,622,852,406,1258,1880,2017-01-11 17:00:00,741,189425,188607
"5361",17802,2017-01-11 18:00:00,741,803,566,237,83,154,2017-01-11 18:00:00,741,750,840,398,1238,1988,2017-01-11 18:00:00,741,185615,184755
"5362",17803,2017-01-11 19:00:00,741,824,614,210,72,138,2017-01-11 19:00:00,741,747,979,404,1383,2130,2017-01-11 19:00:00,741,185502,184690
"5363",17804,2017-01-11 20:00:00,741,966,677,289,88,201,2017-01-11 20:00:00,741,740,1134,459,1593,2333,2017-01-11 20:00:00,741,175050,174324
"5364",17805,2017-01-11 21:00:00,741,902,617,285,108,177,2017-01-11 21:00:00,741,703,1416,549,1965,2668,2017-01-11 21:00:00,741,159756,159078
"5365",17806,2017-01-11 22:00:00,741,951,612,339,129,210,2017-01-11 22:00:00,741,630,1542,601,2143,2773,2017-01-11 22:00:00,741,142183,141603
"5366",17807,2017-01-11 23:00:00,741,922,564,358,130,228,2017-01-11 23:00:00,741,587,1656,586,2242,2829,2017-01-11 23:00:00,741,125399,124840
"5367",17808,2017-01-12 00:00:00,742,871,543,328,122,206,2017-01-12 00:00:00,742,505,1455,552,2007,2512,2017-01-12 00:00:00,742,117708,117264
"5368",17809,2017-01-12 01:00:00,742,863,563,300,110,189,2017-01-12 01:00:00,742,425,1374,515,1889,2314,2017-01-12 01:00:00,742,116660,116176
"5369",17810,2017-01-12 02:00:00,742,832,551,281,114,167,2017-01-12 02:00:00,742,401,1098,384,1482,1883,2017-01-12 02:00:00,742,110476,109977
"5370",17811,2017-01-12 03:00:00,742,827,537,290,103,187,2017-01-12 03:00:00,742,285,730,299,1029,1314,2017-01-12 03:00:00,742,104232,103830
"5371",17812,2017-01-12 04:00:00,742,639,444,195,79,116,2017-01-12 04:00:00,742,205,562,215,777,982,2017-01-12 04:00:00,742,97202,96832
"5372",17813,2017-01-12 05:00:00,742,588,392,196,76,120,2017-01-12 05:00:00,742,126,345,137,482,608,2017-01-12 05:00:00,742,89719,89335
"5373",17814,2017-01-12 06:00:00,742,406,277,129,49,80,2017-01-12 06:00:00,742,101,171,52,223,324,2017-01-12 06:00:00,742,90156,89768
"5374",17815,2017-01-12 07:00:00,742,293,217,76,22,54,2017-01-12 07:00:00,742,64,88,33,121,185,2017-01-12 07:00:00,742,90794,90384
"5375",17816,2017-01-12 08:00:00,742,275,196,79,28,51,2017-01-12 08:00:00,742,49,66,24,90,139,2017-01-12 08:00:00,742,94364,93975
"5376",17817,2017-01-12 09:00:00,742,254,190,64,25,39,2017-01-12 09:00:00,742,39,38,11,49,88,2017-01-12 09:00:00,742,96406,95954
"5377",17818,2017-01-12 10:00:00,742,241,185,56,22,34,2017-01-12 10:00:00,742,37,39,19,58,95,2017-01-12 10:00:00,742,94615,94210
"5378",17819,2017-01-12 11:00:00,742,235,187,48,23,25,2017-01-12 11:00:00,742,38,52,24,76,114,2017-01-12 11:00:00,742,102184,101759
"5379",17820,2017-01-12 12:00:00,742,335,258,77,35,42,2017-01-12 12:00:00,742,98,127,60,187,285,2017-01-12 12:00:00,742,136368,135925
"5380",17821,2017-01-12 13:00:00,742,426,321,105,40,65,2017-01-12 13:00:00,742,213,252,120,372,585,2017-01-12 13:00:00,742,192415,191877
"5381",17822,2017-01-12 14:00:00,742,597,463,134,45,89,2017-01-12 14:00:00,742,384,513,243,756,1140,2017-01-12 14:00:00,742,231718,230938
"5382",17823,2017-01-12 15:00:00,742,706,550,156,68,88,2017-01-12 15:00:00,742,546,610,285,895,1441,2017-01-12 15:00:00,742,236983,236189
"5383",17824,2017-01-12 16:00:00,742,735,571,164,64,100,2017-01-12 16:00:00,742,554,690,313,1003,1557,2017-01-12 16:00:00,742,231611,230819
"5384",17848,2017-01-13 16:00:00,743,735,551,184,73,111,2017-01-13 16:00:00,743,33,36,15,51,84,2017-01-13 16:00:00,743,207967,207208
"5385",17849,2017-01-13 17:00:00,743,763,589,174,76,98,2017-01-13 17:00:00,743,625,838,374,1212,1837,2017-01-13 17:00:00,743,189420,188699
"5386",17850,2017-01-13 18:00:00,743,838,611,227,91,136,2017-01-13 18:00:00,743,665,881,406,1287,1952,2017-01-13 18:00:00,743,180437,179712
"5387",17851,2017-01-13 19:00:00,743,928,646,282,119,163,2017-01-13 19:00:00,743,759,1060,414,1474,2233,2017-01-13 19:00:00,743,174803,174086
"5388",17852,2017-01-13 20:00:00,743,869,616,253,99,154,2017-01-13 20:00:00,743,753,1215,488,1703,2456,2017-01-13 20:00:00,743,162128,161462
"5389",17853,2017-01-13 21:00:00,743,969,623,346,132,214,2017-01-13 21:00:00,743,770,1363,542,1905,2675,2017-01-13 21:00:00,743,147262,146702
"5390",17854,2017-01-13 22:00:00,743,978,624,354,104,250,2017-01-13 22:00:00,743,594,1498,603,2101,2695,2017-01-13 22:00:00,743,122678,122168
"5391",17855,2017-01-13 23:00:00,743,997,596,401,111,290,2017-01-13 23:00:00,743,483,1646,605,2251,2734,2017-01-13 23:00:00,743,101132,100697
"5392",17856,2017-01-14 00:00:00,744,912,497,415,134,281,2017-01-14 00:00:00,744,449,1524,554,2078,2527,2017-01-14 00:00:00,744,90406,90018
"5393",17857,2017-01-14 01:00:00,744,909,522,387,136,251,2017-01-14 01:00:00,744,361,1376,500,1876,2237,2017-01-14 01:00:00,744,83168,82800
"5394",17858,2017-01-14 02:00:00,744,896,524,372,106,266,2017-01-14 02:00:00,744,269,1309,413,1722,1991,2017-01-14 02:00:00,744,78347,77967
"5395",17859,2017-01-14 03:00:00,744,825,492,333,108,225,2017-01-14 03:00:00,744,223,1157,424,1581,1804,2017-01-14 03:00:00,744,75165,74849
"5396",17860,2017-01-14 04:00:00,744,674,359,315,95,220,2017-01-14 04:00:00,744,185,839,305,1144,1329,2017-01-14 04:00:00,744,69998,69695
"5397",17861,2017-01-14 05:00:00,744,660,376,284,98,186,2017-01-14 05:00:00,744,129,550,201,751,880,2017-01-14 05:00:00,744,63299,63024
"5398",17862,2017-01-14 06:00:00,744,491,267,224,72,152,2017-01-14 06:00:00,744,90,293,98,391,481,2017-01-14 06:00:00,744,59107,58870
"5399",17863,2017-01-14 07:00:00,744,402,243,159,61,98,2017-01-14 07:00:00,744,67,136,51,187,254,2017-01-14 07:00:00,744,55498,55233
"5400",17864,2017-01-14 08:00:00,744,293,191,102,33,69,2017-01-14 08:00:00,744,55,115,46,161,216,2017-01-14 08:00:00,744,53955,53697
"5401",17865,2017-01-14 09:00:00,744,277,173,104,49,55,2017-01-14 09:00:00,744,43,59,15,74,117,2017-01-14 09:00:00,744,54177,53950
"5402",17866,2017-01-14 10:00:00,744,195,157,38,14,24,2017-01-14 10:00:00,744,50,41,16,57,107,2017-01-14 10:00:00,744,55841,55601
"5403",17867,2017-01-14 11:00:00,744,268,170,98,38,60,2017-01-14 11:00:00,744,60,60,27,87,147,2017-01-14 11:00:00,744,60386,60157
"5404",17868,2017-01-14 12:00:00,744,342,233,109,42,67,2017-01-14 12:00:00,744,71,110,39,149,220,2017-01-14 12:00:00,744,69288,69010
"5405",17869,2017-01-14 13:00:00,744,425,289,136,48,88,2017-01-14 13:00:00,744,125,299,126,425,550,2017-01-14 13:00:00,744,82228,81895
"5406",17870,2017-01-14 14:00:00,744,655,417,238,84,154,2017-01-14 14:00:00,744,264,600,260,860,1124,2017-01-14 14:00:00,744,94548,94163
"5407",17871,2017-01-14 15:00:00,744,772,464,308,110,198,2017-01-14 15:00:00,744,364,1068,426,1494,1858,2017-01-14 15:00:00,744,103128,102707
"5408",17872,2017-01-14 16:00:00,744,922,591,331,136,195,2017-01-14 16:00:00,744,440,1202,462,1664,2104,2017-01-14 16:00:00,744,107740,107241
"5409",17873,2017-01-14 17:00:00,744,986,584,402,147,255,2017-01-14 17:00:00,744,471,1330,539,1869,2340,2017-01-14 17:00:00,744,107205,106724
"5410",17874,2017-01-14 18:00:00,744,1056,614,442,154,288,2017-01-14 18:00:00,744,531,1533,601,2134,2665,2017-01-14 18:00:00,744,104738,104225
"5411",17875,2017-01-14 19:00:00,744,1057,649,408,137,271,2017-01-14 19:00:00,744,525,1650,617,2267,2792,2017-01-14 19:00:00,744,101550,101098
"5412",17876,2017-01-14 20:00:00,744,1066,624,442,176,266,2017-01-14 20:00:00,744,543,1649,604,2253,2796,2017-01-14 20:00:00,744,97840,97367
"5413",17877,2017-01-14 21:00:00,744,1088,621,467,165,302,2017-01-14 21:00:00,744,477,1584,616,2200,2677,2017-01-14 21:00:00,744,91394,90994
"5414",17878,2017-01-14 22:00:00,744,1092,610,482,174,308,2017-01-14 22:00:00,744,492,1458,555,2013,2505,2017-01-14 22:00:00,744,85418,85035
"5415",17879,2017-01-14 23:00:00,744,1067,577,490,188,302,2017-01-14 23:00:00,744,370,1442,509,1951,2321,2017-01-14 23:00:00,744,80202,79832
"5416",17880,2017-01-15 00:00:00,745,1051,558,493,194,299,2017-01-15 00:00:00,745,377,1278,433,1711,2088,2017-01-15 00:00:00,745,77328,76983
"5417",17881,2017-01-15 01:00:00,745,1029,545,484,182,302,2017-01-15 01:00:00,745,259,1246,458,1704,1963,2017-01-15 01:00:00,745,75036,74689
"5418",17882,2017-01-15 02:00:00,745,826,459,367,84,283,2017-01-15 02:00:00,745,300,1043,395,1438,1738,2017-01-15 02:00:00,745,73790,73458
"5419",17883,2017-01-15 03:00:00,745,848,462,386,95,291,2017-01-15 03:00:00,745,203,899,281,1180,1383,2017-01-15 03:00:00,745,74290,73983
"5420",17884,2017-01-15 04:00:00,745,777,431,346,107,239,2017-01-15 04:00:00,745,171,643,233,876,1047,2017-01-15 04:00:00,745,74105,73824
"5421",17885,2017-01-15 05:00:00,745,761,411,350,148,202,2017-01-15 05:00:00,745,131,462,153,615,746,2017-01-15 05:00:00,745,68662,68378
"5422",17886,2017-01-15 06:00:00,745,515,276,239,96,143,2017-01-15 06:00:00,745,73,283,80,363,436,2017-01-15 06:00:00,745,64182,63896
"5423",17887,2017-01-15 07:00:00,745,426,237,189,76,113,2017-01-15 07:00:00,745,48,133,45,178,226,2017-01-15 07:00:00,745,59136,58867
"5424",17888,2017-01-15 08:00:00,745,284,178,106,37,69,2017-01-15 08:00:00,745,33,69,26,95,128,2017-01-15 08:00:00,745,57405,57146
"5425",17889,2017-01-15 09:00:00,745,253,166,87,27,60,2017-01-15 09:00:00,745,33,77,29,106,139,2017-01-15 09:00:00,745,57112,56881
"5426",17890,2017-01-15 10:00:00,745,254,182,72,28,43,2017-01-15 10:00:00,745,29,33,16,49,78,2017-01-15 10:00:00,745,60650,60401
"5427",17891,2017-01-15 11:00:00,745,264,181,83,38,45,2017-01-15 11:00:00,745,29,50,11,61,90,2017-01-15 11:00:00,745,63146,62881
"5428",17892,2017-01-15 12:00:00,745,341,222,119,46,73,2017-01-15 12:00:00,745,60,90,37,127,187,2017-01-15 12:00:00,745,68387,68136
"5429",17893,2017-01-15 13:00:00,745,432,290,142,57,85,2017-01-15 13:00:00,745,85,232,87,319,404,2017-01-15 13:00:00,745,77503,77182
"5430",17894,2017-01-15 14:00:00,745,548,337,211,90,121,2017-01-15 14:00:00,745,203,554,201,755,958,2017-01-15 14:00:00,745,85780,85446
"5431",17895,2017-01-15 15:00:00,745,676,388,288,119,169,2017-01-15 15:00:00,745,271,928,351,1279,1550,2017-01-15 15:00:00,745,93931,93569
"5432",17896,2017-01-15 16:00:00,745,761,448,313,128,185,2017-01-15 16:00:00,745,310,1058,429,1487,1797,2017-01-15 16:00:00,745,98723,98296
"5433",17897,2017-01-15 17:00:00,745,877,519,358,135,223,2017-01-15 17:00:00,745,389,1266,472,1738,2127,2017-01-15 17:00:00,745,100961,100538
"5434",17898,2017-01-15 18:00:00,745,1055,609,446,161,285,2017-01-15 18:00:00,745,423,1416,507,1923,2346,2017-01-15 18:00:00,745,102176,101711
"5435",17899,2017-01-15 19:00:00,745,1081,635,446,152,294,2017-01-15 19:00:00,745,435,1563,581,2144,2579,2017-01-15 19:00:00,745,101115,100636
"5436",17900,2017-01-15 20:00:00,745,1076,611,465,143,322,2017-01-15 20:00:00,745,423,1553,569,2122,2545,2017-01-15 20:00:00,745,99349,98904
"5437",17901,2017-01-15 21:00:00,745,1055,628,427,155,272,2017-01-15 21:00:00,745,427,1367,518,1885,2312,2017-01-15 21:00:00,745,93666,93257
"5438",17902,2017-01-15 22:00:00,745,983,574,409,157,252,2017-01-15 22:00:00,745,384,1322,474,1796,2180,2017-01-15 22:00:00,745,87254,86858
"5439",17903,2017-01-15 23:00:00,745,997,566,431,161,270,2017-01-15 23:00:00,745,350,1325,458,1783,2133,2017-01-15 23:00:00,745,86161,85802
"5440",17904,2017-01-16 00:00:00,746,932,553,379,127,252,2017-01-16 00:00:00,746,290,1164,386,1550,1840,2017-01-16 00:00:00,746,88969,88617
"5441",17905,2017-01-16 01:00:00,746,1083,596,487,181,306,2017-01-16 01:00:00,746,289,1270,430,1700,1989,2017-01-16 01:00:00,746,98249,97899
"5442",17906,2017-01-16 02:00:00,746,944,526,418,124,294,2017-01-16 02:00:00,746,247,1167,402,1569,1816,2017-01-16 02:00:00,746,95081,94687
"5443",17907,2017-01-16 03:00:00,746,875,512,363,101,262,2017-01-16 03:00:00,746,185,790,278,1068,1253,2017-01-16 03:00:00,746,92263,91875
"5444",17908,2017-01-16 04:00:00,746,848,469,379,133,246,2017-01-16 04:00:00,746,174,568,195,763,937,2017-01-16 04:00:00,746,90251,89878
"5445",17909,2017-01-16 05:00:00,746,696,385,311,106,205,2017-01-16 05:00:00,746,142,327,131,458,600,2017-01-16 05:00:00,746,86882,86554
"5446",17910,2017-01-16 06:00:00,746,546,310,236,99,137,2017-01-16 06:00:00,746,111,167,58,225,336,2017-01-16 06:00:00,746,89647,89312
"5447",17911,2017-01-16 07:00:00,746,377,239,138,60,78,2017-01-16 07:00:00,746,87,130,46,176,263,2017-01-16 07:00:00,746,88804,88405
"5448",17912,2017-01-16 08:00:00,746,356,213,143,50,93,2017-01-16 08:00:00,746,56,67,28,95,151,2017-01-16 08:00:00,746,90180,89750
"5449",17913,2017-01-16 09:00:00,746,301,214,87,34,53,2017-01-16 09:00:00,746,32,66,29,95,127,2017-01-16 09:00:00,746,91275,90873
"5450",17914,2017-01-16 10:00:00,746,287,209,78,25,53,2017-01-16 10:00:00,746,35,36,11,47,82,2017-01-16 10:00:00,746,91124,90714
"5451",17915,2017-01-16 11:00:00,746,283,206,77,24,53,2017-01-16 11:00:00,746,55,73,37,110,165,2017-01-16 11:00:00,746,102664,102257
"5452",17916,2017-01-16 12:00:00,746,283,210,73,33,40,2017-01-16 12:00:00,746,78,131,54,185,263,2017-01-16 12:00:00,746,148790,148364
"5453",17917,2017-01-16 13:00:00,746,500,361,139,59,80,2017-01-16 13:00:00,746,213,265,114,379,592,2017-01-16 13:00:00,746,202897,202369
"5454",17918,2017-01-16 14:00:00,746,636,477,159,72,87,2017-01-16 14:00:00,746,359,714,295,1009,1368,2017-01-16 14:00:00,746,214753,214158
"5455",17919,2017-01-16 15:00:00,746,812,560,252,94,158,2017-01-16 15:00:00,746,547,1046,417,1463,2010,2017-01-16 15:00:00,746,204609,203840
"5456",17920,2017-01-16 16:00:00,746,965,684,281,81,200,2017-01-16 16:00:00,746,615,1412,603,2015,2630,2017-01-16 16:00:00,746,193859,193154
"5457",17921,2017-01-16 17:00:00,746,1112,700,412,148,264,2017-01-16 17:00:00,746,699,1452,583,2035,2734,2017-01-16 17:00:00,746,174023,173294
"5458",17922,2017-01-16 18:00:00,746,1194,755,439,153,286,2017-01-16 18:00:00,746,738,1652,667,2319,3057,2017-01-16 18:00:00,746,164898,164221
"5459",17923,2017-01-16 19:00:00,746,1276,819,457,182,275,2017-01-16 19:00:00,746,742,1572,630,2202,2944,2017-01-16 19:00:00,746,162505,161813
"5460",17924,2017-01-16 20:00:00,746,1285,773,512,166,346,2017-01-16 20:00:00,746,742,1651,665,2316,3058,2017-01-16 20:00:00,746,155527,154874
"5461",17925,2017-01-16 21:00:00,746,1255,787,468,176,292,2017-01-16 21:00:00,746,771,1865,728,2593,3364,2017-01-16 21:00:00,746,144175,143533
"5462",17926,2017-01-16 22:00:00,746,1171,695,476,164,311,2017-01-16 22:00:00,746,658,1757,674,2431,3089,2017-01-16 22:00:00,746,125728,125177
"5463",17927,2017-01-16 23:00:00,746,1059,643,416,146,270,2017-01-16 23:00:00,746,512,1688,621,2309,2821,2017-01-16 23:00:00,746,107855,107385
"5464",17928,2017-01-17 00:00:00,747,1099,651,448,161,287,2017-01-17 00:00:00,747,448,1493,554,2047,2495,2017-01-17 00:00:00,747,104390,103931
"5465",17929,2017-01-17 01:00:00,747,967,594,373,137,236,2017-01-17 01:00:00,747,418,1331,472,1803,2221,2017-01-17 01:00:00,747,102202,101740
"5466",17930,2017-01-17 02:00:00,747,902,553,349,116,232,2017-01-17 02:00:00,747,340,968,374,1342,1682,2017-01-17 02:00:00,747,96429,95977
"5467",17931,2017-01-17 03:00:00,747,779,488,291,91,199,2017-01-17 03:00:00,747,227,726,264,990,1217,2017-01-17 03:00:00,747,91936,91500
"5468",17932,2017-01-17 04:00:00,747,613,372,241,87,154,2017-01-17 04:00:00,747,216,587,220,807,1023,2017-01-17 04:00:00,747,85314,85002
"5469",17933,2017-01-17 05:00:00,747,565,365,200,71,129,2017-01-17 05:00:00,747,138,286,105,391,529,2017-01-17 05:00:00,747,80437,80105
"5470",17934,2017-01-17 06:00:00,747,378,231,147,58,89,2017-01-17 06:00:00,747,82,169,64,233,315,2017-01-17 06:00:00,747,81126,80764
"5471",17935,2017-01-17 07:00:00,747,336,225,111,38,73,2017-01-17 07:00:00,747,51,75,30,105,156,2017-01-17 07:00:00,747,83826,83461
"5472",17936,2017-01-17 08:00:00,747,286,216,70,24,46,2017-01-17 08:00:00,747,41,51,16,67,108,2017-01-17 08:00:00,747,87306,86873
"5473",17937,2017-01-17 09:00:00,747,267,202,65,30,35,2017-01-17 09:00:00,747,33,31,14,45,78,2017-01-17 09:00:00,747,88881,88414
"5474",17938,2017-01-17 10:00:00,747,257,195,62,30,32,2017-01-17 10:00:00,747,40,33,12,45,85,2017-01-17 10:00:00,747,89553,89127
"5475",17939,2017-01-17 11:00:00,747,239,185,54,23,31,2017-01-17 11:00:00,747,59,53,19,72,131,2017-01-17 11:00:00,747,99918,99508
"5476",17940,2017-01-17 12:00:00,747,300,230,70,26,44,2017-01-17 12:00:00,747,92,93,52,145,237,2017-01-17 12:00:00,747,146618,146169
"5477",17941,2017-01-17 13:00:00,747,455,354,101,40,61,2017-01-17 13:00:00,747,237,292,150,442,679,2017-01-17 13:00:00,747,221428,220846
"5478",17942,2017-01-17 14:00:00,747,550,441,109,49,60,2017-01-17 14:00:00,747,346,536,252,788,1134,2017-01-17 14:00:00,747,250821,250100
"5479",17943,2017-01-17 15:00:00,747,673,532,141,52,89,2017-01-17 15:00:00,747,461,679,316,995,1456,2017-01-17 15:00:00,747,244472,243725
"5480",17944,2017-01-17 16:00:00,747,817,628,189,75,114,2017-01-17 16:00:00,747,561,760,378,1138,1699,2017-01-17 16:00:00,747,233374,232520
"5481",17945,2017-01-17 17:00:00,747,817,605,212,80,132,2017-01-17 17:00:00,747,624,894,416,1310,1934,2017-01-17 17:00:00,747,206667,205927
"5482",17946,2017-01-17 18:00:00,747,872,641,231,85,146,2017-01-17 18:00:00,747,738,905,394,1299,2037,2017-01-17 18:00:00,747,197048,196318
"5483",17947,2017-01-17 19:00:00,747,983,720,263,108,155,2017-01-17 19:00:00,747,686,972,417,1389,2075,2017-01-17 19:00:00,747,192028,191281
"5484",17948,2017-01-17 20:00:00,747,936,690,246,85,161,2017-01-17 20:00:00,747,700,1191,509,1700,2400,2017-01-17 20:00:00,747,180213,179514
"5485",17949,2017-01-17 21:00:00,747,958,661,297,113,184,2017-01-17 21:00:00,747,666,1435,594,2029,2695,2017-01-17 21:00:00,747,162149,161511
"5486",17950,2017-01-17 22:00:00,747,964,626,338,118,220,2017-01-17 22:00:00,747,626,1505,622,2127,2753,2017-01-17 22:00:00,747,136671,136186
"5487",17951,2017-01-17 23:00:00,747,913,584,329,126,203,2017-01-17 23:00:00,747,573,1518,594,2112,2685,2017-01-17 23:00:00,747,113914,113448
"5488",17952,2017-01-18 00:00:00,748,978,600,378,135,243,2017-01-18 00:00:00,748,442,1404,552,1956,2398,2017-01-18 00:00:00,748,106218,105791
"5489",17953,2017-01-18 01:00:00,748,977,579,398,120,278,2017-01-18 01:00:00,748,398,1303,503,1806,2204,2017-01-18 01:00:00,748,102126,101723
"5490",17954,2017-01-18 02:00:00,748,831,548,283,93,190,2017-01-18 02:00:00,748,288,1038,406,1444,1732,2017-01-18 02:00:00,748,97258,96835
"5491",17955,2017-01-18 03:00:00,748,755,486,269,95,174,2017-01-18 03:00:00,748,272,729,269,998,1270,2017-01-18 03:00:00,748,92487,92109
"5492",17956,2017-01-18 04:00:00,748,616,398,218,93,125,2017-01-18 04:00:00,748,171,487,183,670,841,2017-01-18 04:00:00,748,86748,86394
"5493",17957,2017-01-18 05:00:00,748,572,359,213,84,129,2017-01-18 05:00:00,748,86,271,100,371,457,2017-01-18 05:00:00,748,80118,79792
"5494",17958,2017-01-18 06:00:00,748,329,203,126,40,86,2017-01-18 06:00:00,748,73,135,51,186,259,2017-01-18 06:00:00,748,80498,80136
"5495",17959,2017-01-18 07:00:00,748,253,194,59,19,40,2017-01-18 07:00:00,748,60,78,29,107,167,2017-01-18 07:00:00,748,82338,81950
"5496",17960,2017-01-18 08:00:00,748,264,193,71,25,46,2017-01-18 08:00:00,748,31,50,16,66,97,2017-01-18 08:00:00,748,84471,84080
"5497",17961,2017-01-18 09:00:00,748,224,179,45,20,25,2017-01-18 09:00:00,748,23,31,20,51,74,2017-01-18 09:00:00,748,87050,86617
"5498",17962,2017-01-18 10:00:00,748,208,159,49,19,30,2017-01-18 10:00:00,748,34,31,16,47,81,2017-01-18 10:00:00,748,86142,85776
"5499",17963,2017-01-18 11:00:00,748,229,174,55,26,29,2017-01-18 11:00:00,748,49,48,26,74,123,2017-01-18 11:00:00,748,90848,90435
"5500",17964,2017-01-18 12:00:00,748,277,209,68,32,36,2017-01-18 12:00:00,748,81,141,71,212,293,2017-01-18 12:00:00,748,113587,113150
"5501",17965,2017-01-18 13:00:00,748,405,312,93,38,55,2017-01-18 13:00:00,748,200,280,139,419,619,2017-01-18 13:00:00,748,155639,155089
"5502",17966,2017-01-18 14:00:00,748,555,452,103,47,56,2017-01-18 14:00:00,748,340,530,264,794,1134,2017-01-18 14:00:00,748,187189,186534
"5503",17967,2017-01-18 15:00:00,748,599,474,125,53,72,2017-01-18 15:00:00,748,486,572,283,855,1341,2017-01-18 15:00:00,748,197990,197245
"5504",17968,2017-01-18 16:00:00,748,718,573,145,55,90,2017-01-18 16:00:00,748,539,770,371,1141,1680,2017-01-18 16:00:00,748,196400,195580
"5505",17969,2017-01-18 17:00:00,748,819,634,185,75,110,2017-01-18 17:00:00,748,588,885,437,1322,1910,2017-01-18 17:00:00,748,182129,181422
"5506",17970,2017-01-18 18:00:00,748,844,638,206,70,136,2017-01-18 18:00:00,748,679,826,370,1196,1875,2017-01-18 18:00:00,748,178763,178025
"5507",17971,2017-01-18 19:00:00,748,890,656,234,90,144,2017-01-18 19:00:00,748,633,930,399,1329,1962,2017-01-18 19:00:00,748,177751,177027
"5508",17972,2017-01-18 20:00:00,748,886,647,239,94,145,2017-01-18 20:00:00,748,592,1151,447,1598,2190,2017-01-18 20:00:00,748,166823,166116
"5509",17973,2017-01-18 21:00:00,748,935,672,263,82,181,2017-01-18 21:00:00,748,617,1332,518,1850,2467,2017-01-18 21:00:00,748,153037,152396
"5510",17974,2017-01-18 22:00:00,748,959,665,294,102,192,2017-01-18 22:00:00,748,642,1418,537,1955,2597,2017-01-18 22:00:00,748,131955,131360
"5511",17975,2017-01-18 23:00:00,748,938,622,316,140,176,2017-01-18 23:00:00,748,533,1541,597,2138,2671,2017-01-18 23:00:00,748,113161,112675
"5512",17976,2017-01-19 00:00:00,749,957,618,339,122,217,2017-01-19 00:00:00,749,455,1466,561,2027,2482,2017-01-19 00:00:00,749,105856,105436
"5513",17977,2017-01-19 01:00:00,749,917,577,340,128,212,2017-01-19 01:00:00,749,396,1184,440,1624,2020,2017-01-19 01:00:00,749,103448,103058
"5514",17978,2017-01-19 02:00:00,749,807,521,286,103,183,2017-01-19 02:00:00,749,340,958,364,1322,1662,2017-01-19 02:00:00,749,98141,97728
"5515",17979,2017-01-19 03:00:00,749,732,458,274,103,171,2017-01-19 03:00:00,749,252,692,252,944,1196,2017-01-19 03:00:00,749,93273,92882
"5516",17980,2017-01-19 04:00:00,749,584,383,201,84,117,2017-01-19 04:00:00,749,206,479,173,652,858,2017-01-19 04:00:00,749,87363,87025
"5517",17981,2017-01-19 05:00:00,749,532,350,182,59,123,2017-01-19 05:00:00,749,142,370,138,508,650,2017-01-19 05:00:00,749,82948,82624
"5518",17982,2017-01-19 06:00:00,749,386,256,130,56,74,2017-01-19 06:00:00,749,80,133,54,187,267,2017-01-19 06:00:00,749,82944,82589
"5519",17983,2017-01-19 07:00:00,749,310,216,94,37,57,2017-01-19 07:00:00,749,60,89,32,121,181,2017-01-19 07:00:00,749,84208,83867
"5520",17984,2017-01-19 08:00:00,749,281,193,88,26,62,2017-01-19 08:00:00,749,32,60,28,88,120,2017-01-19 08:00:00,749,85831,85455
"5521",17985,2017-01-19 09:00:00,749,243,191,52,20,32,2017-01-19 09:00:00,749,49,27,10,37,86,2017-01-19 09:00:00,749,87946,87526
"5522",17986,2017-01-19 10:00:00,749,243,187,56,21,35,2017-01-19 10:00:00,749,31,30,16,46,77,2017-01-19 10:00:00,749,86951,86565
"5523",17987,2017-01-19 11:00:00,749,217,173,44,19,25,2017-01-19 11:00:00,749,55,54,20,74,129,2017-01-19 11:00:00,749,93099,92736
"5524",17988,2017-01-19 12:00:00,749,281,212,69,33,36,2017-01-19 12:00:00,749,74,114,55,169,243,2017-01-19 12:00:00,749,126205,125792
"5525",17989,2017-01-19 13:00:00,749,438,331,107,45,62,2017-01-19 13:00:00,749,198,289,156,445,643,2017-01-19 13:00:00,749,179386,178848
"5526",17990,2017-01-19 14:00:00,749,531,424,107,43,64,2017-01-19 14:00:00,749,340,514,243,757,1097,2017-01-19 14:00:00,749,210310,209644
"5527",17991,2017-01-19 15:00:00,749,617,507,110,44,66,2017-01-19 15:00:00,749,454,570,268,838,1292,2017-01-19 15:00:00,749,213092,212382
"5528",17992,2017-01-19 16:00:00,749,718,566,152,52,100,2017-01-19 16:00:00,749,524,728,318,1046,1570,2017-01-19 16:00:00,749,210298,209568
"5529",17993,2017-01-19 17:00:00,749,804,648,156,54,102,2017-01-19 17:00:00,749,589,800,360,1160,1749,2017-01-19 17:00:00,749,192418,191718
"5530",17994,2017-01-19 18:00:00,749,847,636,211,80,131,2017-01-19 18:00:00,749,636,811,335,1146,1782,2017-01-19 18:00:00,749,188268,187545
"5531",17995,2017-01-19 19:00:00,749,850,633,217,91,126,2017-01-19 19:00:00,749,686,846,377,1223,1909,2017-01-19 19:00:00,749,185100,184411
"5532",17996,2017-01-19 20:00:00,749,920,702,218,80,138,2017-01-19 20:00:00,749,646,1019,425,1444,2090,2017-01-19 20:00:00,749,174324,173663
"5533",17997,2017-01-19 21:00:00,749,939,648,291,109,181,2017-01-19 21:00:00,749,611,1271,500,1771,2382,2017-01-19 21:00:00,749,159499,158868
"5534",17998,2017-01-19 22:00:00,749,945,621,324,119,205,2017-01-19 22:00:00,749,541,1299,553,1852,2393,2017-01-19 22:00:00,749,133511,133020
"5535",17999,2017-01-19 23:00:00,749,698,458,240,92,148,2017-01-19 23:00:00,749,499,1502,596,2098,2597,2017-01-19 23:00:00,749,111043,110610
"5536",18000,2017-01-20 00:00:00,750,16,8,8,5,3,2017-01-20 00:00:00,750,430,1368,516,1884,2314,2017-01-20 00:00:00,750,104496,104117
"5537",18001,2017-01-20 01:00:00,750,41,24,17,4,13,2017-01-20 01:00:00,750,383,1132,430,1562,1945,2017-01-20 01:00:00,750,101748,101351
"5538",18002,2017-01-20 02:00:00,750,853,528,325,108,217,2017-01-20 02:00:00,750,341,952,342,1294,1635,2017-01-20 02:00:00,750,94270,93854
"5539",18003,2017-01-20 03:00:00,750,657,446,211,72,139,2017-01-20 03:00:00,750,233,767,285,1052,1285,2017-01-20 03:00:00,750,88246,87871
"5540",18004,2017-01-20 04:00:00,750,555,330,225,83,142,2017-01-20 04:00:00,750,201,576,196,772,973,2017-01-20 04:00:00,750,81684,81376
"5541",18005,2017-01-20 05:00:00,750,464,299,165,61,104,2017-01-20 05:00:00,750,115,314,111,425,540,2017-01-20 05:00:00,750,74705,74402
"5542",18006,2017-01-20 06:00:00,750,379,229,150,43,107,2017-01-20 06:00:00,750,95,171,62,233,328,2017-01-20 06:00:00,750,75842,75536
"5543",18007,2017-01-20 07:00:00,750,281,187,94,43,51,2017-01-20 07:00:00,750,36,62,23,85,121,2017-01-20 07:00:00,750,76324,76015
"5544",18008,2017-01-20 08:00:00,750,251,174,77,25,52,2017-01-20 08:00:00,750,29,42,17,59,88,2017-01-20 08:00:00,750,77750,77406
"5545",18009,2017-01-20 09:00:00,750,227,167,60,23,37,2017-01-20 09:00:00,750,36,44,18,62,98,2017-01-20 09:00:00,750,80413,80016
"5546",18010,2017-01-20 10:00:00,750,250,199,51,19,32,2017-01-20 10:00:00,750,40,28,10,38,78,2017-01-20 10:00:00,750,80184,79805
"5547",18011,2017-01-20 11:00:00,750,220,169,51,25,26,2017-01-20 11:00:00,750,48,57,26,83,131,2017-01-20 11:00:00,750,88290,87931
"5548",18012,2017-01-20 12:00:00,750,326,247,79,37,42,2017-01-20 12:00:00,750,92,100,44,144,236,2017-01-20 12:00:00,750,123561,123187
"5549",18013,2017-01-20 13:00:00,750,381,280,101,40,61,2017-01-20 13:00:00,750,155,244,127,371,526,2017-01-20 13:00:00,750,181438,180881
"5550",18014,2017-01-20 14:00:00,750,491,394,97,35,62,2017-01-20 14:00:00,750,288,461,215,676,964,2017-01-20 14:00:00,750,210851,210183
"5551",18015,2017-01-20 15:00:00,750,600,469,131,55,76,2017-01-20 15:00:00,750,457,525,251,776,1233,2017-01-20 15:00:00,750,207795,207027
"5552",18016,2017-01-20 16:00:00,750,629,495,134,55,79,2017-01-20 16:00:00,750,457,665,315,980,1437,2017-01-20 16:00:00,750,194362,193652
"5553",18017,2017-01-20 17:00:00,750,677,522,155,59,96,2017-01-20 17:00:00,750,510,713,335,1048,1558,2017-01-20 17:00:00,750,173282,172612
"5554",18018,2017-01-20 18:00:00,750,682,493,189,57,132,2017-01-20 18:00:00,750,619,822,341,1163,1782,2017-01-20 18:00:00,750,174035,173362
"5555",18019,2017-01-20 19:00:00,750,755,523,232,78,154,2017-01-20 19:00:00,750,603,962,391,1353,1956,2017-01-20 19:00:00,750,172574,171916
"5556",18020,2017-01-20 20:00:00,750,849,584,265,91,174,2017-01-20 20:00:00,750,628,1169,488,1657,2285,2017-01-20 20:00:00,750,157936,157310
"5557",18021,2017-01-20 21:00:00,750,920,616,304,90,214,2017-01-20 21:00:00,750,586,1408,539,1947,2533,2017-01-20 21:00:00,750,139856,139275
"5558",18022,2017-01-20 22:00:00,750,923,592,331,116,215,2017-01-20 22:00:00,750,517,1441,535,1976,2493,2017-01-20 22:00:00,750,116009,115533
"5559",18023,2017-01-20 23:00:00,750,894,534,360,150,210,2017-01-20 23:00:00,750,436,1486,552,2038,2474,2017-01-20 23:00:00,750,94873,94509
"5560",18024,2017-01-21 00:00:00,751,873,565,308,110,198,2017-01-21 00:00:00,751,426,1413,470,1883,2309,2017-01-21 00:00:00,751,84983,84647
"5561",18025,2017-01-21 01:00:00,751,1018,529,489,184,305,2017-01-21 01:00:00,751,370,3551,1696,5247,5617,2017-01-21 01:00:00,751,81777,81425
"5562",18026,2017-01-21 02:00:00,751,1281,597,684,218,466,2017-01-21 02:00:00,751,294,2175,919,3094,3388,2017-01-21 02:00:00,751,77703,77354
"5563",18027,2017-01-21 03:00:00,751,943,564,379,158,221,2017-01-21 03:00:00,751,241,976,340,1316,1557,2017-01-21 03:00:00,751,72337,72026
"5564",18028,2017-01-21 04:00:00,751,662,367,295,108,187,2017-01-21 04:00:00,751,179,796,244,1040,1219,2017-01-21 04:00:00,751,69449,69170
"5565",18029,2017-01-21 05:00:00,751,644,383,261,83,178,2017-01-21 05:00:00,751,124,537,183,720,844,2017-01-21 05:00:00,751,64317,64035
"5566",18030,2017-01-21 06:00:00,751,457,268,189,60,129,2017-01-21 06:00:00,751,82,258,87,345,427,2017-01-21 06:00:00,751,59405,59148
"5567",18031,2017-01-21 07:00:00,751,339,228,111,44,67,2017-01-21 07:00:00,751,60,142,52,194,254,2017-01-21 07:00:00,751,56254,56033
"5568",18032,2017-01-21 08:00:00,751,251,173,78,19,59,2017-01-21 08:00:00,751,40,66,26,92,132,2017-01-21 08:00:00,751,54761,54512
"5569",18033,2017-01-21 09:00:00,751,229,150,79,37,42,2017-01-21 09:00:00,751,58,43,18,61,119,2017-01-21 09:00:00,751,54847,54615
"5570",18034,2017-01-21 10:00:00,751,217,164,53,14,39,2017-01-21 10:00:00,751,40,39,17,56,96,2017-01-21 10:00:00,751,55633,55393
"5571",18035,2017-01-21 11:00:00,751,281,176,105,39,66,2017-01-21 11:00:00,751,56,43,18,61,117,2017-01-21 11:00:00,751,60377,60127
"5572",18036,2017-01-21 12:00:00,751,312,199,113,41,72,2017-01-21 12:00:00,751,74,98,41,139,213,2017-01-21 12:00:00,751,68265,67959
"5573",18037,2017-01-21 13:00:00,751,437,289,148,64,84,2017-01-21 13:00:00,751,128,283,116,399,527,2017-01-21 13:00:00,751,79111,78794
"5574",18038,2017-01-21 14:00:00,751,650,392,258,81,177,2017-01-21 14:00:00,751,205,568,252,820,1025,2017-01-21 14:00:00,751,90208,89847
"5575",18039,2017-01-21 15:00:00,751,737,458,279,86,193,2017-01-21 15:00:00,751,330,978,371,1349,1679,2017-01-21 15:00:00,751,98100,97715
"5576",18040,2017-01-21 16:00:00,751,827,509,318,131,187,2017-01-21 16:00:00,751,419,1144,466,1610,2029,2017-01-21 16:00:00,751,102050,101640
"5577",18041,2017-01-21 17:00:00,751,1002,607,395,170,225,2017-01-21 17:00:00,751,473,1308,489,1797,2270,2017-01-21 17:00:00,751,100135,99653
"5578",18042,2017-01-21 18:00:00,751,1012,602,410,131,279,2017-01-21 18:00:00,751,548,1339,546,1885,2433,2017-01-21 18:00:00,751,97761,97332
"5579",18043,2017-01-21 19:00:00,751,962,564,398,129,269,2017-01-21 19:00:00,751,536,1498,549,2047,2583,2017-01-21 19:00:00,751,94046,93624
"5580",18044,2017-01-21 20:00:00,751,988,592,396,139,257,2017-01-21 20:00:00,751,567,1425,508,1933,2500,2017-01-21 20:00:00,751,90791,90366
"5581",18045,2017-01-21 21:00:00,751,986,587,399,142,257,2017-01-21 21:00:00,751,504,1449,515,1964,2468,2017-01-21 21:00:00,751,86192,85783
"5582",18046,2017-01-21 22:00:00,751,1048,586,462,136,326,2017-01-21 22:00:00,751,450,1434,468,1902,2352,2017-01-21 22:00:00,751,80139,79752
"5583",18047,2017-01-21 23:00:00,751,996,524,472,167,305,2017-01-21 23:00:00,751,340,1383,515,1898,2238,2017-01-21 23:00:00,751,74231,73894
"5584",18048,2017-01-22 00:00:00,752,984,510,474,152,322,2017-01-22 00:00:00,752,364,1227,412,1639,2003,2017-01-22 00:00:00,752,71587,71227
"5585",18049,2017-01-22 01:00:00,752,1013,524,489,170,319,2017-01-22 01:00:00,752,319,1114,387,1501,1820,2017-01-22 01:00:00,752,70603,70275
"5586",18050,2017-01-22 02:00:00,752,930,501,429,128,301,2017-01-22 02:00:00,752,320,996,356,1352,1672,2017-01-22 02:00:00,752,70091,69782
"5587",18051,2017-01-22 03:00:00,752,838,478,360,92,268,2017-01-22 03:00:00,752,215,780,299,1079,1294,2017-01-22 03:00:00,752,70405,70113
"5588",18052,2017-01-22 04:00:00,752,729,406,323,112,211,2017-01-22 04:00:00,752,162,626,205,831,993,2017-01-22 04:00:00,752,70520,70217
"5589",18053,2017-01-22 05:00:00,752,690,341,349,130,219,2017-01-22 05:00:00,752,122,381,155,536,658,2017-01-22 05:00:00,752,65164,64884
"5590",18054,2017-01-22 06:00:00,752,526,273,253,87,166,2017-01-22 06:00:00,752,95,181,59,240,335,2017-01-22 06:00:00,752,61589,61314
"5591",18055,2017-01-22 07:00:00,752,360,212,148,53,95,2017-01-22 07:00:00,752,71,142,42,184,255,2017-01-22 07:00:00,752,56865,56627
"5592",18056,2017-01-22 08:00:00,752,304,190,114,45,69,2017-01-22 08:00:00,752,58,71,22,93,151,2017-01-22 08:00:00,752,55338,55090
"5593",18057,2017-01-22 09:00:00,752,229,164,65,18,47,2017-01-22 09:00:00,752,44,37,12,49,93,2017-01-22 09:00:00,752,54784,54556
"5594",18058,2017-01-22 10:00:00,752,251,154,97,43,54,2017-01-22 10:00:00,752,33,30,11,41,74,2017-01-22 10:00:00,752,55606,55349
"5595",18059,2017-01-22 11:00:00,752,259,180,79,25,54,2017-01-22 11:00:00,752,28,27,14,41,69,2017-01-22 11:00:00,752,59359,59126
"5596",18060,2017-01-22 12:00:00,752,268,180,88,37,51,2017-01-22 12:00:00,752,48,95,46,141,189,2017-01-22 12:00:00,752,65222,64972
"5597",18061,2017-01-22 13:00:00,752,380,246,134,48,86,2017-01-22 13:00:00,752,92,202,84,286,378,2017-01-22 13:00:00,752,73733,73439
"5598",18062,2017-01-22 14:00:00,752,551,327,224,83,141,2017-01-22 14:00:00,752,173,413,149,562,735,2017-01-22 14:00:00,752,82416,82094
"5599",18063,2017-01-22 15:00:00,752,656,420,236,81,155,2017-01-22 15:00:00,752,292,798,301,1099,1391,2017-01-22 15:00:00,752,88499,88104
"5600",18064,2017-01-22 16:00:00,752,833,514,319,111,208,2017-01-22 16:00:00,752,328,1098,397,1495,1823,2017-01-22 16:00:00,752,95805,95424
"5601",18065,2017-01-22 17:00:00,752,955,605,350,124,226,2017-01-22 17:00:00,752,375,1179,449,1628,2003,2017-01-22 17:00:00,752,97231,96803
"5602",18066,2017-01-22 18:00:00,752,945,585,360,134,226,2017-01-22 18:00:00,752,408,1241,452,1693,2101,2017-01-22 18:00:00,752,96765,96333
"5603",18067,2017-01-22 19:00:00,752,1042,625,417,166,251,2017-01-22 19:00:00,752,370,1303,480,1783,2153,2017-01-22 19:00:00,752,97235,96800
"5604",18068,2017-01-22 20:00:00,752,1014,619,395,139,256,2017-01-22 20:00:00,752,397,1290,492,1782,2179,2017-01-22 20:00:00,752,93474,93050
"5605",18069,2017-01-22 21:00:00,752,974,563,411,158,253,2017-01-22 21:00:00,752,371,1386,527,1913,2284,2017-01-22 21:00:00,752,91707,91276
"5606",18070,2017-01-22 22:00:00,752,987,614,373,115,257,2017-01-22 22:00:00,752,446,1269,455,1724,2170,2017-01-22 22:00:00,752,87326,86944
"5607",18071,2017-01-22 23:00:00,752,965,602,363,123,240,2017-01-22 23:00:00,752,348,1198,426,1624,1972,2017-01-22 23:00:00,752,84851,84475
"5608",18072,2017-01-23 00:00:00,753,934,545,389,147,242,2017-01-23 00:00:00,753,286,1187,414,1601,1887,2017-01-23 00:00:00,753,89913,89529
"5609",18073,2017-01-23 01:00:00,753,933,520,413,118,295,2017-01-23 01:00:00,753,253,1019,375,1394,1647,2017-01-23 01:00:00,753,96559,96170
"5610",18074,2017-01-23 02:00:00,753,965,535,430,167,263,2017-01-23 02:00:00,753,248,797,277,1074,1322,2017-01-23 02:00:00,753,91891,91505
"5611",18075,2017-01-23 03:00:00,753,881,516,365,141,224,2017-01-23 03:00:00,753,196,563,204,767,963,2017-01-23 03:00:00,753,88860,88479
"5612",18076,2017-01-23 04:00:00,753,665,375,290,101,189,2017-01-23 04:00:00,753,134,313,113,426,560,2017-01-23 04:00:00,753,86865,86518
"5613",18077,2017-01-23 05:00:00,753,524,325,199,70,129,2017-01-23 05:00:00,753,94,191,84,275,369,2017-01-23 05:00:00,753,82256,81939
"5614",18078,2017-01-23 06:00:00,753,347,221,126,49,77,2017-01-23 06:00:00,753,59,116,49,165,224,2017-01-23 06:00:00,753,82945,82591
"5615",18079,2017-01-23 07:00:00,753,356,211,145,75,70,2017-01-23 07:00:00,753,40,54,21,75,115,2017-01-23 07:00:00,753,84295,83928
"5616",18080,2017-01-23 08:00:00,753,250,182,68,32,36,2017-01-23 08:00:00,753,34,41,14,55,89,2017-01-23 08:00:00,753,84935,84551
"5617",18081,2017-01-23 09:00:00,753,275,207,68,29,39,2017-01-23 09:00:00,753,36,36,23,59,95,2017-01-23 09:00:00,753,88147,87769
"5618",18082,2017-01-23 10:00:00,753,292,211,81,48,33,2017-01-23 10:00:00,753,34,25,11,36,70,2017-01-23 10:00:00,753,90381,89985
"5619",18083,2017-01-23 11:00:00,753,301,232,69,29,40,2017-01-23 11:00:00,753,46,45,28,73,119,2017-01-23 11:00:00,753,106606,106198
"5620",18084,2017-01-23 12:00:00,753,312,241,71,32,39,2017-01-23 12:00:00,753,108,108,58,166,274,2017-01-23 12:00:00,753,165522,165127
"5621",18085,2017-01-23 13:00:00,753,388,302,86,31,54,2017-01-23 13:00:00,753,187,337,188,525,712,2017-01-23 13:00:00,753,250770,250250
"5622",18086,2017-01-23 14:00:00,753,601,486,115,52,63,2017-01-23 14:00:00,753,341,543,262,805,1146,2017-01-23 14:00:00,753,277923,277226
"5623",18087,2017-01-23 15:00:00,753,717,562,155,57,98,2017-01-23 15:00:00,753,500,676,346,1022,1522,2017-01-23 15:00:00,753,259985,259204
"5624",18088,2017-01-23 16:00:00,753,768,600,168,71,97,2017-01-23 16:00:00,753,610,809,370,1179,1789,2017-01-23 16:00:00,753,246913,246154
"5625",18089,2017-01-23 17:00:00,753,862,661,201,77,124,2017-01-23 17:00:00,753,683,954,430,1384,2067,2017-01-23 17:00:00,753,218700,217987
"5626",18090,2017-01-23 18:00:00,753,928,710,218,81,137,2017-01-23 18:00:00,753,794,993,445,1438,2232,2017-01-23 18:00:00,753,206676,205921
"5627",18091,2017-01-23 19:00:00,753,911,670,241,87,154,2017-01-23 19:00:00,753,754,1080,463,1543,2297,2017-01-23 19:00:00,753,200038,199301
"5628",18092,2017-01-23 20:00:00,753,899,634,265,109,156,2017-01-23 20:00:00,753,721,1259,532,1791,2512,2017-01-23 20:00:00,753,187636,186942
"5629",18093,2017-01-23 21:00:00,753,1014,698,316,135,181,2017-01-23 21:00:00,753,761,1498,613,2111,2872,2017-01-23 21:00:00,753,170513,169840
"5630",18094,2017-01-23 22:00:00,753,1036,682,354,156,198,2017-01-23 22:00:00,753,674,1610,619,2229,2903,2017-01-23 22:00:00,753,141128,140610
"5631",18095,2017-01-23 23:00:00,753,1065,691,374,160,214,2017-01-23 23:00:00,753,607,1597,607,2204,2811,2017-01-23 23:00:00,753,115341,114908
"5632",18096,2017-01-24 00:00:00,754,1045,621,424,177,247,2017-01-24 00:00:00,754,532,1454,524,1978,2510,2017-01-24 00:00:00,754,106460,106021
"5633",18097,2017-01-24 01:00:00,754,952,591,361,110,251,2017-01-24 01:00:00,754,444,1320,508,1828,2272,2017-01-24 01:00:00,754,102168,101724
"5634",18098,2017-01-24 02:00:00,754,891,578,313,99,214,2017-01-24 02:00:00,754,364,989,392,1381,1745,2017-01-24 02:00:00,754,94930,94516
"5635",18099,2017-01-24 03:00:00,754,833,553,280,115,165,2017-01-24 03:00:00,754,261,738,263,1001,1262,2017-01-24 03:00:00,754,90057,89652
"5636",18100,2017-01-24 04:00:00,754,665,444,221,84,137,2017-01-24 04:00:00,754,180,497,175,672,852,2017-01-24 04:00:00,754,83979,83647
"5637",18101,2017-01-24 05:00:00,754,534,325,209,97,112,2017-01-24 05:00:00,754,124,300,100,400,524,2017-01-24 05:00:00,754,78200,77864
"5638",18102,2017-01-24 06:00:00,754,343,229,114,51,63,2017-01-24 06:00:00,754,74,150,51,201,275,2017-01-24 06:00:00,754,78268,77940
"5639",18103,2017-01-24 07:00:00,754,284,194,90,39,50,2017-01-24 07:00:00,754,78,85,37,122,200,2017-01-24 07:00:00,754,78769,78430
"5640",18104,2017-01-24 08:00:00,754,253,194,59,35,24,2017-01-24 08:00:00,754,61,43,18,61,122,2017-01-24 08:00:00,754,80564,80207
"5641",18105,2017-01-24 09:00:00,754,236,182,54,22,32,2017-01-24 09:00:00,754,21,28,11,39,60,2017-01-24 09:00:00,754,83572,83188
"5642",18106,2017-01-24 10:00:00,754,277,213,64,26,38,2017-01-24 10:00:00,754,41,29,10,39,80,2017-01-24 10:00:00,754,84013,83621
"5643",18107,2017-01-24 11:00:00,754,291,237,54,23,31,2017-01-24 11:00:00,754,46,53,27,80,126,2017-01-24 11:00:00,754,91040,90683
"5644",18108,2017-01-24 12:00:00,754,272,205,67,22,45,2017-01-24 12:00:00,754,82,96,45,141,223,2017-01-24 12:00:00,754,120785,120410
"5645",18109,2017-01-24 13:00:00,754,449,362,87,31,56,2017-01-24 13:00:00,754,210,286,129,415,625,2017-01-24 13:00:00,754,171179,170674
"5646",18110,2017-01-24 14:00:00,754,584,473,111,44,67,2017-01-24 14:00:00,754,397,549,276,825,1222,2017-01-24 14:00:00,754,200300,199610
"5647",18111,2017-01-24 15:00:00,754,727,583,144,47,97,2017-01-24 15:00:00,754,540,590,268,858,1398,2017-01-24 15:00:00,754,205042,204326
"5648",18112,2017-01-24 16:00:00,754,813,626,187,70,117,2017-01-24 16:00:00,754,597,787,368,1155,1752,2017-01-24 16:00:00,754,201789,201033
"5649",18113,2017-01-24 17:00:00,754,883,669,214,96,118,2017-01-24 17:00:00,754,661,848,401,1249,1910,2017-01-24 17:00:00,754,183905,183179
"5650",18114,2017-01-24 18:00:00,754,927,675,252,93,159,2017-01-24 18:00:00,754,676,846,368,1214,1890,2017-01-24 18:00:00,754,177877,177277
"5651",18115,2017-01-24 19:00:00,754,893,668,225,96,129,2017-01-24 19:00:00,754,740,993,413,1406,2146,2017-01-24 19:00:00,754,174934,174279
"5652",18116,2017-01-24 20:00:00,754,947,649,298,119,179,2017-01-24 20:00:00,754,719,1174,481,1655,2374,2017-01-24 20:00:00,754,165290,164588
"5653",18117,2017-01-24 21:00:00,754,999,711,288,111,177,2017-01-24 21:00:00,754,691,1372,530,1902,2593,2017-01-24 21:00:00,754,150035,149425
"5654",18118,2017-01-24 22:00:00,754,1108,736,372,130,242,2017-01-24 22:00:00,754,678,1417,541,1958,2636,2017-01-24 22:00:00,754,129085,128556
"5655",18119,2017-01-24 23:00:00,754,1078,701,377,139,238,2017-01-24 23:00:00,754,570,1472,557,2029,2599,2017-01-24 23:00:00,754,108424,108006
"5656",18120,2017-01-25 00:00:00,755,1020,641,379,117,262,2017-01-25 00:00:00,755,474,1463,549,2012,2486,2017-01-25 00:00:00,755,100497,100063
"5657",18121,2017-01-25 01:00:00,755,930,575,355,110,245,2017-01-25 01:00:00,755,420,1182,441,1623,2043,2017-01-25 01:00:00,755,95605,95231
"5658",18122,2017-01-25 02:00:00,755,892,564,328,109,219,2017-01-25 02:00:00,755,343,931,320,1251,1594,2017-01-25 02:00:00,755,90268,89856
"5659",18123,2017-01-25 03:00:00,755,768,483,285,111,174,2017-01-25 03:00:00,755,268,650,252,902,1170,2017-01-25 03:00:00,755,85200,84839
"5660",18124,2017-01-25 04:00:00,755,594,382,212,86,126,2017-01-25 04:00:00,755,199,458,172,630,829,2017-01-25 04:00:00,755,82384,82055
"5661",18125,2017-01-25 05:00:00,755,573,383,190,79,111,2017-01-25 05:00:00,755,127,302,103,405,532,2017-01-25 05:00:00,755,76940,76598
"5662",18126,2017-01-25 06:00:00,755,412,265,147,68,79,2017-01-25 06:00:00,755,91,120,44,164,255,2017-01-25 06:00:00,755,77002,76650
"5663",18127,2017-01-25 07:00:00,755,289,218,71,28,43,2017-01-25 07:00:00,755,66,69,20,89,155,2017-01-25 07:00:00,755,77293,76947
"5664",18128,2017-01-25 08:00:00,755,256,190,66,30,36,2017-01-25 08:00:00,755,53,56,29,85,138,2017-01-25 08:00:00,755,78609,78251
"5665",18129,2017-01-25 09:00:00,755,216,168,48,21,27,2017-01-25 09:00:00,755,33,20,7,27,60,2017-01-25 09:00:00,755,81022,80626
"5666",18130,2017-01-25 10:00:00,755,213,147,66,24,42,2017-01-25 10:00:00,755,37,40,20,60,97,2017-01-25 10:00:00,755,81005,80632
"5667",18131,2017-01-25 11:00:00,755,254,207,47,20,27,2017-01-25 11:00:00,755,54,44,24,68,122,2017-01-25 11:00:00,755,85856,85452
"5668",18132,2017-01-25 12:00:00,755,307,223,84,40,44,2017-01-25 12:00:00,755,83,99,64,163,246,2017-01-25 12:00:00,755,106629,106248
"5669",18133,2017-01-25 13:00:00,755,463,365,98,45,53,2017-01-25 13:00:00,755,222,264,134,398,620,2017-01-25 13:00:00,755,142671,142203
"5670",18134,2017-01-25 14:00:00,755,542,454,88,38,50,2017-01-25 14:00:00,755,369,482,242,724,1093,2017-01-25 14:00:00,755,174551,173891
"5671",18135,2017-01-25 15:00:00,755,682,552,130,42,88,2017-01-25 15:00:00,755,474,619,271,890,1364,2017-01-25 15:00:00,755,182858,182157
"5672",18136,2017-01-25 16:00:00,755,819,632,187,58,129,2017-01-25 16:00:00,755,574,618,288,906,1480,2017-01-25 16:00:00,755,183599,182855
"5673",18137,2017-01-25 17:00:00,755,828,629,199,73,126,2017-01-25 17:00:00,755,603,736,310,1046,1649,2017-01-25 17:00:00,755,170289,169569
"5674",18138,2017-01-25 18:00:00,755,874,664,210,77,133,2017-01-25 18:00:00,755,718,838,381,1219,1937,2017-01-25 18:00:00,755,166585,165870
"5675",18139,2017-01-25 19:00:00,755,921,688,233,81,151,2017-01-25 19:00:00,755,655,878,360,1238,1893,2017-01-25 19:00:00,755,166651,165939
"5676",18140,2017-01-25 20:00:00,755,948,698,250,86,164,2017-01-25 20:00:00,755,720,980,412,1392,2112,2017-01-25 20:00:00,755,157507,156845
"5677",18141,2017-01-25 21:00:00,755,1013,710,303,120,183,2017-01-25 21:00:00,755,682,1205,475,1680,2362,2017-01-25 21:00:00,755,144730,144146
"5678",18142,2017-01-25 22:00:00,755,884,593,291,96,195,2017-01-25 22:00:00,755,609,1251,506,1757,2366,2017-01-25 22:00:00,755,123611,123121
"5679",18143,2017-01-25 23:00:00,755,977,625,352,143,208,2017-01-25 23:00:00,755,546,1385,530,1915,2461,2017-01-25 23:00:00,755,104458,104005
"5680",18144,2017-01-26 00:00:00,756,907,556,351,128,223,2017-01-26 00:00:00,756,415,1168,452,1620,2035,2017-01-26 00:00:00,756,98897,98482
"5681",18145,2017-01-26 01:00:00,756,947,601,346,140,206,2017-01-26 01:00:00,756,397,1256,490,1746,2143,2017-01-26 01:00:00,756,96972,96566
"5682",18146,2017-01-26 02:00:00,756,961,566,395,156,239,2017-01-26 02:00:00,756,328,1115,445,1560,1888,2017-01-26 02:00:00,756,90919,90527
"5683",18147,2017-01-26 03:00:00,756,772,498,274,106,168,2017-01-26 03:00:00,756,262,733,300,1033,1295,2017-01-26 03:00:00,756,85128,84754
"5684",18148,2017-01-26 04:00:00,756,586,368,218,92,126,2017-01-26 04:00:00,756,173,468,165,633,806,2017-01-26 04:00:00,756,78476,78169
"5685",18149,2017-01-26 05:00:00,756,484,317,167,74,93,2017-01-26 05:00:00,756,144,294,107,401,545,2017-01-26 05:00:00,756,72022,71727
"5686",18150,2017-01-26 06:00:00,756,358,225,133,62,71,2017-01-26 06:00:00,756,100,143,56,199,299,2017-01-26 06:00:00,756,72353,72076
"5687",18151,2017-01-26 07:00:00,756,265,191,74,30,44,2017-01-26 07:00:00,756,61,71,35,106,167,2017-01-26 07:00:00,756,75604,75253
"5688",18152,2017-01-26 08:00:00,756,249,176,73,40,33,2017-01-26 08:00:00,756,62,66,28,94,156,2017-01-26 08:00:00,756,78408,78065
"5689",18153,2017-01-26 09:00:00,756,225,185,40,18,22,2017-01-26 09:00:00,756,40,30,13,43,83,2017-01-26 09:00:00,756,79367,79003
"5690",18154,2017-01-26 10:00:00,756,226,181,45,22,23,2017-01-26 10:00:00,756,35,38,18,56,91,2017-01-26 10:00:00,756,79127,78791
"5691",18155,2017-01-26 11:00:00,756,274,208,66,34,32,2017-01-26 11:00:00,756,43,60,35,95,138,2017-01-26 11:00:00,756,86657,86302
"5692",18156,2017-01-26 12:00:00,756,298,229,69,26,43,2017-01-26 12:00:00,756,95,130,59,189,284,2017-01-26 12:00:00,756,121069,120697
"5693",18157,2017-01-26 13:00:00,756,411,315,96,46,50,2017-01-26 13:00:00,756,175,289,152,441,616,2017-01-26 13:00:00,756,179543,179059
"5694",18158,2017-01-26 14:00:00,756,576,453,123,50,73,2017-01-26 14:00:00,756,316,475,226,701,1017,2017-01-26 14:00:00,756,217310,216724
"5695",18159,2017-01-26 15:00:00,756,684,549,135,55,80,2017-01-26 15:00:00,756,484,538,234,772,1256,2017-01-26 15:00:00,756,222883,222152
"5696",18160,2017-01-26 16:00:00,756,660,492,168,69,99,2017-01-26 16:00:00,756,553,750,343,1093,1646,2017-01-26 16:00:00,756,218988,218253
"5697",18161,2017-01-26 17:00:00,756,797,608,189,66,123,2017-01-26 17:00:00,756,616,767,357,1124,1740,2017-01-26 17:00:00,756,201181,200427
"5698",18162,2017-01-26 18:00:00,756,814,612,202,70,132,2017-01-26 18:00:00,756,669,914,401,1315,1984,2017-01-26 18:00:00,756,194442,193748
"5699",18163,2017-01-26 19:00:00,756,865,639,226,96,130,2017-01-26 19:00:00,756,675,953,408,1361,2036,2017-01-26 19:00:00,756,193529,192836
"5700",18164,2017-01-26 20:00:00,756,862,615,247,90,157,2017-01-26 20:00:00,756,637,1132,457,1589,2226,2017-01-26 20:00:00,756,181341,180680
"5701",18165,2017-01-26 21:00:00,756,916,621,295,117,178,2017-01-26 21:00:00,756,610,1372,552,1924,2534,2017-01-26 21:00:00,756,164434,163855
"5702",18166,2017-01-26 22:00:00,756,964,621,343,123,220,2017-01-26 22:00:00,756,600,1388,545,1933,2533,2017-01-26 22:00:00,756,135066,134562
"5703",18167,2017-01-26 23:00:00,756,931,590,341,122,219,2017-01-26 23:00:00,756,531,1355,539,1894,2425,2017-01-26 23:00:00,756,110118,109675
"5704",18168,2017-01-27 00:00:00,757,905,574,331,108,223,2017-01-27 00:00:00,757,132,3,1,4,136,2017-01-27 00:00:00,757,100304,99888
"5705",18169,2017-01-27 01:00:00,757,982,624,358,128,230,2017-01-27 01:00:00,757,269,9,4,13,282,2017-01-27 01:00:00,757,94132,93769
"5706",18170,2017-01-27 02:00:00,757,925,580,345,133,212,2017-01-27 02:00:00,757,237,5,1,6,243,2017-01-27 02:00:00,757,87117,86759
"5707",18171,2017-01-27 03:00:00,757,828,510,318,128,190,2017-01-27 03:00:00,757,180,9,1,10,190,2017-01-27 03:00:00,757,83966,83620
"5708",18172,2017-01-27 04:00:00,757,674,407,267,85,182,2017-01-27 04:00:00,757,130,8,4,12,142,2017-01-27 04:00:00,757,79856,79577
"5709",18173,2017-01-27 05:00:00,757,551,318,233,75,158,2017-01-27 05:00:00,757,57,0,0,0,57,2017-01-27 05:00:00,757,72484,72183
"5710",18174,2017-01-27 06:00:00,757,378,228,150,45,105,2017-01-27 06:00:00,757,35,1,0,1,36,2017-01-27 06:00:00,757,71413,71115
"5711",18175,2017-01-27 07:00:00,757,263,189,74,19,55,2017-01-27 07:00:00,757,48,1,0,1,49,2017-01-27 07:00:00,757,71703,71398
"5712",18176,2017-01-27 08:00:00,757,230,135,95,36,59,2017-01-27 08:00:00,757,32,0,0,0,32,2017-01-27 08:00:00,757,73415,73105
"5713",18177,2017-01-27 09:00:00,757,258,190,68,20,48,2017-01-27 09:00:00,757,12,0,0,0,12,2017-01-27 09:00:00,757,76498,76153
"5714",18178,2017-01-27 10:00:00,757,211,155,56,26,30,2017-01-27 10:00:00,757,23,0,0,0,23,2017-01-27 10:00:00,757,78229,77919
"5715",18179,2017-01-27 11:00:00,757,292,221,71,35,36,2017-01-27 11:00:00,757,29,0,0,0,29,2017-01-27 11:00:00,757,87032,86712
"5716",18180,2017-01-27 12:00:00,757,311,227,84,46,38,2017-01-27 12:00:00,757,45,0,0,0,45,2017-01-27 12:00:00,757,120861,120522
"5717",18181,2017-01-27 13:00:00,757,406,305,101,36,65,2017-01-27 13:00:00,757,57,0,0,0,57,2017-01-27 13:00:00,757,174646,174194
"5718",18182,2017-01-27 14:00:00,757,552,437,115,38,77,2017-01-27 14:00:00,757,106,2,0,2,108,2017-01-27 14:00:00,757,202605,201992
"5719",18183,2017-01-27 15:00:00,757,613,459,154,67,87,2017-01-27 15:00:00,757,137,5,3,8,145,2017-01-27 15:00:00,757,202847,202176
"5720",18184,2017-01-27 16:00:00,757,797,607,190,56,134,2017-01-27 16:00:00,757,144,7,2,9,153,2017-01-27 16:00:00,757,198225,197488
"5721",18185,2017-01-27 17:00:00,757,841,641,200,75,125,2017-01-27 17:00:00,757,185,11,8,19,204,2017-01-27 17:00:00,757,179528,178848
"5722",18186,2017-01-27 18:00:00,757,784,585,199,72,127,2017-01-27 18:00:00,757,173,6,2,8,181,2017-01-27 18:00:00,757,170280,169630
"5723",18187,2017-01-27 19:00:00,757,878,605,273,104,169,2017-01-27 19:00:00,757,194,8,3,11,205,2017-01-27 19:00:00,757,166515,165876
"5724",18188,2017-01-27 20:00:00,757,901,614,287,112,175,2017-01-27 20:00:00,757,181,10,1,11,192,2017-01-27 20:00:00,757,154818,154209
"5725",18189,2017-01-27 21:00:00,757,937,605,332,128,204,2017-01-27 21:00:00,757,180,9,4,13,193,2017-01-27 21:00:00,757,139870,139319
"5726",18190,2017-01-27 22:00:00,757,931,599,332,116,216,2017-01-27 22:00:00,757,145,11,7,18,163,2017-01-27 22:00:00,757,114041,113592
"5727",18191,2017-01-27 23:00:00,757,996,596,400,134,266,2017-01-27 23:00:00,757,128,8,1,9,137,2017-01-27 23:00:00,757,92543,92171
"5728",18192,2017-01-28 00:00:00,758,923,534,389,128,261,2017-01-28 00:00:00,758,392,1436,523,1959,2351,2017-01-28 00:00:00,758,81126,80803
"5729",18193,2017-01-28 01:00:00,758,919,518,401,134,267,2017-01-28 01:00:00,758,338,1325,466,1791,2129,2017-01-28 01:00:00,758,73286,72974
"5730",18194,2017-01-28 02:00:00,758,849,455,394,168,226,2017-01-28 02:00:00,758,253,1119,392,1511,1764,2017-01-28 02:00:00,758,68375,68054
"5731",18195,2017-01-28 03:00:00,758,758,451,307,119,188,2017-01-28 03:00:00,758,266,964,358,1322,1588,2017-01-28 03:00:00,758,65234,64965
"5732",18196,2017-01-28 04:00:00,758,711,410,301,122,179,2017-01-28 04:00:00,758,191,735,250,985,1176,2017-01-28 04:00:00,758,63023,62742
"5733",18197,2017-01-28 05:00:00,758,595,348,247,78,169,2017-01-28 05:00:00,758,138,470,152,622,760,2017-01-28 05:00:00,758,58744,58473
"5734",18198,2017-01-28 06:00:00,758,451,252,199,77,122,2017-01-28 06:00:00,758,86,249,105,354,440,2017-01-28 06:00:00,758,53731,53478
"5735",18199,2017-01-28 07:00:00,758,321,196,125,51,74,2017-01-28 07:00:00,758,53,116,51,167,220,2017-01-28 07:00:00,758,51178,50976
"5736",18200,2017-01-28 08:00:00,758,284,188,96,46,50,2017-01-28 08:00:00,758,52,87,34,121,173,2017-01-28 08:00:00,758,50331,50115
"5737",18201,2017-01-28 09:00:00,758,213,155,58,21,37,2017-01-28 09:00:00,758,28,45,20,65,93,2017-01-28 09:00:00,758,50800,50585
"5738",18202,2017-01-28 10:00:00,758,192,149,43,14,29,2017-01-28 10:00:00,758,36,31,6,37,73,2017-01-28 10:00:00,758,52122,51891
"5739",18203,2017-01-28 11:00:00,758,258,193,65,28,37,2017-01-28 11:00:00,758,39,58,27,85,124,2017-01-28 11:00:00,758,55997,55774
"5740",18204,2017-01-28 12:00:00,758,279,195,84,28,56,2017-01-28 12:00:00,758,76,120,49,169,245,2017-01-28 12:00:00,758,65258,64961
"5741",18205,2017-01-28 13:00:00,758,386,264,122,42,80,2017-01-28 13:00:00,758,119,285,122,407,526,2017-01-28 13:00:00,758,77102,76806
"5742",18206,2017-01-28 14:00:00,758,579,382,197,60,137,2017-01-28 14:00:00,758,218,657,280,937,1155,2017-01-28 14:00:00,758,87013,86693
"5743",18207,2017-01-28 15:00:00,758,743,477,266,102,163,2017-01-28 15:00:00,758,294,1037,418,1455,1749,2017-01-28 15:00:00,758,95789,95394
"5744",18208,2017-01-28 16:00:00,758,798,508,290,92,198,2017-01-28 16:00:00,758,386,1271,518,1789,2175,2017-01-28 16:00:00,758,100675,100229
"5745",18209,2017-01-28 17:00:00,758,1017,635,382,153,229,2017-01-28 17:00:00,758,424,1262,488,1750,2174,2017-01-28 17:00:00,758,100226,99762
"5746",18210,2017-01-28 18:00:00,758,1034,626,408,166,242,2017-01-28 18:00:00,758,465,1378,545,1923,2388,2017-01-28 18:00:00,758,97166,96718
"5747",18211,2017-01-28 19:00:00,758,993,610,383,134,249,2017-01-28 19:00:00,758,482,1521,614,2135,2617,2017-01-28 19:00:00,758,94367,93940
"5748",18212,2017-01-28 20:00:00,758,981,605,376,149,227,2017-01-28 20:00:00,758,543,1445,559,2004,2547,2017-01-28 20:00:00,758,90342,89909
"5749",18213,2017-01-28 21:00:00,758,974,600,374,150,224,2017-01-28 21:00:00,758,485,1404,517,1921,2406,2017-01-28 21:00:00,758,85173,84773
"5750",18214,2017-01-28 22:00:00,758,1025,588,437,143,294,2017-01-28 22:00:00,758,459,1327,528,1855,2314,2017-01-28 22:00:00,758,79368,79001
"5751",18215,2017-01-28 23:00:00,758,991,542,449,148,301,2017-01-28 23:00:00,758,363,1343,503,1846,2209,2017-01-28 23:00:00,758,72768,72431
"5752",18216,2017-01-29 00:00:00,759,972,549,423,159,264,2017-01-29 00:00:00,759,367,1219,433,1652,2019,2017-01-29 00:00:00,759,68391,68090
"5753",18217,2017-01-29 01:00:00,759,879,466,413,125,288,2017-01-29 01:00:00,759,293,1018,382,1400,1693,2017-01-29 01:00:00,759,66854,66565
"5754",18218,2017-01-29 02:00:00,759,837,465,372,120,252,2017-01-29 02:00:00,759,264,1015,353,1368,1632,2017-01-29 02:00:00,759,64873,64625
"5755",18219,2017-01-29 03:00:00,759,691,382,309,85,224,2017-01-29 03:00:00,759,209,762,285,1047,1256,2017-01-29 03:00:00,759,65673,65373
"5756",18220,2017-01-29 04:00:00,759,684,369,315,105,210,2017-01-29 04:00:00,759,145,521,199,720,865,2017-01-29 04:00:00,759,65690,65423
"5757",18221,2017-01-29 05:00:00,759,608,306,302,123,179,2017-01-29 05:00:00,759,115,393,150,543,658,2017-01-29 05:00:00,759,59088,58831
"5758",18222,2017-01-29 06:00:00,759,427,225,202,74,128,2017-01-29 06:00:00,759,94,197,58,255,349,2017-01-29 06:00:00,759,54543,54303
"5759",18223,2017-01-29 07:00:00,759,203,119,84,32,52,2017-01-29 07:00:00,759,52,155,62,217,269,2017-01-29 07:00:00,759,52202,51976
"5760",18224,2017-01-29 08:00:00,759,154,111,43,11,32,2017-01-29 08:00:00,759,50,90,27,117,167,2017-01-29 08:00:00,759,50695,50499
"5761",18225,2017-01-29 09:00:00,759,270,172,98,40,58,2017-01-29 09:00:00,759,33,62,31,93,126,2017-01-29 09:00:00,759,50953,50742
"5762",18226,2017-01-29 10:00:00,759,183,136,47,14,33,2017-01-29 10:00:00,759,25,31,9,40,65,2017-01-29 10:00:00,759,52699,52481
"5763",18227,2017-01-29 11:00:00,759,244,163,81,37,44,2017-01-29 11:00:00,759,34,45,20,65,99,2017-01-29 11:00:00,759,55896,55655
"5764",18228,2017-01-29 12:00:00,759,270,183,87,35,52,2017-01-29 12:00:00,759,45,76,32,108,153,2017-01-29 12:00:00,759,61843,61585
"5765",18229,2017-01-29 13:00:00,759,373,227,146,52,94,2017-01-29 13:00:00,759,85,186,76,262,347,2017-01-29 13:00:00,759,70797,70509
"5766",18230,2017-01-29 14:00:00,759,536,332,204,79,125,2017-01-29 14:00:00,759,147,478,194,672,819,2017-01-29 14:00:00,759,79254,78944
"5767",18231,2017-01-29 15:00:00,759,724,429,295,121,174,2017-01-29 15:00:00,759,240,719,277,996,1236,2017-01-29 15:00:00,759,86411,86019
"5768",18232,2017-01-29 16:00:00,759,829,518,311,108,203,2017-01-29 16:00:00,759,312,1007,385,1392,1704,2017-01-29 16:00:00,759,92788,92406
"5769",18233,2017-01-29 17:00:00,759,924,574,350,159,191,2017-01-29 17:00:00,759,356,1150,438,1588,1944,2017-01-29 17:00:00,759,95045,94667
"5770",18234,2017-01-29 18:00:00,759,958,580,378,158,220,2017-01-29 18:00:00,759,392,1272,461,1733,2125,2017-01-29 18:00:00,759,95629,95216
"5771",18235,2017-01-29 19:00:00,759,1024,579,445,174,271,2017-01-29 19:00:00,759,411,1339,494,1833,2244,2017-01-29 19:00:00,759,95486,95075
"5772",18236,2017-01-29 20:00:00,759,1008,598,410,150,260,2017-01-29 20:00:00,759,475,1380,482,1862,2337,2017-01-29 20:00:00,759,93203,92794
"5773",18237,2017-01-29 21:00:00,759,1080,629,451,152,299,2017-01-29 21:00:00,759,451,1355,496,1851,2302,2017-01-29 21:00:00,759,90197,89791
"5774",18238,2017-01-29 22:00:00,759,1055,615,440,151,288,2017-01-29 22:00:00,759,362,1405,527,1932,2294,2017-01-29 22:00:00,759,84900,84518
"5775",18239,2017-01-29 23:00:00,759,1019,589,430,158,272,2017-01-29 23:00:00,759,333,1232,449,1681,2014,2017-01-29 23:00:00,759,81034,80668
"5776",18240,2017-01-30 00:00:00,760,869,530,339,114,225,2017-01-30 00:00:00,760,311,1035,369,1404,1715,2017-01-30 00:00:00,760,81239,80874
"5777",18241,2017-01-30 01:00:00,760,975,575,400,163,237,2017-01-30 01:00:00,760,257,924,335,1259,1516,2017-01-30 01:00:00,760,82819,82456
"5778",18242,2017-01-30 02:00:00,760,881,497,384,132,252,2017-01-30 02:00:00,760,218,760,276,1036,1254,2017-01-30 02:00:00,760,79027,78701
"5779",18243,2017-01-30 03:00:00,760,793,447,346,119,227,2017-01-30 03:00:00,760,167,462,175,637,804,2017-01-30 03:00:00,760,78157,77845
"5780",18244,2017-01-30 04:00:00,760,642,388,254,95,159,2017-01-30 04:00:00,760,125,293,119,412,537,2017-01-30 04:00:00,760,78409,78115
"5781",18245,2017-01-30 05:00:00,760,462,281,181,72,109,2017-01-30 05:00:00,760,85,142,50,192,277,2017-01-30 05:00:00,760,75329,75026
"5782",18246,2017-01-30 06:00:00,760,369,242,127,45,82,2017-01-30 06:00:00,760,65,93,39,132,197,2017-01-30 06:00:00,760,76326,76032
"5783",18247,2017-01-30 07:00:00,760,296,196,100,38,62,2017-01-30 07:00:00,760,37,49,24,73,110,2017-01-30 07:00:00,760,77085,76768
"5784",18248,2017-01-30 08:00:00,760,272,191,81,34,47,2017-01-30 08:00:00,760,55,30,13,43,98,2017-01-30 08:00:00,760,79135,78795
"5785",18249,2017-01-30 09:00:00,760,243,186,57,27,30,2017-01-30 09:00:00,760,17,34,8,42,59,2017-01-30 09:00:00,760,82823,82473
"5786",18250,2017-01-30 10:00:00,760,259,208,51,23,28,2017-01-30 10:00:00,760,33,30,12,42,75,2017-01-30 10:00:00,760,86386,85982
"5787",18251,2017-01-30 11:00:00,760,249,176,73,29,44,2017-01-30 11:00:00,760,39,38,14,52,91,2017-01-30 11:00:00,760,102798,102412
"5788",18252,2017-01-30 12:00:00,760,293,228,65,24,41,2017-01-30 12:00:00,760,61,104,64,168,229,2017-01-30 12:00:00,760,165855,165446
"5789",18253,2017-01-30 13:00:00,760,413,328,85,32,53,2017-01-30 13:00:00,760,222,304,154,458,680,2017-01-30 13:00:00,760,254199,253676
"5790",18254,2017-01-30 14:00:00,760,582,490,92,52,40,2017-01-30 14:00:00,760,394,555,272,827,1221,2017-01-30 14:00:00,760,278726,278073
"5791",18255,2017-01-30 15:00:00,760,679,531,148,57,91,2017-01-30 15:00:00,760,493,642,296,938,1431,2017-01-30 15:00:00,760,259179,258462
"5792",18256,2017-01-30 16:00:00,760,751,581,170,65,105,2017-01-30 16:00:00,760,576,817,404,1221,1797,2017-01-30 16:00:00,760,244067,243326
"5793",18257,2017-01-30 17:00:00,760,903,670,233,79,154,2017-01-30 17:00:00,760,668,821,384,1205,1873,2017-01-30 17:00:00,760,213404,212678
"5794",18258,2017-01-30 18:00:00,760,898,678,220,86,134,2017-01-30 18:00:00,760,613,871,379,1250,1863,2017-01-30 18:00:00,760,201254,200507
"5795",18259,2017-01-30 19:00:00,760,918,666,252,103,149,2017-01-30 19:00:00,760,722,986,471,1457,2179,2017-01-30 19:00:00,760,194179,193500
"5796",18260,2017-01-30 20:00:00,760,958,667,291,118,173,2017-01-30 20:00:00,760,658,1203,564,1767,2425,2017-01-30 20:00:00,760,181641,180933
"5797",18261,2017-01-30 21:00:00,760,936,637,299,100,199,2017-01-30 21:00:00,760,659,1328,537,1865,2524,2017-01-30 21:00:00,760,163856,163286
"5798",18262,2017-01-30 22:00:00,760,1007,647,360,88,272,2017-01-30 22:00:00,760,656,1430,546,1976,2632,2017-01-30 22:00:00,760,135765,135259
"5799",18263,2017-01-30 23:00:00,760,1045,633,412,131,281,2017-01-30 23:00:00,760,605,1549,544,2093,2698,2017-01-30 23:00:00,760,111917,111479
"5800",18264,2017-01-31 00:00:00,761,1018,585,433,112,321,2017-01-31 00:00:00,761,486,1534,584,2118,2604,2017-01-31 00:00:00,761,103085,102640
"5801",18265,2017-01-31 01:00:00,761,920,544,376,115,261,2017-01-31 01:00:00,761,414,1198,450,1648,2062,2017-01-31 01:00:00,761,96338,95996
"5802",18266,2017-01-31 02:00:00,761,768,487,281,97,184,2017-01-31 02:00:00,761,346,827,311,1138,1484,2017-01-31 02:00:00,761,89213,88830
"5803",18267,2017-01-31 03:00:00,761,718,463,255,89,166,2017-01-31 03:00:00,761,263,626,221,847,1110,2017-01-31 03:00:00,761,83209,82861
"5804",18268,2017-01-31 04:00:00,761,619,388,231,82,149,2017-01-31 04:00:00,761,196,377,139,516,712,2017-01-31 04:00:00,761,79289,78977
"5805",18269,2017-01-31 05:00:00,761,469,328,141,42,99,2017-01-31 05:00:00,761,98,245,100,345,443,2017-01-31 05:00:00,761,74306,74016
"5806",18270,2017-01-31 06:00:00,761,348,228,120,39,81,2017-01-31 06:00:00,761,77,92,37,129,206,2017-01-31 06:00:00,761,73590,73295
"5807",18271,2017-01-31 07:00:00,761,300,221,79,36,43,2017-01-31 07:00:00,761,52,52,20,72,124,2017-01-31 07:00:00,761,75327,74992
"5808",18272,2017-01-31 08:00:00,761,242,189,53,19,34,2017-01-31 08:00:00,761,55,40,16,56,111,2017-01-31 08:00:00,761,77376,77025
"5809",18273,2017-01-31 09:00:00,761,244,191,53,20,33,2017-01-31 09:00:00,761,34,35,11,46,80,2017-01-31 09:00:00,761,80711,80332
"5810",18274,2017-01-31 10:00:00,761,232,170,62,24,38,2017-01-31 10:00:00,761,30,28,7,35,65,2017-01-31 10:00:00,761,81866,81507
"5811",18275,2017-01-31 11:00:00,761,266,207,59,25,34,2017-01-31 11:00:00,761,56,58,29,87,143,2017-01-31 11:00:00,761,87574,87244
"5812",18276,2017-01-31 12:00:00,761,279,220,59,24,35,2017-01-31 12:00:00,761,82,107,47,154,236,2017-01-31 12:00:00,761,117801,117413
"5813",18277,2017-01-31 13:00:00,761,409,318,91,43,48,2017-01-31 13:00:00,761,207,261,117,378,585,2017-01-31 13:00:00,761,166767,166244
"5814",18278,2017-01-31 14:00:00,761,500,395,105,42,63,2017-01-31 14:00:00,761,380,491,249,740,1120,2017-01-31 14:00:00,761,195149,194546
"5815",18279,2017-01-31 15:00:00,761,571,443,128,56,72,2017-01-31 15:00:00,761,458,535,274,809,1267,2017-01-31 15:00:00,761,200375,199697
"5816",18280,2017-01-31 16:00:00,761,747,599,148,57,91,2017-01-31 16:00:00,761,607,733,362,1095,1702,2017-01-31 16:00:00,761,195691,195005
"5817",18281,2017-01-31 17:00:00,761,729,580,149,55,94,2017-01-31 17:00:00,761,556,693,330,1023,1579,2017-01-31 17:00:00,761,179070,178361
"5818",18282,2017-01-31 18:00:00,761,766,596,170,67,103,2017-01-31 18:00:00,761,632,857,388,1245,1877,2017-01-31 18:00:00,761,174039,173384
"5819",18283,2017-01-31 19:00:00,761,793,604,189,76,113,2017-01-31 19:00:00,761,640,908,392,1300,1940,2017-01-31 19:00:00,761,171185,170540
"5820",18284,2017-01-31 20:00:00,761,790,607,183,77,106,2017-01-31 20:00:00,761,630,982,425,1407,2037,2017-01-31 20:00:00,761,160993,160335
"5821",18285,2017-01-31 21:00:00,761,945,699,246,85,161,2017-01-31 21:00:00,761,652,1146,454,1600,2252,2017-01-31 21:00:00,761,145133,144584
"5822",18286,2017-01-31 22:00:00,761,943,622,321,122,199,2017-01-31 22:00:00,761,602,1156,482,1638,2240,2017-01-31 22:00:00,761,120931,120448
"5823",18287,2017-01-31 23:00:00,761,947,611,336,117,219,2017-01-31 23:00:00,761,471,1356,504,1860,2331,2017-01-31 23:00:00,761,100811,100431
